,location,voters,spoiltvotes,votes,Зеленський Володимир,Порошенко Петро,tvk,region
0,1,296,30,254,92,162,1,Донецька область
1,2,319,14,303,132,171,2,Донецька область
2,3,366,9,321,187,134,3,Донецька область
3,4,920,26,888,305,583,4,Донецька область
4,5,316,15,260,97,163,5,Донецька область
5,6,556,8,467,305,162,6,Донецька область
6,140566,2095,34,950,776,174,140566,Донецька область
7,140567,611,2,134,70,64,140567,Донецька область
8,140568,1014,16,769,447,322,140568,Донецька область
9,140569,1463,33,679,518,161,140569,Донецька область
10,140570,1574,30,727,628,99,140570,Донецька область
11,140572,622,7,287,227,60,140572,Донецька область
12,140573,491,1,214,176,38,140573,Донецька область
13,140574,726,22,438,359,79,140574,Донецька область
14,140575,1309,31,624,429,195,140575,Донецька область
15,140576,419,2,302,203,99,140576,Донецька область
16,140577,1723,48,908,666,242,140577,Донецька область
17,140578,782,6,572,337,235,140578,Донецька область
18,140579,1845,7,497,235,262,140579,Донецька область
19,140580,554,9,312,238,74,140580,Донецька область
20,140582,693,3,478,295,183,140582,Донецька область
21,140585,564,1,247,153,94,140585,Донецька область
22,140587,969,21,372,348,24,140587,Донецька область
23,140588,1394,17,492,443,49,140588,Донецька область
24,140589,912,16,352,318,34,140589,Донецька область
25,140590,956,19,365,343,22,140590,Донецька область
26,140591,1199,21,493,438,55,140591,Донецька область
27,140592,1005,15,385,350,35,140592,Донецька область
28,140593,1209,18,446,411,35,140593,Донецька область
29,140594,1897,44,800,730,70,140594,Донецька область
30,140595,2147,13,825,761,64,140595,Донецька область
31,140596,1822,40,783,712,71,140596,Донецька область
32,140597,1093,20,479,439,40,140597,Донецька область
33,140598,1954,30,762,681,81,140598,Донецька область
34,140599,2044,31,857,793,64,140599,Донецька область
35,140600,1852,28,761,704,57,140600,Донецька область
36,140601,1949,33,832,762,70,140601,Донецька область
37,140602,1985,37,872,787,85,140602,Донецька область
38,1,602,52,550,537,13,1,Донецька область
39,2,256,8,222,167,55,2,Донецька область
40,3,227,6,182,125,57,3,Донецька область
41,4,210,2,202,139,63,4,Донецька область
42,5,332,37,292,107,185,5,Донецька область
43,6,714,26,676,423,253,6,Донецька область
44,7,864,247,464,263,201,7,Донецька область
45,8,484,20,457,206,251,8,Донецька область
46,9,261,24,214,124,90,9,Донецька область
47,10,638,36,560,300,260,10,Донецька область
48,11,870,12,807,328,479,11,Донецька область
49,12,180,13,165,79,86,12,Донецька область
50,13,574,20,530,339,191,13,Донецька область
51,140041,989,9,455,419,36,140041,Донецька область
52,140042,1458,7,703,653,50,140042,Донецька область
53,140043,1487,16,764,718,46,140043,Донецька область
54,140044,1393,9,676,629,47,140044,Донецька область
55,140045,1502,12,756,703,53,140045,Донецька область
56,140046,839,6,387,367,20,140046,Донецька область
57,140047,738,9,368,300,68,140047,Донецька область
58,140048,873,6,421,348,73,140048,Донецька область
59,140049,242,2,121,105,16,140049,Донецька область
60,140050,243,2,131,101,30,140050,Донецька область
61,140051,836,8,432,404,28,140051,Донецька область
62,140052,597,3,337,314,23,140052,Донецька область
63,140053,439,4,185,174,11,140053,Донецька область
64,140054,253,4,153,140,13,140054,Донецька область
65,140055,588,9,399,262,137,140055,Донецька область
66,140056,806,7,387,362,25,140056,Донецька область
67,140057,326,13,178,154,24,140057,Донецька область
68,140058,1005,14,594,487,107,140058,Донецька область
69,140059,916,14,660,451,209,140059,Донецька область
70,140060,569,4,368,342,26,140060,Донецька область
71,140061,565,8,346,296,50,140061,Донецька область
72,140062,503,5,306,289,17,140062,Донецька область
73,140063,146,0,100,65,35,140063,Донецька область
74,140064,396,3,215,179,36,140064,Донецька область
75,140066,583,6,307,279,28,140066,Донецька область
76,140067,370,1,138,131,7,140067,Донецька область
77,140068,1225,15,718,672,46,140068,Донецька область
78,140069,420,5,229,194,35,140069,Донецька область
79,140070,730,6,365,354,11,140070,Донецька область
80,140071,451,5,232,215,17,140071,Донецька область
81,140073,1904,23,765,724,41,140073,Донецька область
82,140074,1255,18,606,559,47,140074,Донецька область
83,140075,1462,11,822,744,78,140075,Донецька область
84,140076,218,4,125,110,15,140076,Донецька область
85,140077,220,3,166,146,20,140077,Донецька область
86,140078,343,0,196,186,10,140078,Донецька область
87,140079,502,4,283,261,22,140079,Донецька область
88,140080,512,3,282,265,17,140080,Донецька область
89,140081,1479,16,921,867,54,140081,Донецька область
90,140082,309,5,137,121,16,140082,Донецька область
91,140083,278,3,180,165,15,140083,Донецька область
92,140084,489,4,335,261,74,140084,Донецька область
93,140085,511,4,267,243,24,140085,Донецька область
94,140086,972,8,500,476,24,140086,Донецька область
95,140603,615,7,318,292,26,140603,Донецька область
96,140604,1461,17,791,738,53,140604,Донецька область
97,140605,1589,26,883,789,94,140605,Донецька область
98,140606,1341,14,757,705,52,140606,Донецька область
99,140607,986,17,507,450,57,140607,Донецька область
100,140608,749,9,379,350,29,140608,Донецька область
101,140609,1009,29,667,538,129,140609,Донецька область
102,140610,840,15,479,416,63,140610,Донецька область
103,140611,1183,10,689,644,45,140611,Донецька область
104,140612,1146,27,642,569,73,140612,Донецька область
105,140613,1372,20,845,753,92,140613,Донецька область
106,140614,888,10,533,466,67,140614,Донецька область
107,140615,1413,20,847,781,66,140615,Донецька область
108,140616,1743,24,996,917,79,140616,Донецька область
109,140617,1873,23,930,841,89,140617,Донецька область
110,140618,2013,31,1187,1106,81,140618,Донецька область
111,140619,995,16,582,514,68,140619,Донецька область
112,140620,1321,12,774,713,61,140620,Донецька область
113,140621,1460,24,816,757,59,140621,Донецька область
114,140622,1173,23,680,614,66,140622,Донецька область
115,140623,1564,30,896,829,67,140623,Донецька область
116,140624,1920,35,1109,1021,88,140624,Донецька область
117,140625,2123,32,1252,1158,94,140625,Донецька область
118,140626,2056,25,1195,1086,109,140626,Донецька область
119,140627,1791,29,1000,920,80,140627,Донецька область
120,140628,1779,29,998,905,93,140628,Донецька область
121,140629,1166,21,620,569,51,140629,Донецька область
122,140630,1585,22,826,743,83,140630,Донецька область
123,140631,1514,22,848,775,73,140631,Донецька область
124,140632,1636,31,883,800,83,140632,Донецька область
125,140633,1146,23,638,581,57,140633,Донецька область
126,140634,1323,13,813,767,46,140634,Донецька область
127,140635,1451,21,791,750,41,140635,Донецька область
128,140636,1871,34,1050,973,77,140636,Донецька область
129,140637,1576,20,824,760,64,140637,Донецька область
130,140638,1696,30,945,877,68,140638,Донецька область
131,140639,2143,21,1151,1076,75,140639,Донецька область
132,140641,1816,18,936,897,39,140641,Донецька область
133,140642,441,7,278,250,28,140642,Донецька область
134,140643,536,7,250,244,6,140643,Донецька область
135,140644,882,4,407,382,25,140644,Донецька область
136,140645,1836,19,1146,1087,59,140645,Донецька область
137,140646,1865,27,1141,1094,47,140646,Донецька область
138,140647,1636,22,904,857,47,140647,Донецька область
139,140648,841,7,407,391,16,140648,Донецька область
140,140649,854,12,393,383,10,140649,Донецька область
141,140650,1083,19,498,457,41,140650,Донецька область
142,140651,753,3,383,322,61,140651,Донецька область
143,140652,894,12,416,373,43,140652,Донецька область
144,140653,882,11,420,378,42,140653,Донецька область
145,140654,675,13,357,306,51,140654,Донецька область
146,140655,627,7,291,239,52,140655,Донецька область
147,140656,725,7,365,320,45,140656,Донецька область
148,140657,1523,21,741,696,45,140657,Донецька область
149,140658,899,6,484,436,48,140658,Донецька область
150,140659,929,9,526,480,46,140659,Донецька область
151,140660,1276,16,640,599,41,140660,Донецька область
152,140661,112,2,106,93,13,140661,Донецька область
153,141098,1996,36,1167,1056,111,141098,Донецька область
154,141099,1769,34,1063,973,90,141099,Донецька область
155,141100,1486,18,883,807,76,141100,Донецька область
156,141101,1451,24,837,793,44,141101,Донецька область
157,141102,804,6,414,363,51,141102,Донецька область
158,141103,279,5,173,147,26,141103,Донецька область
159,141104,1278,10,755,683,72,141104,Донецька область
160,141105,965,10,562,512,50,141105,Донецька область
161,141106,1190,13,567,513,54,141106,Донецька область
162,141107,1227,18,654,595,59,141107,Донецька область
163,141108,860,9,428,410,18,141108,Донецька область
164,141109,667,36,350,316,34,141109,Донецька область
165,141110,1749,18,924,875,49,141110,Донецька область
166,141111,1377,15,710,659,51,141111,Донецька область
167,141112,1256,8,677,646,31,141112,Донецька область
168,141113,1791,9,996,933,63,141113,Донецька область
169,141114,284,3,174,122,52,141114,Донецька область
170,141115,213,1,163,92,71,141115,Донецька область
171,141116,427,3,254,238,16,141116,Донецька область
172,141117,253,2,173,123,50,141117,Донецька область
173,141118,152,2,105,60,45,141118,Донецька область
174,141119,239,4,166,113,53,141119,Донецька область
175,141120,909,7,456,427,29,141120,Донецька область
176,141121,706,3,352,327,25,141121,Донецька область
177,141122,373,0,204,175,29,141122,Донецька область
178,141123,973,14,591,535,56,141123,Донецька область
179,141124,1024,10,533,505,28,141124,Донецька область
180,141125,1048,10,535,467,68,141125,Донецька область
181,141126,558,8,275,251,24,141126,Донецька область
182,141127,270,1,147,132,15,141127,Донецька область
183,141128,1067,12,685,612,73,141128,Донецька область
184,141129,1330,16,777,687,90,141129,Донецька область
185,141130,149,3,117,98,19,141130,Донецька область
186,141131,718,5,394,340,54,141131,Донецька область
187,141132,682,3,344,302,42,141132,Донецька область
188,141133,335,3,188,154,34,141133,Донецька область
189,141134,955,9,653,477,176,141134,Донецька область
190,141135,854,10,393,372,21,141135,Донецька область
191,141136,173,2,87,79,8,141136,Донецька область
192,141137,314,4,151,128,23,141137,Донецька область
193,141138,569,2,298,267,31,141138,Донецька область
194,141139,945,14,580,524,56,141139,Донецька область
195,141140,425,2,236,214,22,141140,Донецька область
196,141141,439,2,254,235,19,141141,Донецька область
197,141142,386,3,251,220,31,141142,Донецька область
198,141143,80,0,78,62,16,141143,Донецька область
199,141144,57,1,44,40,4,141144,Донецька область
200,142443,96,4,92,86,6,142443,Донецька область
201,1,63,1,60,50,10,1,Донецька область
202,140393,1479,18,1108,794,314,140393,Донецька область
203,140394,1450,16,991,811,180,140394,Донецька область
204,140395,379,2,316,211,105,140395,Донецька область
205,140396,952,6,611,496,115,140396,Донецька область
206,140397,535,4,365,308,57,140397,Донецька область
207,140398,607,7,335,288,47,140398,Донецька область
208,140399,452,4,294,255,39,140399,Донецька область
209,140400,1356,17,828,777,51,140400,Донецька область
210,140401,417,2,248,225,23,140401,Донецька область
211,140402,655,7,477,365,112,140402,Донецька область
212,140403,642,6,497,418,79,140403,Донецька область
213,140404,484,2,308,277,31,140404,Донецька область
214,140405,375,3,243,219,24,140405,Донецька область
215,140406,654,2,394,357,37,140406,Донецька область
216,140407,685,13,464,380,84,140407,Донецька область
217,140408,511,7,302,284,18,140408,Донецька область
218,140409,870,10,526,494,32,140409,Донецька область
219,140410,605,9,431,339,92,140410,Донецька область
220,140411,1004,9,658,616,42,140411,Донецька область
221,140433,857,8,500,464,36,140433,Донецька область
222,140434,429,4,239,224,15,140434,Донецька область
223,140435,524,10,252,232,20,140435,Донецька область
224,140436,1531,16,879,825,54,140436,Донецька область
225,140437,985,14,521,480,41,140437,Донецька область
226,140438,652,7,385,349,36,140438,Донецька область
227,140439,515,11,349,330,19,140439,Донецька область
228,140440,1166,8,584,540,44,140440,Донецька область
229,140441,1613,10,734,656,78,140441,Донецька область
230,140442,1405,14,784,722,62,140442,Донецька область
231,140443,1433,12,797,740,57,140443,Донецька область
232,140444,1197,15,729,651,78,140444,Донецька область
233,140445,831,4,515,407,108,140445,Донецька область
234,140446,466,7,236,214,22,140446,Донецька область
235,140447,361,0,214,193,21,140447,Донецька область
236,140448,838,6,376,354,22,140448,Донецька область
237,140449,1508,15,762,698,64,140449,Донецька область
238,140450,1108,16,706,661,45,140450,Донецька область
239,140451,469,12,313,265,48,140451,Донецька область
240,140452,414,7,229,209,20,140452,Донецька область
241,140453,823,9,416,382,34,140453,Донецька область
242,140454,392,3,241,217,24,140454,Донецька область
243,140455,367,2,210,182,28,140455,Донецька область
244,140456,523,5,241,218,23,140456,Донецька область
245,140457,622,18,319,271,48,140457,Донецька область
246,140458,786,9,309,289,20,140458,Донецька область
247,140459,422,8,232,213,19,140459,Донецька область
248,140460,637,4,380,357,23,140460,Донецька область
249,140461,504,8,275,257,18,140461,Донецька область
250,140462,1040,19,539,502,37,140462,Донецька область
251,141184,1519,14,690,634,56,141184,Донецька область
252,141185,1824,25,844,783,61,141185,Донецька область
253,141186,1643,28,875,782,93,141186,Донецька область
254,141187,1809,21,949,821,128,141187,Донецька область
255,141188,1162,12,614,557,57,141188,Донецька область
256,141189,1968,33,1124,988,136,141189,Донецька область
257,141190,1700,28,940,837,103,141190,Донецька область
258,141191,1696,31,842,759,83,141191,Донецька область
259,141192,1636,24,864,782,82,141192,Донецька область
260,141193,1861,36,991,890,101,141193,Донецька область
261,141194,1297,25,654,594,60,141194,Донецька область
262,141195,1663,26,908,806,102,141195,Донецька область
263,141196,1865,33,1065,946,119,141196,Донецька область
264,141197,2030,29,1156,1030,126,141197,Донецька область
265,141198,1710,36,1033,880,153,141198,Донецька область
266,141199,1260,23,742,645,97,141199,Донецька область
267,141200,2003,34,1193,1050,143,141200,Донецька область
268,141201,2170,28,1225,1077,148,141201,Донецька область
269,141202,1518,15,778,681,97,141202,Донецька область
270,141203,1496,16,696,598,98,141203,Донецька область
271,141204,1868,29,901,829,72,141204,Донецька область
272,141205,1925,27,1081,997,84,141205,Донецька область
273,141206,1771,28,959,860,99,141206,Донецька область
274,141207,1766,27,961,863,98,141207,Донецька область
275,141208,998,15,498,446,52,141208,Донецька область
276,141209,1399,14,828,727,101,141209,Донецька область
277,141210,2029,26,1224,1090,134,141210,Донецька область
278,141211,2146,32,1268,1133,135,141211,Донецька область
279,141212,2280,28,1321,1183,138,141212,Донецька область
280,141213,2149,33,1208,1078,130,141213,Донецька область
281,141214,2297,29,1249,1153,96,141214,Донецька область
282,141215,445,7,223,210,13,141215,Донецька область
283,141216,2081,29,1163,1018,145,141216,Донецька область
284,141217,1825,27,885,775,110,141217,Донецька область
285,141218,1971,32,1112,970,142,141218,Донецька область
286,141219,1723,28,914,825,89,141219,Донецька область
287,141220,1340,21,713,635,78,141220,Донецька область
288,141221,1704,26,1061,932,129,141221,Донецька область
289,141222,1466,24,794,738,56,141222,Донецька область
290,141223,1567,10,621,571,50,141223,Донецька область
291,141224,1155,15,596,555,41,141224,Донецька область
292,141225,1624,23,917,828,89,141225,Донецька область
293,141226,2096,30,979,906,73,141226,Донецька область
294,141227,1287,15,716,649,67,141227,Донецька область
295,141228,1508,12,799,711,88,141228,Донецька область
296,141229,815,19,469,392,77,141229,Донецька область
297,141230,1167,11,623,576,47,141230,Донецька область
298,141231,1443,7,635,570,65,141231,Донецька область
299,141232,1861,25,913,835,78,141232,Донецька область
300,141233,1940,30,1025,937,88,141233,Донецька область
301,141234,1944,39,876,812,64,141234,Донецька область
302,141235,2020,24,1036,961,75,141235,Донецька область
303,141236,1832,32,909,844,65,141236,Донецька область
304,141237,1864,18,1104,999,105,141237,Донецька область
305,141238,1490,63,786,687,99,141238,Донецька область
306,141239,1273,24,762,661,101,141239,Донецька область
307,141240,18,0,18,13,5,141240,Донецька область
308,141241,14,0,14,8,6,141241,Донецька область
309,141243,12,0,12,6,6,141243,Донецька область
310,141244,125,15,102,76,26,141244,Донецька область
311,141245,25,0,18,12,6,141245,Донецька область
312,141246,39,0,38,30,8,141246,Донецька область
313,141247,57,0,49,36,13,141247,Донецька область
314,141248,132,3,118,104,14,141248,Донецька область
315,2,833,22,767,387,380,2,Донецька область
316,3,1923,53,1683,735,948,3,Донецька область
317,140970,1625,27,1024,907,117,140970,Донецька область
318,140971,1546,28,953,826,127,140971,Донецька область
319,140972,1678,21,1024,908,116,140972,Донецька область
320,140973,2004,41,1273,1121,152,140973,Донецька область
321,140974,1763,25,1067,953,114,140974,Донецька область
322,140975,1819,16,1070,958,112,140975,Донецька область
323,140976,2225,32,1229,1042,187,140976,Донецька область
324,140977,2220,32,1216,1042,174,140977,Донецька область
325,140978,1998,30,1235,1089,146,140978,Донецька область
326,140979,1800,24,1084,961,123,140979,Донецька область
327,140980,1829,29,1030,944,86,140980,Донецька область
328,140981,2037,21,1161,1036,125,140981,Донецька область
329,140982,1636,20,877,802,75,140982,Донецька область
330,140983,1962,24,1143,1059,84,140983,Донецька область
331,140984,2128,19,1187,1076,111,140984,Донецька область
332,140985,517,2,303,262,41,140985,Донецька область
333,140986,1708,26,771,689,82,140986,Донецька область
334,140987,1612,15,788,691,97,140987,Донецька область
335,140988,1596,18,795,713,82,140988,Донецька область
336,140989,1256,14,598,560,38,140989,Донецька область
337,140990,1348,24,761,703,58,140990,Донецька область
338,140991,2104,17,1049,932,117,140991,Донецька область
339,140992,1221,16,659,602,57,140992,Донецька область
340,140993,1387,19,804,746,58,140993,Донецька область
341,140994,1432,19,729,662,67,140994,Донецька область
342,140995,2070,18,1055,937,118,140995,Донецька область
343,140996,1714,21,864,783,81,140996,Донецька область
344,140997,1907,34,1112,995,117,140997,Донецька область
345,140998,2025,31,1079,948,131,140998,Донецька область
346,140999,1518,15,896,772,124,140999,Донецька область
347,141000,1460,14,835,718,117,141000,Донецька область
348,141001,2031,28,1103,994,109,141001,Донецька область
349,141002,1671,20,834,770,64,141002,Донецька область
350,141003,1484,27,748,681,67,141003,Донецька область
351,141004,1070,11,543,486,57,141004,Донецька область
352,141005,1152,10,552,483,69,141005,Донецька область
353,141006,2033,24,1164,1016,148,141006,Донецька область
354,141007,1643,23,809,731,78,141007,Донецька область
355,141008,1881,20,961,861,100,141008,Донецька область
356,141009,1649,16,894,793,101,141009,Донецька область
357,141010,1843,22,970,849,121,141010,Донецька область
358,141011,2006,24,1160,1014,146,141011,Донецька область
359,141012,1899,25,1063,921,142,141012,Донецька область
360,141013,1119,16,617,548,69,141013,Донецька область
361,141014,1123,11,557,488,69,141014,Донецька область
362,141015,1955,28,1127,958,169,141015,Донецька область
363,141016,1527,28,989,818,171,141016,Донецька область
364,141017,1630,20,944,829,115,141017,Донецька область
365,141018,1929,36,1131,965,166,141018,Донецька область
366,141019,1965,43,1112,962,150,141019,Донецька область
367,141020,1786,14,1023,885,138,141020,Донецька область
368,141021,1669,18,901,728,173,141021,Донецька область
369,141022,1928,32,1146,972,174,141022,Донецька область
370,141023,1814,25,1129,968,161,141023,Донецька область
371,141024,1953,21,1215,1038,177,141024,Донецька область
372,141025,1943,33,1247,1069,178,141025,Донецька область
373,141026,1818,33,1184,995,189,141026,Донецька область
374,141027,2050,32,1298,1111,187,141027,Донецька область
375,141028,2093,32,1241,1095,146,141028,Донецька область
376,141029,2164,36,1266,1091,175,141029,Донецька область
377,141030,1954,28,1215,1038,177,141030,Донецька область
378,141031,2091,41,1251,1087,164,141031,Донецька область
379,141032,1977,37,1199,1025,174,141032,Донецька область
380,141033,2111,20,1265,1112,153,141033,Донецька область
381,141034,1592,18,977,822,155,141034,Донецька область
382,141035,1907,22,1180,1014,166,141035,Донецька область
383,141036,1781,34,1110,927,183,141036,Донецька область
384,141037,1535,24,922,805,117,141037,Донецька область
385,141038,1636,29,1034,893,141,141038,Донецька область
386,141039,1340,14,818,689,129,141039,Донецька область
387,141040,1845,29,1127,928,199,141040,Донецька область
388,141041,1624,23,956,831,125,141041,Донецька область
389,141042,1507,38,861,705,156,141042,Донецька область
390,141043,1692,26,988,876,112,141043,Донецька область
391,141044,1536,33,924,802,122,141044,Донецька область
392,141045,2047,33,1138,962,176,141045,Донецька область
393,141046,1288,24,751,644,107,141046,Донецька область
394,141047,1408,18,816,698,118,141047,Донецька область
395,141048,1524,24,951,770,181,141048,Донецька область
396,141049,1370,37,859,728,131,141049,Донецька область
397,141050,1477,26,881,734,147,141050,Донецька область
398,141051,2033,35,1239,1017,222,141051,Донецька область
399,141052,1959,32,1214,988,226,141052,Донецька область
400,141053,121,7,81,73,8,141053,Донецька область
401,141054,111,12,97,84,13,141054,Донецька область
402,141055,52,0,44,36,8,141055,Донецька область
403,141056,35,1,33,26,7,141056,Донецька область
404,141057,34,1,33,28,5,141057,Донецька область
405,141058,36,0,33,29,4,141058,Донецька область
406,142444,18,1,13,9,4,142444,Донецька область
407,1,1195,27,963,469,494,1,Донецька область
408,2,136,0,129,38,91,2,Донецька область
409,3,381,5,372,224,148,3,Донецька область
410,4,294,10,259,138,121,4,Донецька область
411,140246,668,25,452,416,36,140246,Донецька область
412,140247,381,2,207,196,11,140247,Донецька область
413,140248,421,5,265,203,62,140248,Донецька область
414,140249,315,6,193,160,33,140249,Донецька область
415,140250,576,6,336,285,51,140250,Донецька область
416,140251,1160,12,826,673,153,140251,Донецька область
417,140252,437,6,393,263,130,140252,Донецька область
418,140255,1425,21,797,745,52,140255,Донецька область
419,140256,239,6,233,210,23,140256,Донецька область
420,140257,156,3,99,65,34,140257,Донецька область
421,140258,386,10,210,193,17,140258,Донецька область
422,140259,297,0,190,156,34,140259,Донецька область
423,140260,358,3,292,248,44,140260,Донецька область
424,140261,726,6,462,401,61,140261,Донецька область
425,140262,181,8,105,94,11,140262,Донецька область
426,140263,179,2,102,89,13,140263,Донецька область
427,140264,335,5,211,197,14,140264,Донецька область
428,140265,278,1,190,164,26,140265,Донецька область
429,140266,303,2,177,153,24,140266,Донецька область
430,140267,281,2,185,152,33,140267,Донецька область
431,140268,676,0,308,253,55,140268,Донецька область
432,140271,290,3,177,143,34,140271,Донецька область
433,140272,505,9,370,337,33,140272,Донецька область
434,140273,509,2,279,259,20,140273,Донецька область
435,140274,426,2,246,199,47,140274,Донецька область
436,140275,281,2,155,120,35,140275,Донецька область
437,140276,435,8,233,215,18,140276,Донецька область
438,140277,313,7,153,135,18,140277,Донецька область
439,140278,363,3,185,156,29,140278,Донецька область
440,140279,121,0,61,44,17,140279,Донецька область
441,140280,394,4,256,239,17,140280,Донецька область
442,140281,2140,23,1179,1090,89,140281,Донецька область
443,140283,1431,23,824,791,33,140283,Донецька область
444,140284,1175,15,721,694,27,140284,Донецька область
445,140285,1625,7,980,918,62,140285,Донецька область
446,140287,1555,10,925,872,53,140287,Донецька область
447,140288,922,10,466,417,49,140288,Донецька область
448,140289,411,3,408,369,39,140289,Донецька область
449,140290,1736,19,1072,933,139,140290,Донецька область
450,140291,1292,22,626,558,68,140291,Донецька область
451,140293,437,3,268,223,45,140293,Донецька область
452,140294,987,6,669,511,158,140294,Донецька область
453,140295,656,10,344,319,25,140295,Донецька область
454,140296,606,19,298,266,32,140296,Донецька область
455,140297,1138,3,628,573,55,140297,Донецька область
456,140298,949,11,512,475,37,140298,Донецька область
457,140299,454,7,261,231,30,140299,Донецька область
458,140300,1021,6,632,594,38,140300,Донецька область
459,140301,921,11,442,408,34,140301,Донецька область
460,140303,1222,7,661,575,86,140303,Донецька область
461,140304,1074,7,580,539,41,140304,Донецька область
462,140305,484,4,315,276,39,140305,Донецька область
463,140804,1620,16,855,806,49,140804,Донецька область
464,140805,2076,18,994,934,60,140805,Донецька область
465,140806,1459,22,649,600,49,140806,Донецька область
466,140807,1408,15,642,613,29,140807,Донецька область
467,140808,2191,25,1044,974,70,140808,Донецька область
468,140809,2215,39,1131,1046,85,140809,Донецька область
469,140810,2220,27,1160,1067,93,140810,Донецька область
470,140811,936,14,512,479,33,140811,Донецька область
471,140812,1269,16,714,672,42,140812,Донецька область
472,140813,1365,15,723,659,64,140813,Донецька область
473,140814,1270,11,730,690,40,140814,Донецька область
474,140815,1957,19,988,934,54,140815,Донецька область
475,140816,1641,23,902,837,65,140816,Донецька область
476,140817,1394,18,814,763,51,140817,Донецька область
477,140818,2228,32,1199,1108,91,140818,Донецька область
478,140819,2032,16,1095,1024,71,140819,Донецька область
479,140820,2271,24,1206,1113,93,140820,Донецька область
480,140821,2256,28,1204,1123,81,140821,Донецька область
481,140822,2246,27,1228,1133,95,140822,Донецька область
482,140823,2079,33,1160,1072,88,140823,Донецька область
483,140824,1743,10,910,856,54,140824,Донецька область
484,140825,1560,16,907,842,65,140825,Донецька область
485,140826,1414,26,796,766,30,140826,Донецька область
486,140827,1270,15,703,584,119,140827,Донецька область
487,140828,1292,7,598,562,36,140828,Донецька область
488,140829,1498,20,721,702,19,140829,Донецька область
489,140830,1687,14,889,822,67,140830,Донецька область
490,140831,1252,7,701,644,57,140831,Донецька область
491,140832,113,2,109,85,24,140832,Донецька область
492,140833,61,2,56,21,35,140833,Донецька область
493,140834,48,0,46,31,15,140834,Донецька область
494,140930,1423,21,762,708,54,140930,Донецька область
495,140931,1328,10,635,610,25,140931,Донецька область
496,140932,1763,30,825,756,69,140932,Донецька область
497,140933,1878,20,961,909,52,140933,Донецька область
498,140935,1678,29,844,774,70,140935,Донецька область
499,140936,1824,30,837,785,52,140936,Донецька область
500,140937,1830,20,829,783,46,140937,Донецька область
501,140938,1612,23,748,709,39,140938,Донецька область
502,140939,1677,15,744,694,50,140939,Донецька область
503,140940,1569,12,620,579,41,140940,Донецька область
504,140941,1634,23,719,677,42,140941,Донецька область
505,140942,1194,20,555,518,37,140942,Донецька область
506,140943,1739,29,842,810,32,140943,Донецька область
507,140944,1717,18,722,676,46,140944,Донецька область
508,140945,1926,24,855,793,62,140945,Донецька область
509,140946,1657,19,765,719,46,140946,Донецька область
510,140947,1838,33,890,833,57,140947,Донецька область
511,140948,1075,8,549,508,41,140948,Донецька область
512,140949,1385,29,718,651,67,140949,Донецька область
513,140950,1445,22,814,777,37,140950,Донецька область
514,140951,1188,16,639,590,49,140951,Донецька область
515,140952,1275,18,635,587,48,140952,Донецька область
516,140953,1652,17,1067,889,178,140953,Донецька область
517,140954,1732,26,947,885,62,140954,Донецька область
518,140955,1681,21,893,844,49,140955,Донецька область
519,140956,1553,19,817,774,43,140956,Донецька область
520,140957,1442,16,715,680,35,140957,Донецька область
521,140958,1556,16,819,761,58,140958,Донецька область
522,140959,1803,26,855,808,47,140959,Донецька область
523,140960,1529,18,804,751,53,140960,Донецька область
524,140961,1141,20,565,518,47,140961,Донецька область
525,140962,1299,19,654,591,63,140962,Донецька область
526,140963,1651,22,787,736,51,140963,Донецька область
527,140964,1585,15,784,741,43,140964,Донецька область
528,140965,1197,11,577,555,22,140965,Донецька область
529,140966,1281,22,669,634,35,140966,Донецька область
530,140967,1436,12,739,687,52,140967,Донецька область
531,140968,67,0,67,59,8,140968,Донецька область
532,140969,90,4,82,74,8,140969,Донецька область
533,1,101,3,98,51,47,1,Донецька область
534,2,700,20,655,387,268,2,Донецька область
535,140220,1440,17,931,858,73,140220,Донецька область
536,140221,412,3,260,244,16,140221,Донецька область
537,140222,394,2,292,266,26,140222,Донецька область
538,140223,1280,16,719,689,30,140223,Донецька область
539,140224,257,3,151,148,3,140224,Донецька область
540,140225,323,6,180,163,17,140225,Донецька область
541,140226,802,8,444,385,59,140226,Донецька область
542,140227,377,4,235,212,23,140227,Донецька область
543,140228,373,2,230,213,17,140228,Донецька область
544,140229,447,6,270,239,31,140229,Донецька область
545,140230,244,1,117,105,12,140230,Донецька область
546,140231,147,0,68,64,4,140231,Донецька область
547,140232,215,2,149,117,32,140232,Донецька область
548,140233,1060,17,675,605,70,140233,Донецька область
549,140234,857,14,530,489,41,140234,Донецька область
550,140235,288,5,159,151,8,140235,Донецька область
551,140236,443,3,308,270,38,140236,Донецька область
552,140237,576,5,387,361,26,140237,Донецька область
553,140238,208,0,126,121,5,140238,Донецька область
554,140239,669,0,372,328,44,140239,Донецька область
555,140240,575,5,295,240,55,140240,Донецька область
556,140243,135,1,78,73,5,140243,Донецька область
557,140244,350,6,220,200,20,140244,Донецька область
558,140245,304,2,211,205,6,140245,Донецька область
559,140738,1722,25,746,689,57,140738,Донецька область
560,140739,1819,18,1037,972,65,140739,Донецька область
561,140740,1629,21,880,836,44,140740,Донецька область
562,140741,1447,22,752,705,47,140741,Донецька область
563,140742,1931,37,1019,965,54,140742,Донецька область
564,140743,1591,18,886,808,78,140743,Донецька область
565,140744,1377,13,749,693,56,140744,Донецька область
566,140745,1765,28,986,931,55,140745,Донецька область
567,140746,1998,21,1388,1017,371,140746,Донецька область
568,140747,1887,20,1078,1006,72,140747,Донецька область
569,140748,1953,28,1122,1027,95,140748,Донецька область
570,140749,2140,12,1147,1091,56,140749,Донецька область
571,140750,2097,24,1237,1135,102,140750,Донецька область
572,140751,1900,18,1070,1003,67,140751,Донецька область
573,140752,1556,21,807,755,52,140752,Донецька область
574,140753,2013,29,1128,1037,91,140753,Донецька область
575,140754,1971,23,1066,998,68,140754,Донецька область
576,140755,2025,19,1039,990,49,140755,Донецька область
577,140756,1846,31,968,883,85,140756,Донецька область
578,140757,1655,27,912,852,60,140757,Донецька область
579,140758,92,2,85,84,1,140758,Донецька область
580,140759,34,2,32,30,2,140759,Донецька область
581,140760,1834,25,1156,1074,82,140760,Донецька область
582,140761,720,14,416,383,33,140761,Донецька область
583,140762,2289,21,1339,1223,116,140762,Донецька область
584,140763,2226,32,1358,1265,93,140763,Донецька область
585,140764,1924,33,1183,1064,119,140764,Донецька область
586,140765,1594,26,948,878,70,140765,Донецька область
587,140766,1661,24,973,909,64,140766,Донецька область
588,140767,1559,25,981,897,84,140767,Донецька область
589,140768,1684,21,1080,992,88,140768,Донецька область
590,140769,1954,27,1250,1152,98,140769,Донецька область
591,140770,1352,25,838,775,63,140770,Донецька область
592,140771,1954,36,1145,1074,71,140771,Донецька область
593,140772,2026,36,1152,1078,74,140772,Донецька область
594,140773,1722,24,965,899,66,140773,Донецька область
595,140774,1337,13,820,752,68,140774,Донецька область
596,140775,1139,24,646,588,58,140775,Донецька область
597,140776,1156,18,643,578,65,140776,Донецька область
598,140777,1457,15,779,739,40,140777,Донецька область
599,140778,1602,14,1007,952,55,140778,Донецька область
600,140779,1060,22,631,588,43,140779,Донецька область
601,140780,1609,21,894,851,43,140780,Донецька область
602,140781,1553,15,969,902,67,140781,Донецька область
603,140782,1708,16,1013,971,42,140782,Донецька область
604,140783,1567,11,903,868,35,140783,Донецька область
605,140784,1455,15,823,777,46,140784,Донецька область
606,140785,1165,11,658,619,39,140785,Донецька область
607,140786,1296,20,789,740,49,140786,Донецька область
608,140787,1832,24,1095,1053,42,140787,Донецька область
609,140788,1913,27,1092,1056,36,140788,Донецька область
610,140789,126,2,119,107,12,140789,Донецька область
611,141059,1521,18,962,922,40,141059,Донецька область
612,141060,1559,25,935,894,41,141060,Донецька область
613,141061,1464,25,862,823,39,141061,Донецька область
614,141062,1831,14,1104,1047,57,141062,Донецька область
615,141063,1392,26,777,734,43,141063,Донецька область
616,141064,1283,14,687,645,42,141064,Донецька область
617,141065,713,10,455,425,30,141065,Донецька область
618,141066,1450,34,793,748,45,141066,Донецька область
619,141067,1291,15,761,712,49,141067,Донецька область
620,141068,2132,21,1133,1050,83,141068,Донецька область
621,141069,2192,21,1209,1129,80,141069,Донецька область
622,141070,1272,8,621,592,29,141070,Донецька область
623,141071,2027,29,1232,1162,70,141071,Донецька область
624,141072,1409,18,633,589,44,141072,Донецька область
625,141073,2031,29,1086,1007,79,141073,Донецька область
626,141074,1316,27,765,672,93,141074,Донецька область
627,141075,1368,22,780,709,71,141075,Донецька область
628,141076,1366,20,799,696,103,141076,Донецька область
629,141077,2099,26,1156,1069,87,141077,Донецька область
630,141079,2155,18,1025,953,72,141079,Донецька область
631,141080,1522,14,808,760,48,141080,Донецька область
632,141082,1385,20,850,742,108,141082,Донецька область
633,141083,1546,21,913,845,68,141083,Донецька область
634,141084,1320,13,757,689,68,141084,Донецька область
635,141085,2019,25,1111,1015,96,141085,Донецька область
636,141086,2020,26,1266,1161,105,141086,Донецька область
637,141087,1977,35,1174,1077,97,141087,Донецька область
638,141088,1960,33,1188,1102,86,141088,Донецька область
639,141089,2070,29,1221,1138,83,141089,Донецька область
640,141090,2066,20,1292,1199,93,141090,Донецька область
641,141091,1905,28,1093,1017,76,141091,Донецька область
642,141092,1999,13,1220,1142,78,141092,Донецька область
643,141093,1972,24,1262,1168,94,141093,Донецька область
644,141094,707,16,405,374,31,141094,Донецька область
645,141095,68,0,59,55,4,141095,Донецька область
646,141096,31,0,28,27,1,141096,Донецька область
647,141097,22,0,22,21,1,141097,Донецька область
648,141523,471,8,214,137,77,141523,Донецька область
649,141527,2210,1,288,196,92,141527,Донецька область
650,1,610,22,539,152,387,1,Донецька область
651,2,254,40,211,63,148,2,Донецька область
652,3,198,3,192,79,113,3,Донецька область
653,140681,1818,23,722,684,38,140681,Донецька область
654,140682,1907,39,757,715,42,140682,Донецька область
655,140683,1577,26,698,648,50,140683,Донецька область
656,140684,2102,29,1013,963,50,140684,Донецька область
657,140685,2016,30,906,874,32,140685,Донецька область
658,140686,1915,33,928,887,41,140686,Донецька область
659,140687,2267,47,1035,982,53,140687,Донецька область
660,140690,53,2,43,41,2,140690,Донецька область
661,140691,1073,20,475,376,99,140691,Донецька область
662,140692,1008,23,514,474,40,140692,Донецька область
663,140693,807,14,408,391,17,140693,Донецька область
664,140694,1266,9,603,559,44,140694,Донецька область
665,140695,1188,21,505,461,44,140695,Донецька область
666,140696,1479,28,691,652,39,140696,Донецька область
667,140697,1615,18,864,804,60,140697,Донецька область
668,140698,1606,29,786,731,55,140698,Донецька область
669,140699,1094,27,544,498,46,140699,Донецька область
670,140700,1046,13,491,468,23,140700,Донецька область
671,140701,1300,17,561,511,50,140701,Донецька область
672,140702,1588,33,775,725,50,140702,Донецька область
673,140703,1258,25,640,543,97,140703,Донецька область
674,140704,761,7,252,236,16,140704,Донецька область
675,140705,829,11,334,323,11,140705,Донецька область
676,140706,827,11,300,277,23,140706,Донецька область
677,140707,965,14,351,310,41,140707,Донецька область
678,140708,452,5,176,158,18,140708,Донецька область
679,140709,1582,24,693,572,121,140709,Донецька область
680,140710,1769,40,821,769,52,140710,Донецька область
681,140711,1659,27,727,674,53,140711,Донецька область
682,140712,597,6,193,183,10,140712,Донецька область
683,140713,981,12,394,374,20,140713,Донецька область
684,140714,1093,11,423,394,29,140714,Донецька область
685,140717,785,8,233,204,29,140717,Донецька область
686,140718,1518,17,539,517,22,140718,Донецька область
687,140719,876,7,299,274,25,140719,Донецька область
688,140720,1908,26,882,829,53,140720,Донецька область
689,140721,1743,26,768,740,28,140721,Донецька область
690,140722,1163,25,535,487,48,140722,Донецька область
691,140723,800,14,416,389,27,140723,Донецька область
692,140724,1341,26,841,733,108,140724,Донецька область
693,140725,1331,21,661,603,58,140725,Донецька область
694,140726,601,8,287,269,18,140726,Донецька область
695,140727,1292,16,527,493,34,140727,Донецька область
696,140728,1522,29,661,616,45,140728,Донецька область
697,140729,624,14,318,294,24,140729,Донецька область
698,140730,656,6,289,256,33,140730,Донецька область
699,140731,449,3,256,218,38,140731,Донецька область
700,140732,422,6,223,197,26,140732,Донецька область
701,140733,1145,0,687,631,56,140733,Донецька область
702,140734,1024,11,510,466,44,140734,Донецька область
703,140735,656,7,368,340,28,140735,Донецька область
704,140736,68,3,64,53,11,140736,Донецька область
705,140737,544,38,493,475,18,140737,Донецька область
706,1,432,39,393,380,13,1,Донецька область
707,2,903,23,681,521,160,2,Донецька область
708,3,607,19,581,262,319,3,Донецька область
709,4,1942,32,1291,754,537,4,Донецька область
710,5,897,21,833,521,312,5,Донецька область
711,142297,1750,15,1020,983,37,142297,Донецька область
712,142298,1531,7,817,794,23,142298,Донецька область
713,142299,1382,18,808,754,54,142299,Донецька область
714,142300,1361,8,756,726,30,142300,Донецька область
715,142301,572,1,273,265,8,142301,Донецька область
716,142302,1333,5,847,798,49,142302,Донецька область
717,142303,1584,21,1026,954,72,142303,Донецька область
718,142304,1923,17,1169,1084,85,142304,Донецька область
719,142305,1919,14,1211,1125,86,142305,Донецька область
720,142306,1748,17,1023,959,64,142306,Донецька область
721,142307,1950,13,1229,1135,94,142307,Донецька область
722,142308,1781,38,1010,940,70,142308,Донецька область
723,142309,1791,18,1058,1007,51,142309,Донецька область
724,142310,1263,12,502,483,19,142310,Донецька область
725,142311,1266,20,573,535,38,142311,Донецька область
726,142312,1714,21,1084,1000,84,142312,Донецька область
727,142313,1602,21,966,899,67,142313,Донецька область
728,142314,1827,28,992,945,47,142314,Донецька область
729,142315,1742,26,896,835,61,142315,Донецька область
730,142316,1121,20,641,608,33,142316,Донецька область
731,142317,1253,11,674,625,49,142317,Донецька область
732,142318,907,13,466,441,25,142318,Донецька область
733,142319,1607,14,783,759,24,142319,Донецька область
734,142320,922,6,434,397,37,142320,Донецька область
735,142321,936,15,485,461,24,142321,Донецька область
736,142322,1101,13,532,507,25,142322,Донецька область
737,142323,1629,29,894,829,65,142323,Донецька область
738,142324,987,21,529,511,18,142324,Донецька область
739,142325,1262,9,687,670,17,142325,Донецька область
740,142326,1688,30,840,789,51,142326,Донецька область
741,142327,2003,22,917,879,38,142327,Донецька область
742,142328,618,6,331,315,16,142328,Донецька область
743,142329,1134,17,608,587,21,142329,Донецька область
744,142330,1152,11,645,622,23,142330,Донецька область
745,142331,1183,13,686,668,18,142331,Донецька область
746,142332,835,12,525,507,18,142332,Донецька область
747,142333,1507,18,926,889,37,142333,Донецька область
748,142334,1403,18,826,776,50,142334,Донецька область
749,142335,1589,27,874,838,36,142335,Донецька область
750,142337,1643,19,985,926,59,142337,Донецька область
751,142338,1313,20,713,674,39,142338,Донецька область
752,142339,1075,13,564,517,47,142339,Донецька область
753,142340,1368,10,696,649,47,142340,Донецька область
754,142341,2015,29,1173,1114,59,142341,Донецька область
755,142342,1192,19,685,641,44,142342,Донецька область
756,142343,1462,20,821,789,32,142343,Донецька область
757,142344,2220,18,1241,1204,37,142344,Донецька область
758,142345,2305,15,1270,1228,42,142345,Донецька область
759,142346,2122,16,1165,1136,29,142346,Донецька область
760,142347,1172,13,623,602,21,142347,Донецька область
761,142348,1555,16,860,843,17,142348,Донецька область
762,142349,372,3,202,197,5,142349,Донецька область
763,142351,27,0,27,21,6,142351,Донецька область
764,142352,141,9,129,122,7,142352,Донецька область
765,142353,30,0,28,28,0,142353,Донецька область
766,142355,71,2,69,67,2,142355,Донецька область
767,142356,569,3,308,283,25,142356,Донецька область
768,142357,1473,18,859,785,74,142357,Донецька область
769,142358,1564,23,901,833,68,142358,Донецька область
770,142359,2010,33,1216,1142,74,142359,Донецька область
771,142360,1776,24,1077,990,87,142360,Донецька область
772,142361,1061,13,597,549,48,142361,Донецька область
773,142362,1008,17,593,554,39,142362,Донецька область
774,142363,1468,22,936,863,73,142363,Донецька область
775,142364,1434,16,851,780,71,142364,Донецька область
776,142365,1548,31,871,812,59,142365,Донецька область
777,142366,1642,21,933,856,77,142366,Донецька область
778,142367,1681,10,1069,990,79,142367,Донецька область
779,142368,1718,23,1023,939,84,142368,Донецька область
780,142369,1837,8,709,667,42,142369,Донецька область
781,142370,1784,22,1008,936,72,142370,Донецька область
782,142371,1036,12,618,582,36,142371,Донецька область
783,142372,1256,19,755,703,52,142372,Донецька область
784,142373,1192,25,725,656,69,142373,Донецька область
785,142374,1099,17,649,608,41,142374,Донецька область
786,142375,1248,12,743,681,62,142375,Донецька область
787,142376,1124,14,668,612,56,142376,Донецька область
788,142377,1632,11,770,728,42,142377,Донецька область
789,142378,1329,17,737,691,46,142378,Донецька область
790,142379,1337,17,808,751,57,142379,Донецька область
791,142380,1365,11,838,793,45,142380,Донецька область
792,142381,1718,21,1022,965,57,142381,Донецька область
793,142382,1694,22,1009,935,74,142382,Донецька область
794,142383,1449,22,753,705,48,142383,Донецька область
795,142384,1535,25,922,847,75,142384,Донецька область
796,142385,1747,14,957,898,59,142385,Донецька область
797,142386,1651,20,883,832,51,142386,Донецька область
798,142387,2080,31,1187,1090,97,142387,Донецька область
799,142388,1776,24,1097,1022,75,142388,Донецька область
800,142389,1784,17,1078,1003,75,142389,Донецька область
801,142390,1056,16,637,597,40,142390,Донецька область
802,142391,1165,15,690,640,50,142391,Донецька область
803,142392,1286,23,751,697,54,142392,Донецька область
804,142393,1623,20,897,839,58,142393,Донецька область
805,142394,1825,26,1028,957,71,142394,Донецька область
806,142395,1914,24,1104,1039,65,142395,Донецька область
807,142396,1685,20,984,912,72,142396,Донецька область
808,142397,1579,18,984,935,49,142397,Донецька область
809,142398,1485,15,910,862,48,142398,Донецька область
810,142399,2005,32,1121,1050,71,142399,Донецька область
811,142400,1148,14,715,677,38,142400,Донецька область
812,142401,1446,16,861,810,51,142401,Донецька область
813,142402,2149,29,1230,1170,60,142402,Донецька область
814,142403,2380,31,1370,1299,71,142403,Донецька область
815,142404,1409,19,803,745,58,142404,Донецька область
816,142405,2129,26,1218,1142,76,142405,Донецька область
817,142406,1436,21,872,812,60,142406,Донецька область
818,142407,2119,26,1237,1172,65,142407,Донецька область
819,142408,118,1,106,96,10,142408,Донецька область
820,142409,60,1,58,54,4,142409,Донецька область
821,142410,126,0,93,85,8,142410,Донецька область
822,142411,177,10,164,145,19,142411,Донецька область
823,142227,1048,16,541,519,22,142227,Донецька область
824,142228,1180,8,560,552,8,142228,Донецька область
825,142229,1459,15,891,819,72,142229,Донецька область
826,142230,1462,19,908,861,47,142230,Донецька область
827,142231,1173,11,608,576,32,142231,Донецька область
828,142232,1917,19,1212,1130,82,142232,Донецька область
829,142233,1894,29,1006,928,78,142233,Донецька область
830,142234,1214,16,785,736,49,142234,Донецька область
831,142235,2028,29,1282,1164,118,142235,Донецька область
832,142236,2273,16,1140,1040,100,142236,Донецька область
833,142237,1103,20,645,583,62,142237,Донецька область
834,142238,1071,19,629,524,105,142238,Донецька область
835,142239,2213,48,1326,1174,152,142239,Донецька область
836,142240,1591,14,855,764,91,142240,Донецька область
837,142241,682,8,385,331,54,142241,Донецька область
838,142242,1982,25,1122,1015,107,142242,Донецька область
839,142243,1279,20,725,623,102,142243,Донецька область
840,142244,1792,33,1073,925,148,142244,Донецька область
841,142245,1462,31,855,786,69,142245,Донецька область
842,142246,1549,22,890,799,91,142246,Донецька область
843,142247,1257,18,773,688,85,142247,Донецька область
844,142248,1682,22,1032,927,105,142248,Донецька область
845,142249,2039,26,1175,1079,96,142249,Донецька область
846,142250,1455,27,849,780,69,142250,Донецька область
847,142251,1152,16,719,669,50,142251,Донецька область
848,142252,1995,29,1358,1243,115,142252,Донецька область
849,142253,2119,29,1266,1150,116,142253,Донецька область
850,142254,1846,35,1153,1062,91,142254,Донецька область
851,142255,1852,22,1083,977,106,142255,Донецька область
852,142256,1869,26,1100,1012,88,142256,Донецька область
853,142257,1924,21,1198,1093,105,142257,Донецька область
854,142258,968,22,567,512,55,142258,Донецька область
855,142259,2192,28,1335,1221,114,142259,Донецька область
856,142260,2061,25,1219,1108,111,142260,Донецька область
857,142261,2011,13,1218,1128,90,142261,Донецька область
858,142262,2002,24,1220,1125,95,142262,Донецька область
859,142263,2032,27,1275,1158,117,142263,Донецька область
860,142264,1973,29,1208,1107,101,142264,Донецька область
861,142265,939,9,595,548,47,142265,Донецька область
862,142266,1905,29,1222,1133,89,142266,Донецька область
863,142267,1562,23,944,873,71,142267,Донецька область
864,142268,2044,26,1307,1198,109,142268,Донецька область
865,142269,2100,36,1207,1130,77,142269,Донецька область
866,142270,2193,24,1323,1213,110,142270,Донецька область
867,142271,1176,7,652,614,38,142271,Донецька область
868,142272,1754,22,1111,1017,94,142272,Донецька область
869,142273,1987,33,1304,1218,86,142273,Донецька область
870,142274,1930,22,1156,1070,86,142274,Донецька область
871,142275,1797,23,1113,1029,84,142275,Донецька область
872,142276,1817,21,1109,1026,83,142276,Донецька область
873,142277,1851,11,1182,1102,80,142277,Донецька область
874,142278,2044,27,1197,1112,85,142278,Донецька область
875,142279,1442,13,874,792,82,142279,Донецька область
876,142280,1953,26,1208,1116,92,142280,Донецька область
877,142281,2173,40,1338,1249,89,142281,Донецька область
878,142282,2198,26,1335,1236,99,142282,Донецька область
879,142283,2035,30,1209,1116,93,142283,Донецька область
880,142284,1817,20,1090,1039,51,142284,Донецька область
881,142285,2073,31,1306,1225,81,142285,Донецька область
882,142286,2080,29,1366,1278,88,142286,Донецька область
883,142287,1381,20,809,763,46,142287,Донецька область
884,142288,1216,12,677,645,32,142288,Донецька область
885,142289,2053,22,1128,1036,92,142289,Донецька область
886,142290,1272,7,681,642,39,142290,Донецька область
887,142291,1328,8,721,675,46,142291,Донецька область
888,142292,1955,23,1121,1066,55,142292,Донецька область
889,142293,144,3,95,87,8,142293,Донецька область
890,142294,16,0,16,14,2,142294,Донецька область
891,142295,32,1,30,27,3,142295,Донецька область
892,142296,90,0,77,70,7,142296,Донецька область
893,142412,1658,19,899,824,75,142412,Донецька область
894,142413,932,9,564,503,61,142413,Донецька область
895,142414,1415,13,868,788,80,142414,Донецька область
896,142415,1717,34,939,845,94,142415,Донецька область
897,142416,1765,26,1021,907,114,142416,Донецька область
898,142417,1591,20,935,861,74,142417,Донецька область
899,142418,1303,29,712,653,59,142418,Донецька область
900,142419,1857,38,1026,954,72,142419,Донецька область
901,142420,1528,26,948,868,80,142420,Донецька область
902,142421,1618,36,928,824,104,142421,Донецька область
903,142422,1593,35,887,802,85,142422,Донецька область
904,142423,1616,10,877,784,93,142423,Донецька область
905,142424,1351,9,775,715,60,142424,Донецька область
906,142425,1931,23,1167,1079,88,142425,Донецька область
907,142426,2000,21,1217,1125,92,142426,Донецька область
908,142427,1231,18,680,626,54,142427,Донецька область
909,142428,2114,29,1268,1141,127,142428,Донецька область
910,142429,2069,28,1263,1141,122,142429,Донецька область
911,142430,1243,17,688,614,74,142430,Донецька область
912,142431,1671,24,930,862,68,142431,Донецька область
913,142432,1497,17,818,750,68,142432,Донецька область
914,142433,1681,10,907,798,109,142433,Донецька область
915,142434,1185,17,606,571,35,142434,Донецька область
916,142435,1877,28,1183,1072,111,142435,Донецька область
917,142436,1723,13,902,852,50,142436,Донецька область
918,142437,1763,28,861,785,76,142437,Донецька область
919,142438,30,0,27,15,12,142438,Донецька область
920,142439,134,1,115,103,12,142439,Донецька область
921,1,137,7,121,87,34,1,Донецька область
922,2,167,1,166,44,122,2,Донецька область
923,3,260,21,233,33,200,3,Донецька область
924,4,163,1,162,31,131,4,Донецька область
925,5,228,10,216,25,191,5,Донецька область
926,6,266,5,260,15,245,6,Донецька область
927,7,83,0,83,23,60,7,Донецька область
928,8,325,6,307,126,181,8,Донецька область
929,9,875,101,767,363,404,9,Донецька область
930,10,346,22,316,82,234,10,Донецька область
931,11,294,10,283,135,148,11,Донецька область
932,12,251,23,227,92,135,12,Донецька область
933,13,380,14,360,125,235,13,Донецька область
934,14,100,4,96,37,59,14,Донецька область
935,15,604,17,587,280,307,15,Донецька область
936,140087,868,13,446,386,60,140087,Донецька область
937,140088,1388,17,934,743,191,140088,Донецька область
938,140089,1959,21,1063,938,125,140089,Донецька область
939,140090,1417,26,778,714,64,140090,Донецька область
940,140091,879,17,546,460,86,140091,Донецька область
941,140093,491,8,300,231,69,140093,Донецька область
942,140094,477,4,321,257,64,140094,Донецька область
943,140095,875,9,459,430,29,140095,Донецька область
944,140096,309,5,155,140,15,140096,Донецька область
945,140097,1117,27,696,633,63,140097,Донецька область
946,140098,650,12,482,400,82,140098,Донецька область
947,140099,328,10,215,199,16,140099,Донецька область
948,140100,511,3,345,280,65,140100,Донецька область
949,140102,489,5,370,293,77,140102,Донецька область
950,140103,561,12,389,291,98,140103,Донецька область
951,140104,1299,27,683,633,50,140104,Донецька область
952,140105,560,5,320,267,53,140105,Донецька область
953,140107,763,7,463,432,31,140107,Донецька область
954,140108,561,7,361,318,43,140108,Донецька область
955,140109,586,13,422,344,78,140109,Донецька область
956,140110,1478,30,796,709,87,140110,Донецька область
957,140111,994,7,488,427,61,140111,Донецька область
958,140112,376,3,245,203,42,140112,Донецька область
959,140113,441,4,307,276,31,140113,Донецька область
960,140114,556,5,426,389,37,140114,Донецька область
961,140115,462,5,304,297,7,140115,Донецька область
962,140116,397,6,249,221,28,140116,Донецька область
963,140117,738,8,534,445,89,140117,Донецька область
964,140118,203,2,153,116,37,140118,Донецька область
965,140119,284,0,152,124,28,140119,Донецька область
966,140120,645,13,397,359,38,140120,Донецька область
967,140121,457,6,310,263,47,140121,Донецька область
968,140122,693,9,401,367,34,140122,Донецька область
969,140123,221,4,126,118,8,140123,Донецька область
970,140124,506,11,316,268,48,140124,Донецька область
971,140125,176,6,121,100,21,140125,Донецька область
972,140126,683,10,445,352,93,140126,Донецька область
973,140127,1229,17,638,521,117,140127,Донецька область
974,140128,1074,12,594,530,64,140128,Донецька область
975,140130,393,1,238,190,48,140130,Донецька область
976,140131,202,3,147,115,32,140131,Донецька область
977,140132,731,11,402,376,26,140132,Донецька область
978,140133,262,3,208,170,38,140133,Донецька область
979,140134,273,3,206,159,47,140134,Донецька область
980,140135,385,9,301,254,47,140135,Донецька область
981,140136,885,9,625,478,147,140136,Донецька область
982,140306,1802,66,720,567,153,140306,Донецька область
983,140307,1532,35,710,533,177,140307,Донецька область
984,140308,1144,5,472,223,249,140308,Донецька область
985,140309,1328,16,692,418,274,140309,Донецька область
986,140310,1312,53,369,339,30,140310,Донецька область
987,140311,1075,0,563,384,179,140311,Донецька область
988,140312,832,4,668,381,287,140312,Донецька область
989,140313,1222,7,543,260,283,140313,Донецька область
990,140314,1064,7,737,230,507,140314,Донецька область
991,140315,1348,25,570,386,184,140315,Донецька область
992,140316,1353,21,723,259,464,140316,Донецька область
993,140317,1477,25,716,258,458,140317,Донецька область
994,140318,1128,6,548,162,386,140318,Донецька область
995,140319,947,9,362,236,126,140319,Донецька область
996,140320,953,8,380,219,161,140320,Донецька область
997,140321,1557,29,859,809,50,140321,Донецька область
998,140322,1937,37,1087,1009,78,140322,Донецька область
999,140323,1788,26,938,866,72,140323,Донецька область
1000,140324,1591,23,919,824,95,140324,Донецька область
1001,140325,1374,17,650,598,52,140325,Донецька область
1002,140326,1648,32,861,803,58,140326,Донецька область
1003,140327,1918,20,1051,965,86,140327,Донецька область
1004,140328,1561,31,785,704,81,140328,Донецька область
1005,140329,611,5,239,223,16,140329,Донецька область
1006,140330,867,4,392,361,31,140330,Донецька область
1007,140331,465,3,204,190,14,140331,Донецька область
1008,140332,282,4,190,124,66,140332,Донецька область
1009,140338,1057,13,522,482,40,140338,Донецька область
1010,140339,1151,21,640,424,216,140339,Донецька область
1011,140340,1277,21,606,570,36,140340,Донецька область
1012,140341,384,10,166,141,25,140341,Донецька область
1013,140342,286,0,256,174,82,140342,Донецька область
1014,140343,286,6,220,141,79,140343,Донецька область
1015,140344,1402,36,698,624,74,140344,Донецька область
1016,140345,997,15,463,383,80,140345,Донецька область
1017,140346,851,10,487,418,69,140346,Донецька область
1018,140347,995,14,600,430,170,140347,Донецька область
1019,140350,1567,27,757,670,87,140350,Донецька область
1020,140351,790,27,346,304,42,140351,Донецька область
1021,140352,1154,22,472,418,54,140352,Донецька область
1022,140353,959,12,494,469,25,140353,Донецька область
1023,140354,1069,5,602,519,83,140354,Донецька область
1024,140355,468,4,322,267,55,140355,Донецька область
1025,140356,465,8,330,250,80,140356,Донецька область
1026,140357,1709,28,959,870,89,140357,Донецька область
1027,140358,1008,31,538,434,104,140358,Донецька область
1028,140359,344,8,204,154,50,140359,Донецька область
1029,140360,240,5,151,133,18,140360,Донецька область
1030,140361,389,8,242,193,49,140361,Донецька область
1031,140362,665,6,410,309,101,140362,Донецька область
1032,140364,30,0,29,23,6,140364,Донецька область
1033,140365,101,1,85,75,10,140365,Донецька область
1034,140662,2259,37,1242,1151,91,140662,Донецька область
1035,140663,1647,20,957,884,73,140663,Донецька область
1036,140664,1689,23,976,907,69,140664,Донецька область
1037,140665,1697,23,1025,938,87,140665,Донецька область
1038,140666,1683,18,1018,952,66,140666,Донецька область
1039,140667,1640,29,945,863,82,140667,Донецька область
1040,140668,1634,17,935,863,72,140668,Донецька область
1041,141145,905,14,504,458,46,141145,Донецька область
1042,141146,1102,15,592,568,24,141146,Донецька область
1043,141147,856,3,482,436,46,141147,Донецька область
1044,141148,1785,25,917,858,59,141148,Донецька область
1045,141149,2133,29,1112,1063,49,141149,Донецька область
1046,141150,1824,19,904,839,65,141150,Донецька область
1047,141151,1320,28,768,637,131,141151,Донецька область
1048,141152,1221,22,634,579,55,141152,Донецька область
1049,141153,1409,16,782,707,75,141153,Донецька область
1050,141154,1453,22,805,630,175,141154,Донецька область
1051,141155,1714,25,933,873,60,141155,Донецька область
1052,141156,1058,12,517,482,35,141156,Донецька область
1053,141157,1826,20,958,879,79,141157,Донецька область
1054,141158,1568,21,819,744,75,141158,Донецька область
1055,141159,1916,30,1099,980,119,141159,Донецька область
1056,141160,1252,22,656,592,64,141160,Донецька область
1057,141161,1640,20,833,718,115,141161,Донецька область
1058,141162,1682,9,913,840,73,141162,Донецька область
1059,141163,1515,20,834,794,40,141163,Донецька область
1060,141164,1516,16,761,728,33,141164,Донецька область
1061,141165,203,3,121,106,15,141165,Донецька область
1062,141166,264,9,204,120,84,141166,Донецька область
1063,141167,1706,20,830,786,44,141167,Донецька область
1064,141168,1603,32,666,633,33,141168,Донецька область
1065,141169,1454,28,695,628,67,141169,Донецька область
1066,141170,1134,74,707,645,62,141170,Донецька область
1067,141171,1462,8,687,645,42,141171,Донецька область
1068,141172,1421,22,517,477,40,141172,Донецька область
1069,141173,2148,32,912,853,59,141173,Донецька область
1070,141174,1454,25,685,647,38,141174,Донецька область
1071,141175,1454,11,585,567,18,141175,Донецька область
1072,141176,1777,30,816,736,80,141176,Донецька область
1073,141177,662,4,300,279,21,141177,Донецька область
1074,141178,1533,18,633,591,42,141178,Донецька область
1075,141179,1100,13,447,410,37,141179,Донецька область
1076,141180,546,3,266,252,14,141180,Донецька область
1077,141181,938,15,630,598,32,141181,Донецька область
1078,141182,542,4,268,248,20,141182,Донецька область
1079,141183,706,43,638,607,31,141183,Донецька область
1080,1,541,28,500,227,273,1,Донецька область
1081,2,767,25,669,382,287,2,Донецька область
1082,3,341,18,319,122,197,3,Донецька область
1083,4,307,28,231,133,98,4,Донецька область
1084,5,272,26,245,118,127,5,Донецька область
1085,6,94,3,82,31,51,6,Донецька область
1086,7,773,76,634,402,232,7,Донецька область
1087,8,318,25,293,102,191,8,Донецька область
1088,9,489,36,437,209,228,9,Донецька область
1089,10,194,3,183,74,109,10,Донецька область
1090,11,106,4,100,42,58,11,Донецька область
1091,12,318,15,285,209,76,12,Донецька область
1092,13,224,5,214,132,82,13,Донецька область
1093,14,122,6,112,94,18,14,Донецька область
1094,15,492,23,263,154,109,15,Донецька область
1095,16,319,12,272,47,225,16,Донецька область
1096,140137,1396,17,745,703,42,140137,Донецька область
1097,140138,1475,11,827,772,55,140138,Донецька область
1098,140139,1146,27,667,628,39,140139,Донецька область
1099,140140,1236,17,680,653,27,140140,Донецька область
1100,140141,1492,19,885,809,76,140141,Донецька область
1101,140142,1918,27,1098,984,114,140142,Донецька область
1102,140143,2229,40,1261,1093,168,140143,Донецька область
1103,140144,1238,21,667,598,69,140144,Донецька область
1104,140145,1233,15,671,600,71,140145,Донецька область
1105,140146,1627,23,891,819,72,140146,Донецька область
1106,140147,2279,32,1364,1232,132,140147,Донецька область
1107,140148,1070,25,502,468,34,140148,Донецька область
1108,140149,1966,23,953,902,51,140149,Донецька область
1109,140150,1772,27,757,704,53,140150,Донецька область
1110,140151,1301,16,640,554,86,140151,Донецька область
1111,140152,1921,24,1135,1089,46,140152,Донецька область
1112,140153,1930,17,1139,1070,69,140153,Донецька область
1113,140154,1682,31,833,740,93,140154,Донецька область
1114,140155,1763,35,679,627,52,140155,Донецька область
1115,140156,1941,27,946,866,80,140156,Донецька область
1116,140159,1769,56,641,565,76,140159,Донецька область
1117,140160,871,8,390,318,72,140160,Донецька область
1118,140161,558,11,409,348,61,140161,Донецька область
1119,140164,969,8,507,485,22,140164,Донецька область
1120,140165,922,20,521,452,69,140165,Донецька область
1121,140166,758,9,528,482,46,140166,Донецька область
1122,140167,918,12,461,452,9,140167,Донецька область
1123,140168,630,12,409,388,21,140168,Донецька область
1124,140169,421,3,251,227,24,140169,Донецька область
1125,140170,374,6,198,186,12,140170,Донецька область
1126,140171,2289,29,1033,988,45,140171,Донецька область
1127,140172,690,5,358,324,34,140172,Донецька область
1128,140173,433,1,253,238,15,140173,Донецька область
1129,140174,692,4,385,366,19,140174,Донецька область
1130,140175,580,7,424,322,102,140175,Донецька область
1131,140177,1450,16,763,704,59,140177,Донецька область
1132,140178,994,20,523,491,32,140178,Донецька область
1133,140179,537,6,256,238,18,140179,Донецька область
1134,140180,453,4,257,251,6,140180,Донецька область
1135,140181,554,8,310,292,18,140181,Донецька область
1136,140182,447,8,227,201,26,140182,Донецька область
1137,140183,651,11,407,360,47,140183,Донецька область
1138,140184,715,9,427,383,44,140184,Донецька область
1139,140185,597,7,334,302,32,140185,Донецька область
1140,140186,519,4,276,254,22,140186,Донецька область
1141,140187,1074,16,586,546,40,140187,Донецька область
1142,140188,950,21,514,498,16,140188,Донецька область
1143,140189,487,6,193,183,10,140189,Донецька область
1144,140190,645,13,390,335,55,140190,Донецька область
1145,140191,1248,18,827,792,35,140191,Донецька область
1146,140192,758,16,515,465,50,140192,Донецька область
1147,140193,920,10,555,509,46,140193,Донецька область
1148,140194,119,2,114,104,10,140194,Донецька область
1149,140196,1542,21,941,891,50,140196,Донецька область
1150,140197,1725,27,1059,1002,57,140197,Донецька область
1151,140198,1696,18,998,958,40,140198,Донецька область
1152,140199,1530,19,1083,1014,69,140199,Донецька область
1153,140200,358,2,241,238,3,140200,Донецька область
1154,140201,726,3,483,454,29,140201,Донецька область
1155,140202,771,11,477,450,27,140202,Донецька область
1156,140203,330,3,224,173,51,140203,Донецька область
1157,140204,508,3,392,369,23,140204,Донецька область
1158,140205,372,2,233,216,17,140205,Донецька область
1159,140206,1884,20,1174,1106,68,140206,Донецька область
1160,140207,1055,11,639,620,19,140207,Донецька область
1161,140208,398,3,233,219,14,140208,Донецька область
1162,140209,712,3,506,485,21,140209,Донецька область
1163,140210,843,8,631,608,23,140210,Донецька область
1164,140211,886,4,575,555,20,140211,Донецька область
1165,140212,1494,7,899,876,23,140212,Донецька область
1166,140213,389,5,215,206,9,140213,Донецька область
1167,140214,850,7,563,529,34,140214,Донецька область
1168,140215,823,4,518,465,53,140215,Донецька область
1169,140216,1331,18,927,904,23,140216,Донецька область
1170,140218,1241,15,687,644,43,140218,Донецька область
1171,140376,938,1,554,520,34,140376,Донецька область
1172,140377,847,10,482,466,16,140377,Донецька область
1173,140379,192,0,1,1,0,140379,Донецька область
1174,140382,731,5,381,368,13,140382,Донецька область
1175,140383,610,4,377,361,16,140383,Донецька область
1176,140384,493,2,284,257,27,140384,Донецька область
1177,140392,1024,5,249,212,37,140392,Донецька область
1178,140412,1059,8,704,649,55,140412,Донецька область
1179,140413,1032,9,621,578,43,140413,Донецька область
1180,140414,1171,7,768,710,58,140414,Донецька область
1181,140415,1140,6,737,680,57,140415,Донецька область
1182,140416,1066,12,686,636,50,140416,Донецька область
1183,140417,1205,12,728,718,10,140417,Донецька область
1184,140418,1791,21,1140,1092,48,140418,Донецька область
1185,140419,941,10,603,577,26,140419,Донецька область
1186,140420,266,8,177,164,13,140420,Донецька область
1187,140421,286,4,175,162,13,140421,Донецька область
1188,140422,1257,11,756,701,55,140422,Донецька область
1189,140423,638,7,374,340,34,140423,Донецька область
1190,140424,1335,10,785,732,53,140424,Донецька область
1191,140425,685,9,410,379,31,140425,Донецька область
1192,140426,568,2,357,317,40,140426,Донецька область
1193,140427,987,10,569,534,35,140427,Донецька область
1194,140428,613,3,372,339,33,140428,Донецька область
1195,140429,597,10,327,310,17,140429,Донецька область
1196,140430,522,4,315,299,16,140430,Донецька область
1197,140431,430,2,265,232,33,140431,Донецька область
1198,140432,1997,20,1234,1147,87,140432,Донецька область
1199,140520,1432,17,561,506,55,140520,Донецька область
1200,140521,1211,11,496,481,15,140521,Донецька область
1201,140527,1366,13,692,586,106,140527,Донецька область
1202,140528,654,5,448,436,12,140528,Донецька область
1203,140529,263,2,201,194,7,140529,Донецька область
1204,140530,291,3,223,180,43,140530,Донецька область
1205,140531,669,11,406,377,29,140531,Донецька область
1206,140532,1127,16,498,471,27,140532,Донецька область
1207,140533,1260,12,763,742,21,140533,Донецька область
1208,140534,190,2,124,117,7,140534,Донецька область
1209,140535,2038,12,1035,991,44,140535,Донецька область
1210,140537,432,2,205,185,20,140537,Донецька область
