,location,voters,spoiltvotes,votes,Зеленський Володимир,Порошенко Петро,tvk,region
0,50130,1694,16,1078,579,499,50130,Вінницька область
1,50131,2095,28,1278,751,527,50131,Вінницька область
2,50132,1281,14,798,471,327,50132,Вінницька область
3,50133,2422,37,1478,769,709,50133,Вінницька область
4,50134,222,0,132,77,55,50134,Вінницька область
5,50135,2414,43,1563,844,719,50135,Вінницька область
6,50137,1647,22,1048,587,461,50137,Вінницька область
7,50145,458,2,328,174,154,50145,Вінницька область
8,50149,373,9,248,149,99,50149,Вінницька область
9,50154,467,6,281,165,116,50154,Вінницька область
10,50155,679,13,471,235,236,50155,Вінницька область
11,50156,291,2,191,105,86,50156,Вінницька область
12,50161,386,4,257,143,114,50161,Вінницька область
13,50162,301,4,199,95,104,50162,Вінницька область
14,50164,1355,16,890,470,420,50164,Вінницька область
15,50165,1766,30,1096,541,555,50165,Вінницька область
16,50166,535,12,329,132,197,50166,Вінницька область
17,50167,745,10,413,228,185,50167,Вінницька область
18,50185,1933,33,1242,773,469,50185,Вінницька область
19,50186,1123,17,660,337,323,50186,Вінницька область
20,50187,132,0,95,51,44,50187,Вінницька область
21,50188,2473,23,1540,836,704,50188,Вінницька область
22,50189,390,9,267,148,119,50189,Вінницька область
23,50190,160,4,91,54,37,50190,Вінницька область
24,50191,78,4,74,54,20,50191,Вінницька область
25,50192,485,26,458,412,46,50192,Вінницька область
26,51477,2163,37,1389,787,602,51477,Вінницька область
27,51478,2398,60,1527,930,597,51478,Вінницька область
28,51479,2018,36,1160,698,462,51479,Вінницька область
29,51480,1609,33,996,574,422,51480,Вінницька область
30,51481,1522,32,1022,529,493,51481,Вінницька область
31,51482,2391,44,1539,890,649,51482,Вінницька область
32,51483,2112,40,1409,776,633,51483,Вінницька область
33,51484,2046,43,1370,736,634,51484,Вінницька область
34,51485,2166,40,1467,792,675,51485,Вінницька область
35,51486,1719,37,1171,640,531,51486,Вінницька область
36,51487,1617,35,1116,590,526,51487,Вінницька область
37,51489,1877,37,1146,691,455,51489,Вінницька область
38,51490,1972,33,1197,744,453,51490,Вінницька область
39,51491,1530,28,981,546,435,51491,Вінницька область
40,51492,2024,44,1281,719,562,51492,Вінницька область
41,51493,2013,32,1283,785,498,51493,Вінницька область
42,51494,1885,24,1189,698,491,51494,Вінницька область
43,51495,214,17,169,96,73,51495,Вінницька область
44,51496,1649,39,1071,633,438,51496,Вінницька область
45,51499,1772,27,1138,625,513,51499,Вінницька область
46,51500,2115,56,1384,793,591,51500,Вінницька область
47,51501,2057,35,1317,697,620,51501,Вінницька область
48,51502,2278,36,1539,848,691,51502,Вінницька область
49,51503,2390,37,1653,894,759,51503,Вінницька область
50,51504,2002,34,1223,828,395,51504,Вінницька область
51,51505,2011,39,1273,804,469,51505,Вінницька область
52,51506,2263,26,1431,857,574,51506,Вінницька область
53,51507,2241,49,1405,779,626,51507,Вінницька область
54,51508,1861,38,1189,698,491,51508,Вінницька область
55,51509,1988,35,1159,695,464,51509,Вінницька область
56,51510,1833,37,1190,671,519,51510,Вінницька область
57,51511,1917,32,1255,677,578,51511,Вінницька область
58,51512,2064,45,1354,710,644,51512,Вінницька область
59,51513,1940,45,1242,685,557,51513,Вінницька область
60,51514,1981,43,1296,793,503,51514,Вінницька область
61,51515,1979,48,1284,745,539,51515,Вінницька область
62,51516,1851,38,1128,682,446,51516,Вінницька область
63,51517,1962,49,1283,754,529,51517,Вінницька область
64,51518,2124,49,1455,821,634,51518,Вінницька область
65,51519,2113,31,1352,748,604,51519,Вінницька область
66,51520,2231,39,1322,735,587,51520,Вінницька область
67,51521,1914,40,1126,647,479,51521,Вінницька область
68,51522,1821,34,1219,640,579,51522,Вінницька область
69,51523,1927,36,1288,753,535,51523,Вінницька область
70,51524,1513,34,970,532,438,51524,Вінницька область
71,51525,1036,22,647,360,287,51525,Вінницька область
72,51526,1872,48,1226,705,521,51526,Вінницька область
73,51527,2063,45,1305,765,540,51527,Вінницька область
74,51528,1935,45,1223,734,489,51528,Вінницька область
75,51529,1970,37,1127,674,453,51529,Вінницька область
76,51530,2527,40,1686,916,770,51530,Вінницька область
77,51531,1586,26,949,573,376,51531,Вінницька область
78,51532,2119,36,1355,767,588,51532,Вінницька область
79,51533,2135,36,1405,805,600,51533,Вінницька область
80,51534,2346,49,1516,823,693,51534,Вінницька область
81,51535,1667,34,1062,655,407,51535,Вінницька область
82,51536,2043,53,1350,777,573,51536,Вінницька область
83,51537,1364,15,877,597,280,51537,Вінницька область
84,51538,2118,47,1360,813,547,51538,Вінницька область
85,51539,1486,61,989,585,404,51539,Вінницька область
86,51540,2083,40,1358,774,584,51540,Вінницька область
87,51541,1823,43,1108,690,418,51541,Вінницька область
88,51542,1711,21,1049,616,433,51542,Вінницька область
89,51543,1996,33,1201,735,466,51543,Вінницька область
90,51544,2019,51,1282,749,533,51544,Вінницька область
91,51545,2764,32,1905,1012,893,51545,Вінницька область
92,51546,2090,46,1208,799,409,51546,Вінницька область
93,51547,2009,36,1316,861,455,51547,Вінницька область
94,51575,39,2,37,23,14,51575,Вінницька область
95,51576,51,1,48,32,16,51576,Вінницька область
96,51577,63,4,58,43,15,51577,Вінницька область
97,51578,44,1,42,25,17,51578,Вінницька область
98,51579,134,1,131,63,68,51579,Вінницька область
99,51580,56,1,41,31,10,51580,Вінницька область
100,51581,503,37,387,241,146,51581,Вінницька область
101,51582,94,0,88,47,41,51582,Вінницька область
102,51583,33,0,32,23,9,51583,Вінницька область
103,51584,196,6,175,111,64,51584,Вінницька область
104,51585,12,0,12,6,6,51585,Вінницька область
105,51586,20,0,19,11,8,51586,Вінницька область
106,51669,2379,46,1604,832,772,51669,Вінницька область
107,51671,43,0,43,28,15,51671,Вінницька область
108,51672,67,3,61,40,21,51672,Вінницька область
109,51673,1980,25,1215,722,493,51673,Вінницька область
110,51675,348,5,240,128,112,51675,Вінницька область
111,1,720,60,654,574,80,1,Вінницька область
112,50125,698,24,393,267,126,50125,Вінницька область
113,50126,1971,34,1262,689,573,50126,Вінницька область
114,50127,1245,15,787,491,296,50127,Вінницька область
115,50128,976,16,595,396,199,50128,Вінницька область
116,50129,1031,8,692,351,341,50129,Вінницька область
117,50138,679,8,474,222,252,50138,Вінницька область
118,50139,2371,32,1437,859,578,50139,Вінницька область
119,50140,2127,38,1336,783,553,50140,Вінницька область
120,50141,2518,34,1509,839,670,50141,Вінницька область
121,50142,1360,15,992,456,536,50142,Вінницька область
122,50143,593,4,417,269,148,50143,Вінницька область
123,50146,396,2,268,161,107,50146,Вінницька область
124,50147,474,10,287,142,145,50147,Вінницька область
125,50148,152,0,95,47,48,50148,Вінницька область
126,50150,426,8,274,164,110,50150,Вінницька область
127,50151,209,4,143,78,65,50151,Вінницька область
128,50152,875,7,546,331,215,50152,Вінницька область
129,50153,550,7,364,207,157,50153,Вінницька область
130,50157,1731,17,1105,681,424,50157,Вінницька область
131,50158,1706,28,976,543,433,50158,Вінницька область
132,50159,301,7,188,124,64,50159,Вінницька область
133,50160,539,6,341,175,166,50160,Вінницька область
134,50163,1257,19,851,441,410,50163,Вінницька область
135,50168,468,2,306,191,115,50168,Вінницька область
136,50169,303,2,177,109,68,50169,Вінницька область
137,50170,405,8,243,144,99,50170,Вінницька область
138,50171,389,6,257,153,104,50171,Вінницька область
139,50172,953,11,628,383,245,50172,Вінницька область
140,50173,1196,15,795,505,290,50173,Вінницька область
141,50174,1104,16,698,391,307,50174,Вінницька область
142,50175,534,7,397,200,197,50175,Вінницька область
143,50176,236,6,187,102,85,50176,Вінницька область
144,50177,646,7,407,231,176,50177,Вінницька область
145,50178,393,2,286,157,129,50178,Вінницька область
146,50179,291,5,166,119,47,50179,Вінницька область
147,50180,967,17,580,406,174,50180,Вінницька область
148,50181,1851,7,1135,667,468,50181,Вінницька область
149,50182,1064,14,700,419,281,50182,Вінницька область
150,50183,863,11,533,320,213,50183,Вінницька область
151,50184,481,14,304,188,116,50184,Вінницька область
152,51435,1665,30,1071,646,425,51435,Вінницька область
153,51436,2252,50,1418,860,558,51436,Вінницька область
154,51437,2064,47,1328,773,555,51437,Вінницька область
155,51438,1817,37,1143,608,535,51438,Вінницька область
156,51439,2005,35,1314,767,547,51439,Вінницька область
157,51440,2179,41,1314,750,564,51440,Вінницька область
158,51441,1898,45,1193,722,471,51441,Вінницька область
159,51442,1774,36,1125,687,438,51442,Вінницька область
160,51443,1356,17,878,476,402,51443,Вінницька область
161,51444,2033,49,1235,712,523,51444,Вінницька область
162,51445,1703,28,1007,518,489,51445,Вінницька область
163,51446,1907,33,1271,751,520,51446,Вінницька область
164,51447,2193,34,1184,687,497,51447,Вінницька область
165,51448,1921,39,1162,666,496,51448,Вінницька область
166,51449,2085,25,1168,659,509,51449,Вінницька область
167,51450,2193,53,1344,783,561,51450,Вінницька область
168,51451,2217,45,1416,750,666,51451,Вінницька область
169,51452,2031,33,1315,622,693,51452,Вінницька область
170,51453,2104,29,1248,750,498,51453,Вінницька область
171,51454,2050,28,1205,751,454,51454,Вінницька область
172,51455,1653,38,1024,592,432,51455,Вінницька область
173,51456,2333,47,1418,803,615,51456,Вінницька область
174,51457,2464,52,1491,860,631,51457,Вінницька область
175,51458,2158,41,1377,860,517,51458,Вінницька область
176,51459,2163,23,1115,639,476,51459,Вінницька область
177,51460,2276,42,1367,778,589,51460,Вінницька область
178,51461,2122,30,1208,679,529,51461,Вінницька область
179,51462,2078,29,1174,632,542,51462,Вінницька область
180,51463,1555,26,940,520,420,51463,Вінницька область
181,51464,827,12,474,271,203,51464,Вінницька область
182,51465,2367,55,1438,886,552,51465,Вінницька область
183,51466,2099,44,1307,734,573,51466,Вінницька область
184,51467,1858,41,1122,694,428,51467,Вінницька область
185,51468,1650,28,1020,543,477,51468,Вінницька область
186,51469,2308,33,1481,831,650,51469,Вінницька область
187,51470,2276,36,1372,735,637,51470,Вінницька область
188,51471,2350,32,1442,902,540,51471,Вінницька область
189,51472,2105,43,1201,699,502,51472,Вінницька область
190,51473,2119,23,1234,760,474,51473,Вінницька область
191,51474,1986,38,1233,756,477,51474,Вінницька область
192,51475,1849,28,1134,675,459,51475,Вінницька область
193,51476,2093,46,1359,820,539,51476,Вінницька область
194,51548,2381,39,1413,856,557,51548,Вінницька область
195,51549,2106,45,1311,781,530,51549,Вінницька область
196,51550,2049,38,1140,664,476,51550,Вінницька область
197,51551,2419,48,1416,826,590,51551,Вінницька область
198,51552,1873,51,1131,609,522,51552,Вінницька область
199,51553,2316,43,1386,837,549,51553,Вінницька область
200,51554,2034,36,1269,770,499,51554,Вінницька область
201,51555,2450,39,1452,854,598,51555,Вінницька область
202,51556,2001,40,1203,664,539,51556,Вінницька область
203,51557,2332,26,1357,799,558,51557,Вінницька область
204,51558,2189,27,1311,825,486,51558,Вінницька область
205,51559,2070,36,1308,737,571,51559,Вінницька область
206,51560,2184,30,1305,798,507,51560,Вінницька область
207,51561,2082,42,1301,777,524,51561,Вінницька область
208,51562,2537,40,1474,850,624,51562,Вінницька область
209,51563,2320,34,1358,781,577,51563,Вінницька область
210,51565,2264,40,1296,730,566,51565,Вінницька область
211,51566,1700,35,1072,611,461,51566,Вінницька область
212,51567,2289,41,1398,795,603,51567,Вінницька область
213,51568,2175,37,1348,761,587,51568,Вінницька область
214,51569,2193,29,1319,862,457,51569,Вінницька область
215,51571,2298,33,1412,809,603,51571,Вінницька область
216,51572,159,2,134,93,41,51572,Вінницька область
217,51573,46,2,43,27,16,51573,Вінницька область
218,51574,13,0,13,8,5,51574,Вінницька область
219,51587,72,3,64,38,26,51587,Вінницька область
220,51588,16,0,16,9,7,51588,Вінницька область
221,51589,382,38,332,275,57,51589,Вінницька область
222,51590,452,10,411,356,55,51590,Вінницька область
223,51670,2081,40,1316,782,534,51670,Вінницька область
224,51674,2325,55,1597,950,647,51674,Вінницька область
225,50375,396,2,313,140,173,50375,Вінницька область
226,50376,374,2,245,127,118,50376,Вінницька область
227,50377,955,11,621,383,238,50377,Вінницька область
228,50378,42,0,34,26,8,50378,Вінницька область
229,50379,197,2,131,92,39,50379,Вінницька область
230,50380,551,10,368,278,90,50380,Вінницька область
231,50381,1789,34,1099,514,585,50381,Вінницька область
232,50382,234,0,146,66,80,50382,Вінницька область
233,50383,607,7,426,218,208,50383,Вінницька область
234,50384,488,9,298,202,96,50384,Вінницька область
235,50385,389,9,277,96,181,50385,Вінницька область
236,50386,526,3,341,231,110,50386,Вінницька область
237,50387,1548,16,844,530,314,50387,Вінницька область
238,50388,1648,9,868,546,322,50388,Вінницька область
239,50389,534,7,311,171,140,50389,Вінницька область
240,50390,392,7,236,130,106,50390,Вінницька область
241,50391,296,1,192,105,87,50391,Вінницька область
242,50392,109,1,80,43,37,50392,Вінницька область
243,50393,2065,32,1139,709,430,50393,Вінницька область
244,50394,457,7,280,189,91,50394,Вінницька область
245,50395,920,17,612,373,239,50395,Вінницька область
246,50396,475,5,319,173,146,50396,Вінницька область
247,50397,302,1,172,120,52,50397,Вінницька область
248,50398,437,5,275,188,87,50398,Вінницька область
249,50399,250,3,179,101,78,50399,Вінницька область
250,50400,246,3,187,111,76,50400,Вінницька область
251,50401,913,11,537,260,277,50401,Вінницька область
252,50402,535,2,345,211,134,50402,Вінницька область
253,50403,489,5,301,150,151,50403,Вінницька область
254,50404,112,1,79,39,40,50404,Вінницька область
255,50405,267,3,170,101,69,50405,Вінницька область
256,50406,165,0,121,72,49,50406,Вінницька область
257,50407,778,13,435,283,152,50407,Вінницька область
258,50408,744,9,582,354,228,50408,Вінницька область
259,50409,509,10,408,271,137,50409,Вінницька область
260,50410,304,1,243,156,87,50410,Вінницька область
261,50411,1485,20,970,539,431,50411,Вінницька область
262,50412,1367,13,822,448,374,50412,Вінницька область
263,50413,604,10,473,281,192,50413,Вінницька область
264,50414,824,8,511,343,168,50414,Вінницька область
265,50415,1501,18,879,461,418,50415,Вінницька область
266,50416,628,8,356,267,89,50416,Вінницька область
267,50417,282,4,163,78,85,50417,Вінницька область
268,50418,199,3,115,72,43,50418,Вінницька область
269,50419,416,5,265,145,120,50419,Вінницька область
270,50420,237,1,147,80,67,50420,Вінницька область
271,50421,198,2,125,80,45,50421,Вінницька область
272,50422,1019,18,651,400,251,50422,Вінницька область
273,50423,2182,22,1421,910,511,50423,Вінницька область
274,50424,1824,40,1086,637,449,50424,Вінницька область
275,50425,2287,32,1457,795,662,50425,Вінницька область
276,50426,1559,27,947,525,422,50426,Вінницька область
277,50427,1903,28,1227,641,586,50427,Вінницька область
278,50428,1640,29,989,539,450,50428,Вінницька область
279,50429,1708,30,1123,682,441,50429,Вінницька область
280,50430,192,2,115,78,37,50430,Вінницька область
281,50431,312,3,176,114,62,50431,Вінницька область
282,50432,2309,32,1449,866,583,50432,Вінницька область
283,50433,103,1,85,57,28,50433,Вінницька область
284,50434,459,4,327,188,139,50434,Вінницька область
285,50435,207,3,118,71,47,50435,Вінницька область
286,50436,165,5,106,66,40,50436,Вінницька область
287,50437,77,0,52,27,25,50437,Вінницька область
288,50438,79,0,65,31,34,50438,Вінницька область
289,50439,482,5,299,194,105,50439,Вінницька область
290,50440,138,4,91,57,34,50440,Вінницька область
291,50441,877,7,449,258,191,50441,Вінницька область
292,50442,1001,15,571,303,268,50442,Вінницька область
293,50444,520,6,306,226,80,50444,Вінницька область
294,50445,187,3,117,74,43,50445,Вінницька область
295,50446,270,0,227,137,90,50446,Вінницька область
296,50447,534,8,351,215,136,50447,Вінницька область
297,50448,1542,15,865,655,210,50448,Вінницька область
298,50449,1242,9,729,548,181,50449,Вінницька область
299,50450,1023,7,577,392,185,50450,Вінницька область
300,50451,495,6,298,234,64,50451,Вінницька область
301,50452,556,2,269,173,96,50452,Вінницька область
302,50453,1355,16,871,516,355,50453,Вінницька область
303,50454,589,0,354,201,153,50454,Вінницька область
304,50455,225,0,161,98,63,50455,Вінницька область
305,50456,208,2,147,86,61,50456,Вінницька область
306,50457,73,3,64,34,30,50457,Вінницька область
307,50458,183,3,121,67,54,50458,Вінницька область
308,50459,673,7,402,271,131,50459,Вінницька область
309,50460,418,7,306,216,90,50460,Вінницька область
310,50461,385,5,219,144,75,50461,Вінницька область
311,50462,139,1,79,51,28,50462,Вінницька область
312,50463,469,1,264,195,69,50463,Вінницька область
313,50464,253,2,158,91,67,50464,Вінницька область
314,50465,53,0,36,20,16,50465,Вінницька область
315,50466,224,2,154,104,50,50466,Вінницька область
316,50467,59,2,36,16,20,50467,Вінницька область
317,50468,109,0,85,36,49,50468,Вінницька область
318,50469,254,2,168,120,48,50469,Вінницька область
319,50470,392,4,253,131,122,50470,Вінницька область
320,50471,33,1,22,11,11,50471,Вінницька область
321,50472,608,7,383,227,156,50472,Вінницька область
322,50474,193,1,119,73,46,50474,Вінницька область
323,50475,394,4,243,164,79,50475,Вінницька область
324,50476,294,2,212,135,77,50476,Вінницька область
325,50477,431,6,266,203,63,50477,Вінницька область
326,50478,326,3,227,142,85,50478,Вінницька область
327,50479,375,4,271,169,102,50479,Вінницька область
328,50480,378,6,213,148,65,50480,Вінницька область
329,50481,796,8,413,248,165,50481,Вінницька область
330,50482,2378,31,1372,984,388,50482,Вінницька область
331,50483,500,14,273,213,60,50483,Вінницька область
332,50484,527,5,295,237,58,50484,Вінницька область
333,50485,942,18,611,444,167,50485,Вінницька область
334,50486,169,0,132,78,54,50486,Вінницька область
335,50487,219,2,164,136,28,50487,Вінницька область
336,50488,69,0,59,40,19,50488,Вінницька область
337,50489,459,4,360,285,75,50489,Вінницька область
338,50490,748,2,389,282,107,50490,Вінницька область
339,50491,424,5,259,159,100,50491,Вінницька область
340,50492,88,0,52,38,14,50492,Вінницька область
341,50493,205,4,116,83,33,50493,Вінницька область
342,50494,384,3,217,132,85,50494,Вінницька область
343,50495,522,5,324,212,112,50495,Вінницька область
344,50496,293,6,177,135,42,50496,Вінницька область
345,50497,107,3,75,55,20,50497,Вінницька область
346,50498,1379,24,789,452,337,50498,Вінницька область
347,50499,88,1,44,32,12,50499,Вінницька область
348,50500,82,0,51,30,21,50500,Вінницька область
349,50501,191,4,116,75,41,50501,Вінницька область
350,50502,709,3,310,242,68,50502,Вінницька область
351,50503,363,3,228,176,52,50503,Вінницька область
352,50504,779,16,532,382,150,50504,Вінницька область
353,50505,438,6,236,174,62,50505,Вінницька область
354,50506,418,4,256,158,98,50506,Вінницька область
355,50507,82,3,58,36,22,50507,Вінницька область
356,50508,33,0,33,27,6,50508,Вінницька область
357,51210,475,11,343,208,135,51210,Вінницька область
358,51211,73,0,57,34,23,51211,Вінницька область
359,51212,149,0,102,63,39,51212,Вінницька область
360,51213,998,15,607,428,179,51213,Вінницька область
361,51214,340,3,230,172,58,51214,Вінницька область
362,51215,692,8,352,266,86,51215,Вінницька область
363,51216,286,0,173,126,47,51216,Вінницька область
364,51217,336,1,215,163,52,51217,Вінницька область
365,51218,474,3,317,154,163,51218,Вінницька область
366,51219,59,0,39,21,18,51219,Вінницька область
367,51220,661,5,434,285,149,51220,Вінницька область
368,51221,220,2,179,120,59,51221,Вінницька область
369,51222,1472,14,738,524,214,51222,Вінницька область
370,51223,461,4,274,204,70,51223,Вінницька область
371,51224,950,9,492,366,126,51224,Вінницька область
372,51225,412,13,214,147,67,51225,Вінницька область
373,51226,263,1,215,52,163,51226,Вінницька область
374,51227,351,0,265,104,161,51227,Вінницька область
375,51228,26,0,25,17,8,51228,Вінницька область
376,51229,151,0,96,77,19,51229,Вінницька область
377,51230,134,1,93,77,16,51230,Вінницька область
378,51231,275,1,218,139,79,51231,Вінницька область
379,51232,203,4,177,97,80,51232,Вінницька область
380,51233,201,2,145,91,54,51233,Вінницька область
381,51234,475,4,311,147,164,51234,Вінницька область
382,51235,235,2,128,66,62,51235,Вінницька область
383,51236,201,6,138,67,71,51236,Вінницька область
384,51237,676,9,359,251,108,51237,Вінницька область
385,51238,341,7,263,95,168,51238,Вінницька область
386,51239,153,0,111,60,51,51239,Вінницька область
387,51240,334,4,257,124,133,51240,Вінницька область
388,51241,164,3,123,69,54,51241,Вінницька область
389,51242,208,3,158,103,55,51242,Вінницька область
390,51243,158,1,124,69,55,51243,Вінницька область
391,51244,248,1,194,132,62,51244,Вінницька область
392,51245,431,1,289,156,133,51245,Вінницька область
393,51246,214,3,149,64,85,51246,Вінницька область
394,51247,450,5,329,192,137,51247,Вінницька область
395,51248,189,6,116,57,59,51248,Вінницька область
396,51249,271,4,177,107,70,51249,Вінницька область
397,51250,128,1,91,53,38,51250,Вінницька область
398,51251,83,1,49,24,25,51251,Вінницька область
399,51252,285,6,185,136,49,51252,Вінницька область
400,51253,175,0,103,44,59,51253,Вінницька область
401,51254,189,2,106,51,55,51254,Вінницька область
402,51255,442,4,319,168,151,51255,Вінницька область
403,51256,301,7,213,135,78,51256,Вінницька область
404,51257,501,4,339,233,106,51257,Вінницька область
405,51258,394,6,331,226,105,51258,Вінницька область
406,51259,361,3,229,103,126,51259,Вінницька область
407,51260,287,3,163,78,85,51260,Вінницька область
408,51261,243,1,173,92,81,51261,Вінницька область
409,51262,340,8,254,182,72,51262,Вінницька область
410,51263,348,1,265,172,93,51263,Вінницька область
411,51264,698,9,459,322,137,51264,Вінницька область
412,51265,716,2,473,321,152,51265,Вінницька область
413,51266,163,1,104,69,35,51266,Вінницька область
414,51267,388,2,228,169,59,51267,Вінницька область
415,51268,569,15,467,354,113,51268,Вінницька область
416,51269,238,2,195,99,96,51269,Вінницька область
417,51270,192,3,123,96,27,51270,Вінницька область
418,51271,398,7,249,130,119,51271,Вінницька область
419,51272,229,0,166,65,101,51272,Вінницька область
420,51273,438,7,339,202,137,51273,Вінницька область
421,51274,525,5,263,181,82,51274,Вінницька область
422,51276,1294,10,810,540,270,51276,Вінницька область
423,51277,898,18,500,319,181,51277,Вінницька область
424,51278,457,6,370,252,118,51278,Вінницька область
425,51279,381,4,227,133,94,51279,Вінницька область
426,51280,322,8,236,95,141,51280,Вінницька область
427,51281,122,0,89,58,31,51281,Вінницька область
428,51282,908,9,495,311,184,51282,Вінницька область
429,51283,573,10,266,183,83,51283,Вінницька область
430,51284,23,0,23,11,12,51284,Вінницька область
431,51608,1979,45,1163,882,281,51608,Вінницька область
432,51609,1770,39,1163,837,326,51609,Вінницька область
433,51610,1503,27,914,644,270,51610,Вінницька область
434,51611,1700,36,1048,740,308,51611,Вінницька область
435,51612,1874,26,1138,812,326,51612,Вінницька область
436,51613,667,9,354,251,103,51613,Вінницька область
437,51614,1587,20,931,708,223,51614,Вінницька область
438,51615,1468,24,875,638,237,51615,Вінницька область
439,51616,1101,15,628,483,145,51616,Вінницька область
440,51617,1055,19,601,448,153,51617,Вінницька область
441,51618,914,9,554,425,129,51618,Вінницька область
442,51619,632,7,406,295,111,51619,Вінницька область
443,51620,2185,24,1395,1034,361,51620,Вінницька область
444,51621,1560,26,918,684,234,51621,Вінницька область
445,51622,10,4,6,4,2,51622,Вінницька область
446,51623,26,0,23,15,8,51623,Вінницька область
447,51656,2239,32,1278,932,346,51656,Вінницька область
448,51657,1957,45,1181,784,397,51657,Вінницька область
449,51658,1808,26,1088,728,360,51658,Вінницька область
450,51659,1994,18,1201,815,386,51659,Вінницька область
451,51660,1915,32,1175,815,360,51660,Вінницька область
452,51661,2026,27,1254,850,404,51661,Вінницька область
453,51662,1892,23,1163,807,356,51662,Вінницька область
454,51663,1683,38,1004,693,311,51663,Вінницька область
455,51664,1995,26,1261,846,415,51664,Вінницька область
456,51665,1431,22,860,601,259,51665,Вінницька область
457,51666,396,5,308,201,107,51666,Вінницька область
458,51668,40,0,30,21,9,51668,Вінницька область
459,50001,1498,26,876,561,315,50001,Вінницька область
460,50002,2105,30,1241,769,472,50002,Вінницька область
461,50003,2179,24,1197,806,391,50003,Вінницька область
462,50004,1484,23,877,576,301,50004,Вінницька область
463,50005,1851,28,1114,778,336,50005,Вінницька область
464,50006,1717,29,1025,654,371,50006,Вінницька область
465,50007,2133,28,1301,809,492,50007,Вінницька область
466,50008,2150,22,1227,782,445,50008,Вінницька область
467,50009,722,13,431,271,160,50009,Вінницька область
468,50010,691,10,395,248,147,50010,Вінницька область
469,50011,146,2,93,54,39,50011,Вінницька область
470,50012,252,0,145,97,48,50012,Вінницька область
471,50013,141,0,105,68,37,50013,Вінницька область
472,50014,358,1,222,99,123,50014,Вінницька область
473,50015,120,1,79,54,25,50015,Вінницька область
474,50016,667,9,475,206,269,50016,Вінницька область
475,50017,208,8,120,64,56,50017,Вінницька область
476,50018,599,5,347,240,107,50018,Вінницька область
477,50019,624,9,402,263,139,50019,Вінницька область
478,50020,546,3,349,228,121,50020,Вінницька область
479,50021,174,3,111,80,31,50021,Вінницька область
480,50022,751,9,405,239,166,50022,Вінницька область
481,50023,1059,13,572,373,199,50023,Вінницька область
482,50024,592,13,350,226,124,50024,Вінницька область
483,50025,314,1,226,107,119,50025,Вінницька область
484,50026,206,0,157,105,52,50026,Вінницька область
485,50027,149,0,96,61,35,50027,Вінницька область
486,50028,311,1,181,158,23,50028,Вінницька область
487,50029,138,2,86,61,25,50029,Вінницька область
488,50030,556,17,291,166,125,50030,Вінницька область
489,50031,587,5,312,209,103,50031,Вінницька область
490,50032,471,5,321,167,154,50032,Вінницька область
491,50033,956,5,505,330,175,50033,Вінницька область
492,50034,1256,14,739,467,272,50034,Вінницька область
493,50035,283,0,187,118,69,50035,Вінницька область
494,50036,263,4,215,166,49,50036,Вінницька область
495,50037,340,4,221,168,53,50037,Вінницька область
496,50038,135,2,91,46,45,50038,Вінницька область
497,50039,347,4,218,153,65,50039,Вінницька область
498,50040,533,5,334,232,102,50040,Вінницька область
499,50041,209,3,132,74,58,50041,Вінницька область
500,50042,168,2,130,69,61,50042,Вінницька область
501,50043,119,1,105,58,47,50043,Вінницька область
502,50044,1092,18,680,515,165,50044,Вінницька область
503,50045,596,6,353,227,126,50045,Вінницька область
504,50046,314,2,284,179,105,50046,Вінницька область
505,50047,733,7,436,290,146,50047,Вінницька область
506,50048,501,12,290,224,66,50048,Вінницька область
507,50049,169,2,128,88,40,50049,Вінницька область
508,50050,190,2,135,119,16,50050,Вінницька область
509,50051,270,3,151,108,43,50051,Вінницька область
510,50052,116,4,78,58,20,50052,Вінницька область
511,50053,666,11,369,255,114,50053,Вінницька область
512,50054,289,1,202,133,69,50054,Вінницька область
513,50055,361,3,209,94,115,50055,Вінницька область
514,50056,209,0,192,77,115,50056,Вінницька область
515,50057,708,6,412,235,177,50057,Вінницька область
516,50058,540,4,360,237,123,50058,Вінницька область
517,50059,159,1,110,68,42,50059,Вінницька область
518,50060,526,3,443,263,180,50060,Вінницька область
519,50061,315,3,250,146,104,50061,Вінницька область
520,50062,416,3,252,168,84,50062,Вінницька область
521,50063,868,8,462,321,141,50063,Вінницька область
522,50064,467,6,253,160,93,50064,Вінницька область
523,50065,293,1,186,124,62,50065,Вінницька область
524,50066,733,4,430,273,157,50066,Вінницька область
525,50067,348,9,214,135,79,50067,Вінницька область
526,50068,242,0,197,135,62,50068,Вінницька область
527,50069,451,4,230,151,79,50069,Вінницька область
528,50070,222,1,123,69,54,50070,Вінницька область
529,50071,39,2,19,12,7,50071,Вінницька область
530,50261,1357,18,742,486,256,50261,Вінницька область
531,50262,1199,31,679,406,273,50262,Вінницька область
532,50263,1484,16,797,519,278,50263,Вінницька область
533,50264,303,5,193,128,65,50264,Вінницька область
534,50265,452,7,337,171,166,50265,Вінницька область
535,50266,358,6,262,181,81,50266,Вінницька область
536,50267,234,4,178,121,57,50267,Вінницька область
537,50268,531,8,433,291,142,50268,Вінницька область
538,50269,612,12,350,208,142,50269,Вінницька область
539,50270,1119,20,663,370,293,50270,Вінницька область
540,50271,389,4,268,112,156,50271,Вінницька область
541,50272,687,8,486,294,192,50272,Вінницька область
542,50273,257,5,173,121,52,50273,Вінницька область
543,50274,256,0,176,90,86,50274,Вінницька область
544,50275,60,0,42,22,20,50275,Вінницька область
545,50276,439,3,279,186,93,50276,Вінницька область
546,50277,185,1,108,65,43,50277,Вінницька область
547,50278,510,2,387,211,176,50278,Вінницька область
548,50279,91,0,66,26,40,50279,Вінницька область
549,50280,603,11,407,203,204,50280,Вінницька область
550,50281,450,5,245,160,85,50281,Вінницька область
551,50282,97,0,71,36,35,50282,Вінницька область
552,50283,92,1,54,35,19,50283,Вінницька область
553,50284,228,2,170,114,56,50284,Вінницька область
554,50285,201,3,161,76,85,50285,Вінницька область
555,50286,678,6,469,312,157,50286,Вінницька область
556,50287,665,7,346,290,56,50287,Вінницька область
557,50288,230,2,157,121,36,50288,Вінницька область
558,50289,263,2,186,113,73,50289,Вінницька область
559,50290,207,0,128,63,65,50290,Вінницька область
560,50291,469,4,269,196,73,50291,Вінницька область
561,50292,363,2,216,113,103,50292,Вінницька область
562,50293,64,1,40,23,17,50293,Вінницька область
563,50294,327,7,234,136,98,50294,Вінницька область
564,50295,1033,8,593,397,196,50295,Вінницька область
565,50296,810,11,551,320,231,50296,Вінницька область
566,50297,610,10,422,243,179,50297,Вінницька область
567,50298,364,6,254,160,94,50298,Вінницька область
568,50299,169,0,106,64,42,50299,Вінницька область
569,50300,459,3,391,199,192,50300,Вінницька область
570,50301,149,4,122,76,46,50301,Вінницька область
571,50302,521,4,342,230,112,50302,Вінницька область
572,50303,225,4,109,76,33,50303,Вінницька область
573,50304,1418,14,772,485,287,50304,Вінницька область
574,50305,125,0,107,77,30,50305,Вінницька область
575,50306,795,7,463,327,136,50306,Вінницька область
576,50307,425,1,257,162,95,50307,Вінницька область
577,50308,1080,9,596,463,133,50308,Вінницька область
578,50309,1030,4,556,427,129,50309,Вінницька область
579,50310,442,9,294,171,123,50310,Вінницька область
580,50311,176,4,128,49,79,50311,Вінницька область
581,50312,395,3,264,169,95,50312,Вінницька область
582,50313,375,3,231,184,47,50313,Вінницька область
583,50314,180,4,119,86,33,50314,Вінницька область
584,50315,303,18,217,107,110,50315,Вінницька область
585,50316,896,12,546,385,161,50316,Вінницька область
586,50317,159,4,110,73,37,50317,Вінницька область
587,50318,343,7,267,180,87,50318,Вінницька область
588,50607,2208,49,1384,831,553,50607,Вінницька область
589,50608,1359,20,823,560,263,50608,Вінницька область
590,50609,2029,55,1260,829,431,50609,Вінницька область
591,50610,601,5,375,206,169,50610,Вінницька область
592,50611,638,3,375,204,171,50611,Вінницька область
593,50612,82,0,56,30,26,50612,Вінницька область
594,50613,405,10,264,165,99,50613,Вінницька область
595,50614,147,1,86,57,29,50614,Вінницька область
596,50615,648,5,454,192,262,50615,Вінницька область
597,50616,282,2,190,107,83,50616,Вінницька область
598,50617,248,5,152,84,68,50617,Вінницька область
599,50618,215,2,151,68,83,50618,Вінницька область
600,50619,140,0,85,31,54,50619,Вінницька область
601,50620,57,0,34,25,9,50620,Вінницька область
602,50621,344,2,226,115,111,50621,Вінницька область
603,50622,252,2,168,92,76,50622,Вінницька область
604,50623,795,7,526,329,197,50623,Вінницька область
605,50624,746,9,428,251,177,50624,Вінницька область
606,50625,161,1,135,56,79,50625,Вінницька область
607,50626,539,8,401,243,158,50626,Вінницька область
608,50627,884,13,549,262,287,50627,Вінницька область
609,50628,75,3,50,21,29,50628,Вінницька область
610,50629,866,8,521,321,200,50629,Вінницька область
611,50630,266,1,196,109,87,50630,Вінницька область
612,50631,701,9,441,233,208,50631,Вінницька область
613,50632,300,4,207,118,89,50632,Вінницька область
614,50633,802,9,471,314,157,50633,Вінницька область
615,50634,88,0,45,28,17,50634,Вінницька область
616,50635,283,2,204,120,84,50635,Вінницька область
617,50636,106,1,87,23,64,50636,Вінницька область
618,50637,494,7,325,174,151,50637,Вінницька область
619,50638,62,0,42,20,22,50638,Вінницька область
620,50639,492,4,306,179,127,50639,Вінницька область
621,50640,350,9,293,169,124,50640,Вінницька область
622,50641,116,1,91,54,37,50641,Вінницька область
623,50642,560,9,351,189,162,50642,Вінницька область
624,50643,470,9,342,174,168,50643,Вінницька область
625,50644,228,6,160,101,59,50644,Вінницька область
626,50645,310,6,219,125,94,50645,Вінницька область
627,50646,76,0,47,17,30,50646,Вінницька область
628,50647,274,5,183,126,57,50647,Вінницька область
629,50648,744,4,550,213,337,50648,Вінницька область
630,50649,222,3,168,71,97,50649,Вінницька область
631,50650,387,2,241,122,119,50650,Вінницька область
632,50651,193,0,123,50,73,50651,Вінницька область
633,50652,1277,20,751,445,306,50652,Вінницька область
634,50653,578,6,355,186,169,50653,Вінницька область
635,50654,705,8,464,279,185,50654,Вінницька область
636,50655,819,8,545,380,165,50655,Вінницька область
637,50656,347,6,250,145,105,50656,Вінницька область
638,50657,190,6,124,67,57,50657,Вінницька область
639,50658,197,5,127,76,51,50658,Вінницька область
640,50659,103,2,69,33,36,50659,Вінницька область
641,50660,56,1,41,20,21,50660,Вінницька область
642,50661,787,5,444,296,148,50661,Вінницька область
643,50662,612,9,331,236,95,50662,Вінницька область
644,50663,259,7,164,110,54,50663,Вінницька область
645,50664,161,0,117,66,51,50664,Вінницька область
646,50665,516,5,306,188,118,50665,Вінницька область
647,50666,88,1,52,28,24,50666,Вінницька область
648,50667,69,0,44,23,21,50667,Вінницька область
649,50668,345,8,226,122,104,50668,Вінницька область
650,50669,29,0,29,7,22,50669,Вінницька область
651,50670,236,8,227,137,90,50670,Вінницька область
652,51032,1369,23,824,490,334,51032,Вінницька область
653,51033,1472,13,817,492,325,51033,Вінницька область
654,51034,932,15,565,320,245,51034,Вінницька область
655,51035,1634,15,958,595,363,51035,Вінницька область
656,51036,1102,14,685,445,240,51036,Вінницька область
657,51037,1040,17,615,410,205,51037,Вінницька область
658,51038,751,7,443,250,193,51038,Вінницька область
659,51039,1218,20,686,412,274,51039,Вінницька область
660,51040,538,7,328,239,89,51040,Вінницька область
661,51041,1082,9,612,442,170,51041,Вінницька область
662,51042,1192,23,673,454,219,51042,Вінницька область
663,51043,1185,10,739,475,264,51043,Вінницька область
664,51044,1095,7,642,415,227,51044,Вінницька область
665,51045,1211,12,824,424,400,51045,Вінницька область
666,51046,1002,22,612,380,232,51046,Вінницька область
667,51047,1004,11,630,377,253,51047,Вінницька область
668,51048,195,3,180,44,136,51048,Вінницька область
669,51049,298,0,194,101,93,51049,Вінницька область
670,51051,331,4,231,116,115,51051,Вінницька область
671,51052,164,1,107,49,58,51052,Вінницька область
672,51053,432,2,278,134,144,51053,Вінницька область
673,51054,213,2,116,58,58,51054,Вінницька область
674,51055,874,6,513,315,198,51055,Вінницька область
675,51056,103,1,70,53,17,51056,Вінницька область
676,51057,211,1,98,68,30,51057,Вінницька область
677,51058,220,5,151,116,35,51058,Вінницька область
678,51059,129,1,112,76,36,51059,Вінницька область
679,51060,208,4,129,66,63,51060,Вінницька область
680,51061,363,1,239,138,101,51061,Вінницька область
681,51062,106,2,60,36,24,51062,Вінницька область
682,51063,175,1,113,82,31,51063,Вінницька область
683,51064,215,2,142,97,45,51064,Вінницька область
684,51065,112,1,78,50,28,51065,Вінницька область
685,51066,293,2,166,120,46,51066,Вінницька область
686,51067,152,1,88,54,34,51067,Вінницька область
687,51068,81,1,56,35,21,51068,Вінницька область
688,51069,41,0,32,9,23,51069,Вінницька область
689,51070,191,3,103,68,35,51070,Вінницька область
690,51072,171,3,114,65,49,51072,Вінницька область
691,51073,115,0,92,44,48,51073,Вінницька область
692,51074,167,0,113,81,32,51074,Вінницька область
693,51075,196,5,117,68,49,51075,Вінницька область
694,51076,76,1,65,28,37,51076,Вінницька область
695,51077,511,8,308,218,90,51077,Вінницька область
696,51078,788,18,486,329,157,51078,Вінницька область
697,51079,585,9,334,178,156,51079,Вінницька область
698,51080,179,1,126,56,70,51080,Вінницька область
699,51081,108,0,61,31,30,51081,Вінницька область
700,51082,1725,29,1036,625,411,51082,Вінницька область
701,51083,201,1,137,64,73,51083,Вінницька область
702,51084,426,4,247,140,107,51084,Вінницька область
703,51085,1013,4,585,464,121,51085,Вінницька область
704,51086,145,1,85,42,43,51086,Вінницька область
705,51087,716,6,422,236,186,51087,Вінницька область
706,51088,301,6,192,145,47,51088,Вінницька область
707,51089,392,3,272,172,100,51089,Вінницька область
708,51090,262,2,170,94,76,51090,Вінницька область
709,51092,625,4,366,233,133,51092,Вінницька область
710,51093,904,7,531,354,177,51093,Вінницька область
711,51094,88,0,51,22,29,51094,Вінницька область
712,51591,1555,20,952,740,212,51591,Вінницька область
713,51592,1588,25,935,745,190,51592,Вінницька область
714,51593,2128,35,1213,944,269,51593,Вінницька область
715,51594,1594,14,946,770,176,51594,Вінницька область
716,51595,2214,30,1198,997,201,51595,Вінницька область
717,51596,2265,32,1212,977,235,51596,Вінницька область
718,51597,2185,49,1293,1026,267,51597,Вінницька область
719,51598,2212,55,1337,1066,271,51598,Вінницька область
720,51599,1443,36,744,528,216,51599,Вінницька область
721,51600,2041,36,1167,891,276,51600,Вінницька область
722,51601,1969,40,1187,899,288,51601,Вінницька область
723,51602,1823,22,1076,840,236,51602,Вінницька область
724,51603,1429,32,889,710,179,51603,Вінницька область
725,51604,1263,27,730,605,125,51604,Вінницька область
726,51605,1651,29,976,745,231,51605,Вінницька область
727,51606,1447,20,837,644,193,51606,Вінницька область
728,51607,103,1,89,31,58,51607,Вінницька область
729,50721,292,0,204,117,87,50721,Вінницька область
730,50722,71,1,44,24,20,50722,Вінницька область
731,50723,122,0,75,53,22,50723,Вінницька область
732,50724,59,7,33,18,15,50724,Вінницька область
733,50725,357,3,210,143,67,50725,Вінницька область
734,50726,323,1,176,105,71,50726,Вінницька область
735,50727,819,8,485,302,183,50727,Вінницька область
736,50728,519,3,305,175,130,50728,Вінницька область
737,50729,585,3,403,214,189,50729,Вінницька область
738,50730,76,0,68,31,37,50730,Вінницька область
739,50731,339,0,221,156,65,50731,Вінницька область
740,50732,270,3,175,68,107,50732,Вінницька область
741,50733,82,0,54,29,25,50733,Вінницька область
742,50734,538,0,333,235,98,50734,Вінницька область
743,50735,592,5,377,252,125,50735,Вінницька область
744,50736,254,2,179,109,70,50736,Вінницька область
745,50737,69,0,43,21,22,50737,Вінницька область
746,50738,666,14,456,214,242,50738,Вінницька область
747,50739,388,2,229,116,113,50739,Вінницька область
748,50740,163,4,108,65,43,50740,Вінницька область
749,50741,481,5,309,179,130,50741,Вінницька область
750,50742,521,6,275,202,73,50742,Вінницька область
751,50743,653,12,386,271,115,50743,Вінницька область
752,50744,432,20,254,148,106,50744,Вінницька область
753,50745,1466,18,692,409,283,50745,Вінницька область
754,50746,1665,22,933,573,360,50746,Вінницька область
755,50747,1488,21,885,535,350,50747,Вінницька область
756,50748,515,4,293,191,102,50748,Вінницька область
757,50749,531,11,256,151,105,50749,Вінницька область
758,50750,188,0,156,82,74,50750,Вінницька область
759,50751,778,9,412,279,133,50751,Вінницька область
760,50752,191,1,154,68,86,50752,Вінницька область
761,50753,319,4,179,96,83,50753,Вінницька область
762,50754,130,1,89,60,29,50754,Вінницька область
763,50755,177,1,121,70,51,50755,Вінницька область
764,50756,57,0,48,32,16,50756,Вінницька область
765,50757,116,0,92,60,32,50757,Вінницька область
766,50758,125,3,106,57,49,50758,Вінницька область
767,50759,252,2,159,82,77,50759,Вінницька область
768,50760,141,4,91,64,27,50760,Вінницька область
769,50761,621,1,411,268,143,50761,Вінницька область
770,50762,227,2,125,82,43,50762,Вінницька область
771,50763,533,7,358,236,122,50763,Вінницька область
772,50764,445,6,286,199,87,50764,Вінницька область
773,50765,239,6,180,100,80,50765,Вінницька область
774,50766,466,3,291,117,174,50766,Вінницька область
775,50767,282,2,165,75,90,50767,Вінницька область
776,50768,157,1,95,57,38,50768,Вінницька область
777,50769,18,0,14,8,6,50769,Вінницька область
778,51095,2054,34,1238,965,273,51095,Вінницька область
779,51096,1187,12,691,512,179,51096,Вінницька область
780,51097,1217,11,657,522,135,51097,Вінницька область
781,51098,2115,14,1180,919,261,51098,Вінницька область
782,51099,1403,17,800,649,151,51099,Вінницька область
783,51100,1191,15,651,483,168,51100,Вінницька область
784,51101,1327,14,673,519,154,51101,Вінницька область
785,51102,878,6,528,349,179,51102,Вінницька область
786,51103,893,12,431,311,120,51103,Вінницька область
787,51104,341,2,232,147,85,51104,Вінницька область
788,51105,581,7,342,231,111,51105,Вінницька область
789,51106,577,12,396,235,161,51106,Вінницька область
790,51107,1270,14,752,520,232,51107,Вінницька область
791,51108,269,5,148,114,34,51108,Вінницька область
792,51109,158,1,105,73,32,51109,Вінницька область
793,51110,406,5,253,189,64,51110,Вінницька область
794,51111,389,2,220,158,62,51111,Вінницька область
795,51112,1420,11,739,563,176,51112,Вінницька область
796,51113,968,10,564,462,102,51113,Вінницька область
797,51114,1115,12,604,447,157,51114,Вінницька область
798,51115,328,9,203,129,74,51115,Вінницька область
799,51116,273,19,178,109,69,51116,Вінницька область
800,51117,498,8,311,165,146,51117,Вінницька область
801,51118,376,6,184,123,61,51118,Вінницька область
802,51119,303,4,167,131,36,51119,Вінницька область
803,51120,433,1,302,221,81,51120,Вінницька область
804,51121,305,6,228,166,62,51121,Вінницька область
805,51122,358,4,220,186,34,51122,Вінницька область
806,51123,157,2,103,68,35,51123,Вінницька область
807,51124,713,7,418,329,89,51124,Вінницька область
808,51125,739,10,413,321,92,51125,Вінницька область
809,51126,582,5,359,198,161,51126,Вінницька область
810,51127,921,11,536,335,201,51127,Вінницька область
811,51128,15,0,15,10,5,51128,Вінницька область
812,51165,2139,33,1256,900,356,51165,Вінницька область
813,51166,1747,25,1075,728,347,51166,Вінницька область
814,51167,2077,29,1165,858,307,51167,Вінницька область
815,51168,2097,25,1141,826,315,51168,Вінницька область
816,51169,1679,23,1015,689,326,51169,Вінницька область
817,51170,2000,27,1240,873,367,51170,Вінницька область
818,51171,1417,31,871,586,285,51171,Вінницька область
819,51172,1404,17,1069,617,452,51172,Вінницька область
820,51173,1146,22,872,527,345,51173,Вінницька область
821,51174,1369,12,747,493,254,51174,Вінницька область
822,51175,1363,9,779,517,262,51175,Вінницька область
823,51176,484,6,335,220,115,51176,Вінницька область
824,51177,835,14,547,323,224,51177,Вінницька область
825,51178,446,5,270,172,98,51178,Вінницька область
826,51179,929,9,552,383,169,51179,Вінницька область
827,51180,429,0,270,190,80,51180,Вінницька область
828,51181,313,2,214,113,101,51181,Вінницька область
829,51182,774,6,463,297,166,51182,Вінницька область
830,51183,560,6,374,264,110,51183,Вінницька область
831,51184,625,6,465,349,116,51184,Вінницька область
832,51185,272,3,197,122,75,51185,Вінницька область
833,51186,938,6,541,354,187,51186,Вінницька область
834,51187,2194,35,1110,832,278,51187,Вінницька область
835,51188,1505,16,783,565,218,51188,Вінницька область
836,51189,1747,15,969,695,274,51189,Вінницька область
837,51190,1480,15,836,532,304,51190,Вінницька область
838,51191,108,1,72,36,36,51191,Вінницька область
839,51192,757,2,433,296,137,51192,Вінницька область
840,51193,965,25,563,383,180,51193,Вінницька область
841,51194,508,6,380,258,122,51194,Вінницька область
842,51195,377,6,272,156,116,51195,Вінницька область
843,51196,117,2,75,48,27,51196,Вінницька область
844,51197,682,13,424,271,153,51197,Вінницька область
845,51198,286,3,251,149,102,51198,Вінницька область
846,51199,319,2,217,110,107,51199,Вінницька область
847,51200,443,4,271,172,99,51200,Вінницька область
848,51201,741,6,413,305,108,51201,Вінницька область
849,51202,886,21,583,379,204,51202,Вінницька область
850,51203,529,5,377,250,127,51203,Вінницька область
851,51204,800,6,454,278,176,51204,Вінницька область
852,51205,390,3,232,154,78,51205,Вінницька область
853,51206,611,7,364,211,153,51206,Вінницька область
854,51207,655,12,348,240,108,51207,Вінницька область
855,51208,699,7,343,241,102,51208,Вінницька область
856,51209,847,6,475,336,139,51209,Вінницька область
857,51285,1304,4,724,506,218,51285,Вінницька область
858,51286,910,14,474,285,189,51286,Вінницька область
859,51287,92,0,70,45,25,51287,Вінницька область
860,51288,378,1,213,135,78,51288,Вінницька область
861,51289,469,7,255,152,103,51289,Вінницька область
862,51290,783,3,452,242,210,51290,Вінницька область
863,51291,149,2,91,63,28,51291,Вінницька область
864,51292,47,1,22,13,9,51292,Вінницька область
865,51293,556,6,382,260,122,51293,Вінницька область
866,51294,726,8,452,355,97,51294,Вінницька область
867,51295,230,1,174,133,41,51295,Вінницька область
868,51296,486,1,420,277,143,51296,Вінницька область
869,51297,498,6,352,222,130,51297,Вінницька область
870,51298,1284,9,665,438,227,51298,Вінницька область
871,51299,888,11,487,302,185,51299,Вінницька область
872,51300,142,0,91,51,40,51300,Вінницька область
873,51301,247,0,131,104,27,51301,Вінницька область
874,51302,201,1,118,96,22,51302,Вінницька область
875,51303,514,3,367,229,138,51303,Вінницька область
876,51304,185,6,126,91,35,51304,Вінницька область
877,51305,674,7,379,271,108,51305,Вінницька область
878,51306,54,0,39,26,13,51306,Вінницька область
879,51307,419,5,264,147,117,51307,Вінницька область
880,51308,77,1,51,32,19,51308,Вінницька область
881,51309,54,0,45,21,24,51309,Вінницька область
882,51310,1512,18,791,519,272,51310,Вінницька область
883,51311,777,10,392,279,113,51311,Вінницька область
884,51312,200,5,155,96,59,51312,Вінницька область
885,51313,135,0,77,46,31,51313,Вінницька область
886,51314,1240,8,662,507,155,51314,Вінницька область
887,51315,498,6,328,178,150,51315,Вінницька область
888,51316,879,8,551,409,142,51316,Вінницька область
889,51317,247,9,139,82,57,51317,Вінницька область
890,51318,92,0,63,49,14,51318,Вінницька область
891,51319,28,0,23,15,8,51319,Вінницька область
892,51344,1676,28,958,703,255,51344,Вінницька область
893,51345,611,8,384,329,55,51345,Вінницька область
894,51346,616,6,311,187,124,51346,Вінницька область
895,51347,993,3,510,345,165,51347,Вінницька область
896,51348,620,5,309,218,91,51348,Вінницька область
897,51350,230,0,132,84,48,51350,Вінницька область
898,51351,166,1,112,66,46,51351,Вінницька область
899,51352,1211,15,641,490,151,51352,Вінницька область
900,51353,1206,11,592,456,136,51353,Вінницька область
901,51354,820,16,549,376,173,51354,Вінницька область
902,51355,1036,12,624,454,170,51355,Вінницька область
903,51356,477,4,322,218,104,51356,Вінницька область
904,51357,451,13,259,167,92,51357,Вінницька область
905,51358,784,7,542,276,266,51358,Вінницька область
906,51359,519,7,308,222,86,51359,Вінницька область
907,51360,590,6,345,266,79,51360,Вінницька область
908,51361,1708,36,1014,745,269,51361,Вінницька область
909,51362,1076,14,600,476,124,51362,Вінницька область
910,51363,782,10,450,333,117,51363,Вінницька область
911,51364,207,1,131,83,48,51364,Вінницька область
912,51365,2027,33,1112,841,271,51365,Вінницька область
913,51366,659,2,456,365,91,51366,Вінницька область
914,51367,1246,10,735,550,185,51367,Вінницька область
915,51368,533,6,304,163,141,51368,Вінницька область
916,51369,180,0,114,65,49,51369,Вінницька область
917,51370,545,6,324,264,60,51370,Вінницька область
918,51371,1570,20,902,696,206,51371,Вінницька область
919,51372,240,0,160,135,25,51372,Вінницька область
920,51373,695,12,404,279,125,51373,Вінницька область
921,51374,474,4,261,151,110,51374,Вінницька область
922,51375,1239,19,955,578,377,51375,Вінницька область
923,51376,237,1,171,126,45,51376,Вінницька область
924,51377,472,6,312,184,128,51377,Вінницька область
925,51378,703,7,394,228,166,51378,Вінницька область
926,51379,1796,9,959,629,330,51379,Вінницька область
927,51380,1767,29,898,566,332,51380,Вінницька область
928,51381,355,5,225,122,103,51381,Вінницька область
929,51382,653,3,474,257,217,51382,Вінницька область
930,51383,2014,21,1199,928,271,51383,Вінницька область
931,51384,417,6,289,208,81,51384,Вінницька область
932,51385,648,6,377,253,124,51385,Вінницька область
933,51386,138,1,87,56,31,51386,Вінницька область
934,51387,566,8,362,276,86,51387,Вінницька область
935,51388,1686,28,858,628,230,51388,Вінницька область
936,51389,116,0,76,52,24,51389,Вінницька область
937,51390,303,0,243,170,73,51390,Вінницька область
938,51391,823,24,608,417,191,51391,Вінницька область
939,51392,1661,24,991,739,252,51392,Вінницька область
940,51393,1531,21,973,738,235,51393,Вінницька область
941,51394,2205,43,1282,996,286,51394,Вінницька область
942,51395,77,0,59,47,12,51395,Вінницька область
943,50510,382,1,234,176,58,50510,Вінницька область
944,50511,59,1,37,29,8,50511,Вінницька область
945,50512,709,12,398,271,127,50512,Вінницька область
946,50513,1019,7,508,358,150,50513,Вінницька область
947,50515,1390,12,888,678,210,50515,Вінницька область
948,50517,1067,10,657,489,168,50517,Вінницька область
949,50518,291,1,180,148,32,50518,Вінницька область
950,50519,1897,22,1127,898,229,50519,Вінницька область
951,50521,1219,15,680,503,177,50521,Вінницька область
952,50522,1259,15,699,551,148,50522,Вінницька область
953,50524,199,0,120,72,48,50524,Вінницька область
954,50525,96,1,67,55,12,50525,Вінницька область
955,50526,207,3,135,112,23,50526,Вінницька область
956,50527,188,0,132,109,23,50527,Вінницька область
957,50528,99,0,56,32,24,50528,Вінницька область
958,50529,1274,19,828,514,314,50529,Вінницька область
959,50531,606,3,390,292,98,50531,Вінницька область
960,50532,269,1,190,124,66,50532,Вінницька область
961,50533,381,4,232,150,82,50533,Вінницька область
962,50534,398,2,316,215,101,50534,Вінницька область
963,50535,753,5,449,343,106,50535,Вінницька область
964,50536,157,2,90,63,27,50536,Вінницька область
965,50537,406,2,264,150,114,50537,Вінницька область
966,50538,377,2,239,148,91,50538,Вінницька область
967,50539,276,5,172,122,50,50539,Вінницька область
968,50540,662,3,388,291,97,50540,Вінницька область
969,50541,607,7,355,238,117,50541,Вінницька область
970,50542,431,8,239,195,44,50542,Вінницька область
971,50543,591,4,410,285,125,50543,Вінницька область
972,50544,676,7,417,316,101,50544,Вінницька область
973,50546,576,3,283,216,67,50546,Вінницька область
974,50547,2456,30,1484,1101,383,50547,Вінницька область
975,50548,2398,35,1461,1099,362,50548,Вінницька область
976,50549,2331,30,1388,1022,366,50549,Вінницька область
977,50550,100,5,91,86,5,50550,Вінницька область
978,50671,1352,13,680,488,192,50671,Вінницька область
979,50672,1598,12,808,592,216,50672,Вінницька область
980,50673,233,1,129,76,53,50673,Вінницька область
981,50674,601,1,366,274,92,50674,Вінницька область
982,50675,123,3,69,52,17,50675,Вінницька область
983,50676,421,2,264,196,68,50676,Вінницька область
984,50677,999,13,656,504,152,50677,Вінницька область
985,50678,294,5,149,116,33,50678,Вінницька область
986,50679,365,5,232,178,54,50679,Вінницька область
987,50680,280,9,157,114,43,50680,Вінницька область
988,50681,239,0,172,126,46,50681,Вінницька область
989,50682,300,6,201,136,65,50682,Вінницька область
990,50683,233,1,148,105,43,50683,Вінницька область
991,50684,63,1,37,21,16,50684,Вінницька область
992,50685,588,9,342,284,58,50685,Вінницька область
993,50686,402,7,288,222,66,50686,Вінницька область
994,50687,381,9,266,149,117,50687,Вінницька область
995,50688,153,2,99,64,35,50688,Вінницька область
996,50689,326,4,202,120,82,50689,Вінницька область
997,50690,160,1,100,70,30,50690,Вінницька область
998,50691,433,6,216,156,60,50691,Вінницька область
999,50692,368,13,212,136,76,50692,Вінницька область
1000,50693,740,10,421,295,126,50693,Вінницька область
1001,50694,152,0,104,44,60,50694,Вінницька область
1002,50695,208,1,101,50,51,50695,Вінницька область
1003,50696,212,1,129,107,22,50696,Вінницька область
1004,50697,1635,22,897,751,146,50697,Вінницька область
1005,50698,1081,12,728,388,340,50698,Вінницька область
1006,50699,233,2,129,76,53,50699,Вінницька область
1007,50700,149,0,82,59,23,50700,Вінницька область
1008,50701,541,4,345,269,76,50701,Вінницька область
1009,50702,313,0,217,165,52,50702,Вінницька область
1010,50703,2042,16,1121,893,228,50703,Вінницька область
1011,50704,420,6,260,209,51,50704,Вінницька область
1012,50706,227,5,151,120,31,50706,Вінницька область
1013,50707,383,2,213,138,75,50707,Вінницька область
1014,50708,380,2,192,136,56,50708,Вінницька область
1015,50709,71,0,47,28,19,50709,Вінницька область
1016,50710,315,6,191,144,47,50710,Вінницька область
1017,50711,274,0,147,114,33,50711,Вінницька область
1018,50712,1009,8,589,409,180,50712,Вінницька область
1019,50713,574,6,279,213,66,50713,Вінницька область
1020,50714,570,8,349,219,130,50714,Вінницька область
1021,50715,988,7,477,330,147,50715,Вінницька область
1022,50716,1208,11,628,518,110,50716,Вінницька область
1023,50717,406,1,269,204,65,50717,Вінницька область
1024,50718,425,3,235,155,80,50718,Вінницька область
1025,50719,275,5,182,148,34,50719,Вінницька область
1026,50720,215,6,209,139,70,50720,Вінницька область
1027,50892,1405,19,840,633,207,50892,Вінницька область
1028,50893,1130,15,599,456,143,50893,Вінницька область
1029,50894,1475,29,793,659,134,50894,Вінницька область
1030,50895,291,0,170,139,31,50895,Вінницька область
1031,50896,878,14,532,399,133,50896,Вінницька область
1032,50897,797,14,447,362,85,50897,Вінницька область
1033,50898,488,3,284,217,67,50898,Вінницька область
1034,50899,102,2,61,45,16,50899,Вінницька область
1035,50900,376,5,244,184,60,50900,Вінницька область
1036,50902,291,1,135,91,44,50902,Вінницька область
1037,50903,1026,17,531,426,105,50903,Вінницька область
1038,50904,171,2,123,88,35,50904,Вінницька область
1039,50905,544,5,309,246,63,50905,Вінницька область
1040,50906,723,8,461,378,83,50906,Вінницька область
1041,50907,418,6,238,154,84,50907,Вінницька область
1042,50908,481,14,288,214,74,50908,Вінницька область
1043,50909,682,11,503,381,122,50909,Вінницька область
1044,50910,692,6,527,434,93,50910,Вінницька область
1045,50911,140,0,107,86,21,50911,Вінницька область
1046,50912,174,2,113,83,30,50912,Вінницька область
1047,50913,490,4,278,185,93,50913,Вінницька область
1048,50914,252,4,154,91,63,50914,Вінницька область
1049,50915,49,0,28,10,18,50915,Вінницька область
1050,50916,794,5,475,337,138,50916,Вінницька область
1051,50917,288,3,184,135,49,50917,Вінницька область
1052,50918,520,5,336,254,82,50918,Вінницька область
1053,50919,52,3,48,33,15,50919,Вінницька область
1054,51320,560,4,320,188,132,51320,Вінницька область
1055,51321,524,8,296,183,113,51321,Вінницька область
1056,51322,382,5,275,194,81,51322,Вінницька область
1057,51323,496,10,319,177,142,51323,Вінницька область
1058,51324,98,1,56,41,15,51324,Вінницька область
1059,51325,1337,10,621,391,230,51325,Вінницька область
1060,51326,47,0,33,17,16,51326,Вінницька область
1061,51327,956,11,471,311,160,51327,Вінницька область
1062,51328,421,2,259,165,94,51328,Вінницька область
1063,51329,321,6,232,161,71,51329,Вінницька область
1064,51330,197,3,134,80,54,51330,Вінницька область
1065,51331,460,5,245,143,102,51331,Вінницька область
1066,51332,474,11,294,173,121,51332,Вінницька область
1067,51333,1434,15,667,450,217,51333,Вінницька область
1068,51334,889,10,380,254,126,51334,Вінницька область
1069,51335,621,5,377,182,195,51335,Вінницька область
1070,51336,15,0,11,1,10,51336,Вінницька область
1071,51337,752,5,417,269,148,51337,Вінницька область
1072,51338,772,3,427,292,135,51338,Вінницька область
1073,51339,679,11,370,248,122,51339,Вінницька область
1074,51340,703,4,388,259,129,51340,Вінницька область
1075,51341,2178,35,1183,728,455,51341,Вінницька область
1076,51342,2028,29,999,629,370,51342,Вінницька область
1077,51343,46,3,38,23,15,51343,Вінницька область
1078,51396,2456,30,1140,827,313,51396,Вінницька область
1079,51397,2146,34,1074,743,331,51397,Вінницька область
1080,51398,1987,27,1010,693,317,51398,Вінницька область
1081,51399,2154,27,1094,823,271,51399,Вінницька область
1082,51400,512,4,335,269,66,51400,Вінницька область
1083,51401,541,6,278,228,50,51401,Вінницька область
1084,51402,269,1,131,96,35,51402,Вінницька область
1085,51403,938,10,514,369,145,51403,Вінницька область
1086,51404,999,4,561,405,156,51404,Вінницька область
1087,51405,902,6,459,332,127,51405,Вінницька область
1088,51406,559,1,287,213,74,51406,Вінницька область
1089,51407,68,1,43,27,16,51407,Вінницька область
1090,51408,853,11,457,333,124,51408,Вінницька область
1091,51409,738,11,393,302,91,51409,Вінницька область
1092,51410,579,2,296,231,65,51410,Вінницька область
1093,51411,1117,14,628,354,274,51411,Вінницька область
1094,51412,1116,11,666,295,371,51412,Вінницька область
1095,51413,458,3,223,154,69,51413,Вінницька область
1096,51414,909,12,507,360,147,51414,Вінницька область
1097,51415,899,8,470,336,134,51415,Вінницька область
1098,51416,628,8,361,298,63,51416,Вінницька область
1099,51417,353,2,201,147,54,51417,Вінницька область
1100,51418,426,3,227,177,50,51418,Вінницька область
1101,51419,1081,15,581,452,129,51419,Вінницька область
1102,51420,596,2,377,282,95,51420,Вінницька область
1103,51421,321,0,200,153,47,51421,Вінницька область
1104,51422,379,8,225,150,75,51422,Вінницька область
1105,51423,797,12,452,311,141,51423,Вінницька область
1106,51424,208,2,148,80,68,51424,Вінницька область
1107,51425,503,5,289,223,66,51425,Вінницька область
1108,51426,169,0,79,55,24,51426,Вінницька область
1109,51427,298,3,145,116,29,51427,Вінницька область
1110,51428,337,0,160,96,64,51428,Вінницька область
1111,51429,324,2,153,102,51,51429,Вінницька область
1112,51430,568,6,322,251,71,51430,Вінницька область
1113,51431,615,3,317,254,63,51431,Вінницька область
1114,51432,223,3,121,86,35,51432,Вінницька область
1115,51433,1267,17,618,525,93,51433,Вінницька область
1116,51434,76,0,74,36,38,51434,Вінницька область
1117,51638,1076,14,539,427,112,51638,Вінницька область
1118,51639,875,12,497,397,100,51639,Вінницька область
1119,51640,1641,19,920,740,180,51640,Вінницька область
1120,51641,1593,20,853,676,177,51641,Вінницька область
1121,51642,1487,24,830,657,173,51642,Вінницька область
1122,51643,1707,28,946,729,217,51643,Вінницька область
1123,51644,1614,16,864,641,223,51644,Вінницька область
1124,51645,1829,28,1023,792,231,51645,Вінницька область
1125,51646,1632,17,914,738,176,51646,Вінницька область
1126,51647,1368,17,675,519,156,51647,Вінницька область
1127,51648,1272,29,654,517,137,51648,Вінницька область
1128,51649,2206,35,1267,994,273,51649,Вінницька область
1129,51650,1740,21,999,732,267,51650,Вінницька область
1130,51651,1187,9,616,473,143,51651,Вінницька область
1131,51652,1619,19,893,673,220,51652,Вінницька область
1132,51653,226,1,145,113,32,51653,Вінницька область
1133,51654,44,0,38,34,4,51654,Вінницька область
1134,51655,36,2,34,25,9,51655,Вінницька область
1135,50072,2140,33,1197,778,419,50072,Вінницька область
1136,50073,2446,29,1327,868,459,50073,Вінницька область
1137,50074,2166,41,1171,752,419,50074,Вінницька область
1138,50075,1278,22,684,465,219,50075,Вінницька область
1139,50076,1972,31,1020,780,240,50076,Вінницька область
1140,50077,1560,10,819,536,283,50077,Вінницька область
1141,50078,894,9,442,301,141,50078,Вінницька область
1142,50079,1649,21,975,624,351,50079,Вінницька область
1143,50080,1352,6,790,492,298,50080,Вінницька область
1144,50081,1570,18,841,567,274,50081,Вінницька область
1145,50082,1506,30,872,582,290,50082,Вінницька область
1146,50083,499,2,310,214,96,50083,Вінницька область
1147,50084,1323,13,716,557,159,50084,Вінницька область
1148,50085,1426,13,764,523,241,50085,Вінницька область
1149,50086,569,9,355,236,119,50086,Вінницька область
1150,50087,444,8,322,212,110,50087,Вінницька область
1151,50088,320,4,198,166,32,50088,Вінницька область
1152,50089,422,2,293,185,108,50089,Вінницька область
1153,50090,1333,11,775,490,285,50090,Вінницька область
1154,50091,749,6,516,344,172,50091,Вінницька область
1155,50092,228,0,138,91,47,50092,Вінницька область
1156,50093,1089,16,682,501,181,50093,Вінницька область
1157,50094,760,6,549,410,139,50094,Вінницька область
1158,50095,436,8,297,220,77,50095,Вінницька область
1159,50096,500,5,321,232,89,50096,Вінницька область
1160,50097,158,2,139,86,53,50097,Вінницька область
1161,50098,573,9,319,248,71,50098,Вінницька область
1162,50099,266,2,227,178,49,50099,Вінницька область
1163,50100,848,5,477,343,134,50100,Вінницька область
1164,50101,123,0,90,72,18,50101,Вінницька область
1165,50102,453,4,303,211,92,50102,Вінницька область
1166,50103,946,11,591,404,187,50103,Вінницька область
1167,50104,1118,8,635,416,219,50104,Вінницька область
1168,50105,158,2,130,96,34,50105,Вінницька область
1169,50106,298,4,188,113,75,50106,Вінницька область
1170,50107,316,4,171,130,41,50107,Вінницька область
1171,50108,522,4,344,235,109,50108,Вінницька область
1172,50109,880,12,525,318,207,50109,Вінницька область
1173,50110,719,8,431,294,137,50110,Вінницька область
1174,50111,355,4,217,146,71,50111,Вінницька область
1175,50112,718,13,522,331,191,50112,Вінницька область
1176,50113,1008,19,588,424,164,50113,Вінницька область
1177,50114,722,6,385,255,130,50114,Вінницька область
1178,50115,368,5,226,142,84,50115,Вінницька область
1179,50116,972,12,495,312,183,50116,Вінницька область
1180,50117,2404,30,1335,935,400,50117,Вінницька область
1181,50118,844,10,438,317,121,50118,Вінницька область
1182,50119,365,3,221,138,83,50119,Вінницька область
1183,50120,1441,21,875,603,272,50120,Вінницька область
1184,50121,127,0,84,63,21,50121,Вінницька область
1185,50122,341,6,232,176,56,50122,Вінницька область
1186,50123,1479,18,992,606,386,50123,Вінницька область
1187,50124,77,1,54,34,20,50124,Вінницька область
1188,50193,1060,17,694,473,221,50193,Вінницька область
1189,50194,1965,28,1031,766,265,50194,Вінницька область
1190,50195,1350,17,794,615,179,50195,Вінницька область
1191,50196,1184,15,681,519,162,50196,Вінницька область
1192,50197,1349,21,785,542,243,50197,Вінницька область
1193,50198,1165,24,689,506,183,50198,Вінницька область
1194,50199,1725,31,1007,780,227,50199,Вінницька область
1195,50200,1569,40,960,693,267,50200,Вінницька область
1196,50201,1838,37,1082,786,296,50201,Вінницька область
1197,50202,1563,31,890,649,241,50202,Вінницька область
1198,50203,1838,39,1123,831,292,50203,Вінницька область
1199,50204,1024,6,583,418,165,50204,Вінницька область
1200,50205,1413,15,838,610,228,50205,Вінницька область
1201,50206,453,3,285,196,89,50206,Вінницька область
1202,50207,216,2,153,91,62,50207,Вінницька область
1203,50208,681,11,469,244,225,50208,Вінницька область
1204,50209,187,1,126,78,48,50209,Вінницька область
1205,50210,55,2,37,20,17,50210,Вінницька область
1206,50211,620,10,387,314,73,50211,Вінницька область
1207,50212,593,4,325,235,90,50212,Вінницька область
1208,50213,480,4,287,226,61,50213,Вінницька область
1209,50214,404,9,247,181,66,50214,Вінницька область
1210,50215,1336,18,715,453,262,50215,Вінницька область
1211,50216,362,0,208,133,75,50216,Вінницька область
1212,50217,152,2,106,74,32,50217,Вінницька область
1213,50218,479,6,268,171,97,50218,Вінницька область
1214,50220,188,2,115,56,59,50220,Вінницька область
1215,50221,775,11,445,282,163,50221,Вінницька область
1216,50222,153,5,89,65,24,50222,Вінницька область
1217,50223,43,0,23,8,15,50223,Вінницька область
1218,50224,779,5,402,271,131,50224,Вінницька область
1219,50225,710,6,446,322,124,50225,Вінницька область
1220,50226,741,15,528,400,128,50226,Вінницька область
1221,50227,447,0,290,240,50,50227,Вінницька область
1222,50228,229,3,114,73,41,50228,Вінницька область
1223,50229,1054,19,832,603,229,50229,Вінницька область
1224,50230,534,6,327,212,115,50230,Вінницька область
1225,50231,79,0,59,36,23,50231,Вінницька область
1226,50232,234,2,151,98,53,50232,Вінницька область
1227,50233,655,10,442,267,175,50233,Вінницька область
1228,50234,1359,22,831,543,288,50234,Вінницька область
1229,50235,154,2,110,74,36,50235,Вінницька область
1230,50236,379,5,233,129,104,50236,Вінницька область
1231,50237,698,15,421,288,133,50237,Вінницька область
1232,50238,420,5,275,181,94,50238,Вінницька область
1233,50239,207,0,152,119,33,50239,Вінницька область
1234,50240,321,3,240,145,95,50240,Вінницька область
1235,50241,423,8,229,142,87,50241,Вінницька область
1236,50242,446,0,271,180,91,50242,Вінницька область
1237,50243,126,3,77,52,25,50243,Вінницька область
1238,50244,1007,11,722,451,271,50244,Вінницька область
1239,50245,531,4,390,307,83,50245,Вінницька область
1240,50246,231,1,150,106,44,50246,Вінницька область
1241,50247,74,1,58,36,22,50247,Вінницька область
1242,50248,682,9,441,318,123,50248,Вінницька область
1243,50249,594,5,458,283,175,50249,Вінницька область
1244,50250,471,4,300,224,76,50250,Вінницька область
1245,50251,217,1,140,90,50,50251,Вінницька область
1246,50252,333,5,208,145,63,50252,Вінницька область
1247,50253,501,9,339,230,109,50253,Вінницька область
1248,50254,636,9,402,304,98,50254,Вінницька область
1249,50255,763,9,491,358,133,50255,Вінницька область
1250,50256,370,9,248,162,86,50256,Вінницька область
1251,50257,278,3,208,151,57,50257,Вінницька область
1252,50258,603,9,340,263,77,50258,Вінницька область
1253,50259,236,2,138,87,51,50259,Вінницька область
1254,50260,82,1,66,28,38,50260,Вінницька область
1255,50985,1736,24,1039,746,293,50985,Вінницька область
1256,50986,1516,23,882,645,237,50986,Вінницька область
1257,50987,1827,22,1083,782,301,50987,Вінницька область
1258,50988,737,8,451,320,131,50988,Вінницька область
1259,50989,120,1,91,60,31,50989,Вінницька область
1260,50990,427,4,239,149,90,50990,Вінницька область
1261,50991,543,7,313,174,139,50991,Вінницька область
1262,50992,436,2,212,141,71,50992,Вінницька область
1263,50993,550,3,320,270,50,50993,Вінницька область
1264,50994,370,4,226,168,58,50994,Вінницька область
1265,50995,638,8,412,323,89,50995,Вінницька область
1266,50996,478,6,297,205,92,50996,Вінницька область
1267,50997,126,1,74,47,27,50997,Вінницька область
1268,50998,304,4,188,140,48,50998,Вінницька область
1269,50999,168,6,85,56,29,50999,Вінницька область
1270,51000,271,7,165,127,38,51000,Вінницька область
1271,51001,790,5,458,310,148,51001,Вінницька область
1272,51002,203,1,125,84,41,51002,Вінницька область
1273,51003,606,6,476,334,142,51003,Вінницька область
1274,51004,448,9,321,211,110,51004,Вінницька область
1275,51005,466,6,265,171,94,51005,Вінницька область
1276,51006,363,2,212,135,77,51006,Вінницька область
1277,51007,525,3,344,284,60,51007,Вінницька область
1278,51008,340,3,247,172,75,51008,Вінницька область
1279,51009,90,1,65,42,23,51009,Вінницька область
1280,51010,470,5,280,220,60,51010,Вінницька область
1281,51011,158,2,127,90,37,51011,Вінницька область
1282,51012,121,4,104,43,61,51012,Вінницька область
1283,51013,273,1,166,112,54,51013,Вінницька область
1284,51014,819,2,377,253,124,51014,Вінницька область
1285,51015,683,7,373,249,124,51015,Вінницька область
1286,51016,731,7,412,284,128,51016,Вінницька область
1287,51017,169,1,142,92,50,51017,Вінницька область
1288,51018,250,2,206,149,57,51018,Вінницька область
1289,51019,670,4,375,293,82,51019,Вінницька область
1290,51020,244,2,163,101,62,51020,Вінницька область
1291,51021,397,6,280,240,40,51021,Вінницька область
1292,51022,261,4,163,117,46,51022,Вінницька область
1293,51023,159,6,114,89,25,51023,Вінницька область
1294,51024,539,2,343,218,125,51024,Вінницька область
1295,51025,403,5,247,140,107,51025,Вінницька область
1296,51026,349,10,199,146,53,51026,Вінницька область
1297,51027,601,8,323,252,71,51027,Вінницька область
1298,51028,276,4,163,111,52,51028,Вінницька область
1299,51029,39,0,36,26,10,51029,Вінницька область
1300,51030,11,0,11,5,6,51030,Вінницька область
1301,51129,1753,23,1016,709,307,51129,Вінницька область
1302,51130,2077,26,1215,891,324,51130,Вінницька область
1303,51131,2152,30,1260,873,387,51131,Вінницька область
1304,51132,539,3,353,183,170,51132,Вінницька область
1305,51133,133,1,80,41,39,51133,Вінницька область
1306,51134,894,14,634,467,167,51134,Вінницька область
1307,51135,502,7,329,238,91,51135,Вінницька область
1308,51137,1104,8,829,553,276,51137,Вінницька область
1309,51138,1103,12,648,488,160,51138,Вінницька область
1310,51139,901,13,601,432,169,51139,Вінницька область
1311,51140,1068,12,651,480,171,51140,Вінницька область
1312,51141,1016,8,662,433,229,51141,Вінницька область
1313,51142,490,4,332,257,75,51142,Вінницька область
1314,51143,1401,10,776,545,231,51143,Вінницька область
1315,51144,696,4,387,301,86,51144,Вінницька область
1316,51145,654,9,366,247,119,51145,Вінницька область
1317,51146,203,2,153,65,88,51146,Вінницька область
1318,51147,135,0,83,58,25,51147,Вінницька область
1319,51148,559,11,334,184,150,51148,Вінницька область
1320,51149,1052,13,587,425,162,51149,Вінницька область
1321,51150,1183,16,639,426,213,51150,Вінницька область
1322,51151,766,5,419,324,95,51151,Вінницька область
1323,51152,472,3,368,226,142,51152,Вінницька область
1324,51153,329,2,209,123,86,51153,Вінницька область
1325,51154,884,8,537,385,152,51154,Вінницька область
1326,51155,722,3,485,341,144,51155,Вінницька область
1327,51156,72,1,52,40,12,51156,Вінницька область
1328,51157,1238,13,685,539,146,51157,Вінницька область
1329,51158,959,15,606,452,154,51158,Вінницька область
1330,51159,119,0,76,62,14,51159,Вінницька область
1331,51160,569,8,390,217,173,51160,Вінницька область
1332,51161,459,5,242,165,77,51161,Вінницька область
1333,51162,620,5,335,233,102,51162,Вінницька область
1334,51163,232,4,158,79,79,51163,Вінницька область
1335,51164,42,1,31,23,8,51164,Вінницька область
1336,51624,2196,38,1429,1086,343,51624,Вінницька область
1337,51625,2412,27,1567,1156,411,51625,Вінницька область
1338,51626,866,14,519,378,141,51626,Вінницька область
1339,51627,1727,25,1034,818,216,51627,Вінницька область
1340,51629,581,11,331,260,71,51629,Вінницька область
1341,51630,278,4,177,124,53,51630,Вінницька область
1342,51631,1531,26,951,694,257,51631,Вінницька область
1343,51632,2025,38,1304,965,339,51632,Вінницька область
1344,51633,2088,41,1324,949,375,51633,Вінницька область
1345,51634,2142,37,1282,952,330,51634,Вінницька область
1346,51635,1092,17,706,517,189,51635,Вінницька область
1347,51636,10,0,9,6,3,51636,Вінницька область
1348,51637,273,7,265,207,58,51637,Вінницька область
1349,50319,427,11,292,222,70,50319,Вінницька область
1350,50320,745,9,485,349,136,50320,Вінницька область
1351,50321,1082,15,737,499,238,50321,Вінницька область
1352,50322,1306,28,815,553,262,50322,Вінницька область
1353,50323,1340,24,849,589,260,50323,Вінницька область
1354,50324,2070,35,1235,849,386,50324,Вінницька область
1355,50325,1067,19,664,442,222,50325,Вінницька область
1356,50326,787,17,480,299,181,50326,Вінницька область
1357,50327,300,4,189,133,56,50327,Вінницька область
1358,50328,1018,13,644,425,219,50328,Вінницька область
1359,50329,908,10,526,345,181,50329,Вінницька область
1360,50330,942,18,501,387,114,50330,Вінницька область
1361,50331,874,8,531,339,192,50331,Вінницька область
1362,50332,446,6,282,202,80,50332,Вінницька область
1363,50333,420,5,259,161,98,50333,Вінницька область
1364,50334,189,0,126,81,45,50334,Вінницька область
1365,50335,328,6,202,164,38,50335,Вінницька область
1366,50336,825,14,498,351,147,50336,Вінницька область
1367,50337,359,7,232,122,110,50337,Вінницька область
1368,50338,526,6,282,188,94,50338,Вінницька область
1369,50339,558,8,317,226,91,50339,Вінницька область
1370,50340,702,5,413,299,114,50340,Вінницька область
1371,50341,68,0,49,37,12,50341,Вінницька область
1372,50342,493,6,297,169,128,50342,Вінницька область
1373,50343,252,2,181,109,72,50343,Вінницька область
1374,50344,859,5,557,381,176,50344,Вінницька область
1375,50345,205,1,139,107,32,50345,Вінницька область
1376,50346,411,4,236,130,106,50346,Вінницька область
1377,50347,841,13,512,355,157,50347,Вінницька область
1378,50348,623,9,372,278,94,50348,Вінницька область
1379,50349,373,5,242,147,95,50349,Вінницька область
1380,50350,109,0,64,42,22,50350,Вінницька область
1381,50351,411,8,275,181,94,50351,Вінницька область
1382,50352,269,1,202,147,55,50352,Вінницька область
1383,50353,296,3,193,128,65,50353,Вінницька область
1384,50354,135,2,83,49,34,50354,Вінницька область
1385,50355,317,6,209,120,89,50355,Вінницька область
1386,50356,413,6,273,190,83,50356,Вінницька область
1387,50357,68,0,46,24,22,50357,Вінницька область
1388,50358,312,4,187,89,98,50358,Вінницька область
1389,50359,913,12,711,513,198,50359,Вінницька область
1390,50360,436,7,262,165,97,50360,Вінницька область
1391,50361,200,0,121,88,33,50361,Вінницька область
1392,50362,432,9,298,215,83,50362,Вінницька область
1393,50363,239,0,130,95,35,50363,Вінницька область
1394,50364,326,0,209,144,65,50364,Вінницька область
1395,50365,656,2,457,298,159,50365,Вінницька область
1396,50366,385,2,251,167,84,50366,Вінницька область
1397,50367,249,1,189,137,52,50367,Вінницька область
1398,50368,439,5,270,182,88,50368,Вінницька область
1399,50369,265,0,187,127,60,50369,Вінницька область
1400,50370,284,1,179,107,72,50370,Вінницька область
1401,50371,56,0,48,34,14,50371,Вінницька область
1402,50372,143,2,102,44,58,50372,Вінницька область
1403,50373,19,0,12,10,2,50373,Вінницька область
1404,50374,25,0,21,17,4,50374,Вінницька область
1405,50551,1429,21,853,551,302,50551,Вінницька область
1406,50552,1116,17,694,465,229,50552,Вінницька область
1407,50553,388,7,252,154,98,50553,Вінницька область
1408,50554,1884,21,1172,797,375,50554,Вінницька область
1409,50555,1335,20,727,522,205,50555,Вінницька область
1410,50556,1066,17,648,433,215,50556,Вінницька область
1411,50557,181,0,130,62,68,50557,Вінницька область
1412,50558,251,8,195,115,80,50558,Вінницька область
1413,50559,268,6,160,87,73,50559,Вінницька область
1414,50560,25,0,15,7,8,50560,Вінницька область
1415,50561,309,4,214,106,108,50561,Вінницька область
1416,50562,479,7,307,226,81,50562,Вінницька область
1417,50563,267,1,174,109,65,50563,Вінницька область
1418,50564,184,1,111,82,29,50564,Вінницька область
1419,50565,311,3,178,101,77,50565,Вінницька область
1420,50566,522,4,339,223,116,50566,Вінницька область
1421,50567,142,4,93,57,36,50567,Вінницька область
1422,50568,328,1,234,123,111,50568,Вінницька область
1423,50569,1582,14,928,573,355,50569,Вінницька область
1424,50570,314,2,169,116,53,50570,Вінницька область
1425,50571,380,3,241,154,87,50571,Вінницька область
1426,50572,333,6,221,112,109,50572,Вінницька область
1427,50573,314,0,191,141,50,50573,Вінницька область
1428,50574,91,2,53,26,27,50574,Вінницька область
1429,50575,54,0,46,20,26,50575,Вінницька область
1430,50576,360,3,228,140,88,50576,Вінницька область
1431,50577,305,2,184,90,94,50577,Вінницька область
1432,50578,636,5,362,140,222,50578,Вінницька область
1433,50579,122,2,65,32,33,50579,Вінницька область
1434,50580,83,0,65,36,29,50580,Вінницька область
1435,50581,1661,20,931,585,346,50581,Вінницька область
1436,50582,1548,15,903,612,291,50582,Вінницька область
1437,50584,952,10,540,364,176,50584,Вінницька область
1438,50585,200,1,135,87,48,50585,Вінницька область
1439,50586,113,1,72,37,35,50586,Вінницька область
1440,50587,321,7,242,119,123,50587,Вінницька область
1441,50588,840,10,440,231,209,50588,Вінницька область
1442,50590,217,0,119,61,58,50590,Вінницька область
1443,50591,303,7,183,112,71,50591,Вінницька область
1444,50592,979,7,664,411,253,50592,Вінницька область
1445,50593,289,6,172,89,83,50593,Вінницька область
1446,50594,242,4,160,98,62,50594,Вінницька область
1447,50595,199,3,157,81,76,50595,Вінницька область
1448,50596,287,3,202,144,58,50596,Вінницька область
1449,50597,241,1,160,83,77,50597,Вінницька область
1450,50598,417,3,259,109,150,50598,Вінницька область
1451,50599,57,0,38,31,7,50599,Вінницька область
1452,50600,75,0,53,35,18,50600,Вінницька область
1453,50601,1337,12,796,528,268,50601,Вінницька область
1454,50602,897,12,548,286,262,50602,Вінницька область
1455,50603,239,6,150,103,47,50603,Вінницька область
1456,50604,758,8,451,262,189,50604,Вінницька область
1457,50605,938,5,613,371,242,50605,Вінницька область
1458,50606,46,1,35,27,8,50606,Вінницька область
1459,50770,1760,33,1103,781,322,50770,Вінницька область
1460,50771,1760,29,1083,752,331,50771,Вінницька область
1461,50772,1348,32,894,627,267,50772,Вінницька область
1462,50773,1669,19,1135,711,424,50773,Вінницька область
1463,50774,1810,27,1106,712,394,50774,Вінницька область
1464,50775,1100,39,561,400,161,50775,Вінницька область
1465,50776,1423,8,834,572,262,50776,Вінницька область
1466,50777,1100,10,648,492,156,50777,Вінницька область
1467,50778,923,10,573,361,212,50778,Вінницька область
1468,50779,788,4,419,282,137,50779,Вінницька область
1469,50780,293,1,201,124,77,50780,Вінницька область
1470,50781,80,2,55,25,30,50781,Вінницька область
1471,50782,115,3,93,47,46,50782,Вінницька область
1472,50783,297,4,214,102,112,50783,Вінницька область
1473,50784,231,1,172,82,90,50784,Вінницька область
1474,50786,401,6,250,135,115,50786,Вінницька область
1475,50787,943,13,587,403,184,50787,Вінницька область
1476,50788,388,4,247,121,126,50788,Вінницька область
1477,50789,179,3,141,65,76,50789,Вінницька область
1478,50790,393,3,239,134,105,50790,Вінницька область
1479,50791,621,5,425,270,155,50791,Вінницька область
1480,50792,137,0,106,59,47,50792,Вінницька область
1481,50793,309,5,238,145,93,50793,Вінницька область
1482,50794,247,1,179,114,65,50794,Вінницька область
1483,50795,315,3,211,124,87,50795,Вінницька область
1484,50796,369,1,186,120,66,50796,Вінницька область
1485,50797,258,6,181,133,48,50797,Вінницька область
1486,50798,253,3,169,104,65,50798,Вінницька область
1487,50799,222,2,163,92,71,50799,Вінницька область
1488,50800,191,2,146,100,46,50800,Вінницька область
1489,50801,182,2,127,70,57,50801,Вінницька область
1490,50802,160,0,110,61,49,50802,Вінницька область
1491,50803,193,5,123,72,51,50803,Вінницька область
1492,50804,75,1,48,28,20,50804,Вінницька область
1493,50805,1093,12,649,413,236,50805,Вінницька область
1494,50806,491,6,351,200,151,50806,Вінницька область
1495,50808,1036,17,599,372,227,50808,Вінницька область
1496,50809,1510,23,851,560,291,50809,Вінницька область
1497,50810,151,0,109,59,50,50810,Вінницька область
1498,50811,168,1,117,83,34,50811,Вінницька область
1499,50812,319,8,208,133,75,50812,Вінницька область
1500,50813,163,0,138,90,48,50813,Вінницька область
1501,50814,152,2,106,47,59,50814,Вінницька область
1502,50815,232,1,159,62,97,50815,Вінницька область
1503,50816,252,1,183,89,94,50816,Вінницька область
1504,50817,622,6,412,263,149,50817,Вінницька область
1505,50818,408,6,340,221,119,50818,Вінницька область
1506,50819,263,1,184,124,60,50819,Вінницька область
1507,50820,228,4,147,72,75,50820,Вінницька область
1508,50821,391,8,264,147,117,50821,Вінницька область
1509,50822,1100,15,675,460,215,50822,Вінницька область
1510,50823,159,3,130,67,63,50823,Вінницька область
1511,50824,83,1,58,24,34,50824,Вінницька область
1512,50825,316,3,205,97,108,50825,Вінницька область
1513,50826,190,1,117,52,65,50826,Вінницька область
1514,50827,497,5,309,167,142,50827,Вінницька область
1515,50828,217,0,165,128,37,50828,Вінницька область
1516,50829,342,3,269,162,107,50829,Вінницька область
1517,50830,401,3,269,163,106,50830,Вінницька область
1518,50831,709,4,465,313,152,50831,Вінницька область
1519,50832,152,0,118,74,44,50832,Вінницька область
1520,50833,518,4,351,178,173,50833,Вінницька область
1521,50834,208,2,138,77,61,50834,Вінницька область
1522,50835,89,0,67,39,28,50835,Вінницька область
1523,50836,119,0,91,38,53,50836,Вінницька область
1524,50837,640,7,409,274,135,50837,Вінницька область
1525,50839,473,8,304,176,128,50839,Вінницька область
1526,50840,334,1,231,164,67,50840,Вінницька область
1527,50841,655,7,468,326,142,50841,Вінницька область
1528,50842,145,2,104,66,38,50842,Вінницька область
1529,50843,93,1,69,38,31,50843,Вінницька область
1530,50844,484,5,296,152,144,50844,Вінницька область
1531,50845,194,2,132,99,33,50845,Вінницька область
1532,50846,484,9,385,265,120,50846,Вінницька область
1533,50847,125,3,82,52,30,50847,Вінницька область
1534,50848,26,0,16,11,5,50848,Вінницька область
1535,50849,1429,14,925,602,323,50849,Вінницька область
1536,50850,1184,21,695,455,240,50850,Вінницька область
1537,50851,138,1,90,53,37,50851,Вінницька область
1538,50852,717,10,477,322,155,50852,Вінницька область
1539,50853,459,9,326,203,123,50853,Вінницька область
1540,50854,522,7,344,179,165,50854,Вінницька область
1541,50855,459,4,330,207,123,50855,Вінницька область
1542,50856,208,0,121,87,34,50856,Вінницька область
1543,50857,363,2,230,162,68,50857,Вінницька область
1544,50858,235,3,173,114,59,50858,Вінницька область
1545,50859,199,4,121,84,37,50859,Вінницька область
1546,50860,395,6,249,188,61,50860,Вінницька область
1547,50861,457,9,347,214,133,50861,Вінницька область
1548,50862,928,12,583,348,235,50862,Вінницька область
1549,50863,562,12,347,246,101,50863,Вінницька область
1550,50864,400,6,240,166,74,50864,Вінницька область
1551,50865,285,2,161,92,69,50865,Вінницька область
1552,50866,131,0,79,51,28,50866,Вінницька область
1553,50867,305,5,204,107,97,50867,Вінницька область
1554,50868,263,2,188,112,76,50868,Вінницька область
1555,50869,147,1,102,65,37,50869,Вінницька область
1556,50870,333,2,215,101,114,50870,Вінницька область
1557,50871,433,5,377,241,136,50871,Вінницька область
1558,50872,766,7,398,309,89,50872,Вінницька область
1559,50873,219,4,145,105,40,50873,Вінницька область
1560,50874,166,3,127,74,53,50874,Вінницька область
1561,50875,345,5,238,139,99,50875,Вінницька область
1562,50876,164,2,119,82,37,50876,Вінницька область
1563,50877,212,0,154,124,30,50877,Вінницька область
1564,50878,228,3,152,60,92,50878,Вінницька область
1565,50879,416,8,252,138,114,50879,Вінницька область
1566,50880,606,6,425,249,176,50880,Вінницька область
1567,50881,141,1,102,61,41,50881,Вінницька область
1568,50882,295,3,191,128,63,50882,Вінницька область
1569,50883,673,8,516,297,219,50883,Вінницька область
1570,50884,451,1,363,163,200,50884,Вінницька область
1571,50885,61,0,47,26,21,50885,Вінницька область
1572,50886,328,1,231,139,92,50886,Вінницька область
1573,50887,198,2,134,77,57,50887,Вінницька область
1574,50888,44,0,27,15,12,50888,Вінницька область
1575,50889,871,14,588,376,212,50889,Вінницька область
1576,50890,164,2,105,59,46,50890,Вінницька область
1577,50891,23,0,22,11,11,50891,Вінницька область
1578,50921,1904,43,1135,747,388,50921,Вінницька область
1579,50922,2026,29,1155,825,330,50922,Вінницька область
1580,50923,1719,22,885,637,248,50923,Вінницька область
1581,50924,497,4,288,212,76,50924,Вінницька область
1582,50925,1303,20,758,512,246,50925,Вінницька область
1583,50926,375,2,229,134,95,50926,Вінницька область
1584,50927,399,11,235,162,73,50927,Вінницька область
1585,50928,668,8,431,231,200,50928,Вінницька область
1586,50929,69,0,48,22,26,50929,Вінницька область
1587,50930,337,3,227,101,126,50930,Вінницька область
1588,50931,23,1,18,5,13,50931,Вінницька область
1589,50932,204,1,145,89,56,50932,Вінницька область
1590,50933,68,1,40,27,13,50933,Вінницька область
1591,50934,142,1,88,66,22,50934,Вінницька область
1592,50935,332,3,221,126,95,50935,Вінницька область
1593,50936,145,0,104,64,40,50936,Вінницька область
1594,50937,1040,15,563,389,174,50937,Вінницька область
1595,50938,834,11,489,332,157,50938,Вінницька область
1596,50939,384,3,221,143,78,50939,Вінницька область
1597,50940,287,3,180,130,50,50940,Вінницька область
1598,50941,55,0,43,24,19,50941,Вінницька область
1599,50942,56,0,42,30,12,50942,Вінницька область
1600,50943,224,0,154,88,66,50943,Вінницька область
1601,50944,287,4,156,84,72,50944,Вінницька область
1602,50945,388,5,245,158,87,50945,Вінницька область
1603,50946,263,4,187,115,72,50946,Вінницька область
1604,50947,437,11,365,231,134,50947,Вінницька область
1605,50948,321,4,196,98,98,50948,Вінницька область
1606,50949,526,4,354,147,207,50949,Вінницька область
1607,50950,42,1,28,11,17,50950,Вінницька область
1608,50951,436,4,266,150,116,50951,Вінницька область
1609,50952,185,8,117,69,48,50952,Вінницька область
1610,50953,320,3,152,85,67,50953,Вінницька область
1611,50954,609,6,436,300,136,50954,Вінницька область
1612,50955,257,3,159,108,51,50955,Вінницька область
1613,50956,328,3,224,149,75,50956,Вінницька область
1614,50957,214,4,136,105,31,50957,Вінницька область
1615,50958,938,17,416,253,163,50958,Вінницька область
1616,50959,485,3,265,193,72,50959,Вінницька область
1617,50960,241,2,178,118,60,50960,Вінницька область
1618,50961,31,1,23,5,18,50961,Вінницька область
1619,50962,159,1,108,50,58,50962,Вінницька область
1620,50963,112,1,74,28,46,50963,Вінницька область
1621,50964,351,3,238,164,74,50964,Вінницька область
1622,50965,53,0,47,16,31,50965,Вінницька область
1623,50966,24,1,16,7,9,50966,Вінницька область
1624,50967,239,1,153,100,53,50967,Вінницька область
1625,50968,61,1,47,25,22,50968,Вінницька область
1626,50969,338,3,215,120,95,50969,Вінницька область
1627,50970,137,0,93,59,34,50970,Вінницька область
1628,50971,360,4,246,160,86,50971,Вінницька область
1629,50972,23,0,21,6,15,50972,Вінницька область
1630,50973,233,1,157,97,60,50973,Вінницька область
1631,50974,216,3,163,60,103,50974,Вінницька область
1632,50975,210,3,117,71,46,50975,Вінницька область
1633,50976,466,6,308,165,143,50976,Вінницька область
1634,50977,78,0,47,20,27,50977,Вінницька область
1635,50978,102,0,78,40,38,50978,Вінницька область
1636,50979,188,1,131,58,73,50979,Вінницька область
1637,50980,350,2,238,124,114,50980,Вінницька область
1638,50981,102,1,61,36,25,50981,Вінницька область
1639,50982,94,0,67,50,17,50982,Вінницька область
1640,50983,47,0,37,19,18,50983,Вінницька область
1641,50984,40,0,40,7,33,50984,Вінницька область
1642,70001,1687,29,1026,675,351,70001,Волинська область
1643,70002,191,2,120,79,41,70002,Волинська область
1644,70004,143,5,95,74,21,70004,Волинська область
1645,70005,490,4,354,195,159,70005,Волинська область
1646,70006,245,1,141,110,31,70006,Волинська область
1647,70007,81,4,56,22,34,70007,Волинська область
1648,70008,111,0,72,43,29,70008,Волинська область
1649,70009,135,0,96,70,26,70009,Волинська область
1650,70010,308,6,196,162,34,70010,Волинська область
1651,70011,62,1,46,32,14,70011,Волинська область
1652,70012,245,4,146,114,32,70012,Волинська область
1653,70013,434,3,255,144,111,70013,Волинська область
1654,70014,192,1,107,56,51,70014,Волинська область
1655,70015,109,2,71,44,27,70015,Волинська область
1656,70016,61,2,31,16,15,70016,Волинська область
1657,70017,264,5,148,102,46,70017,Волинська область
1658,70018,260,6,180,112,68,70018,Волинська область
1659,70019,1273,21,821,571,250,70019,Волинська область
1660,70020,234,5,138,108,30,70020,Волинська область
1661,70021,412,11,246,176,70,70021,Волинська область
1662,70022,673,14,380,256,124,70022,Волинська область
1663,70023,437,4,276,211,65,70023,Волинська область
1664,70024,679,14,432,310,122,70024,Волинська область
1665,70025,145,4,119,89,30,70025,Волинська область
1666,70026,158,4,98,60,38,70026,Волинська область
1667,70027,129,4,83,62,21,70027,Волинська область
1668,70028,251,1,165,120,45,70028,Волинська область
1669,70029,63,2,43,30,13,70029,Волинська область
1670,70030,56,0,44,33,11,70030,Волинська область
1671,70031,359,4,221,155,66,70031,Волинська область
1672,70032,482,12,252,164,88,70032,Волинська область
1673,70033,169,1,114,76,38,70033,Волинська область
1674,70034,356,1,233,114,119,70034,Волинська область
1675,70035,189,1,129,91,38,70035,Волинська область
1676,70036,118,0,88,53,35,70036,Волинська область
1677,70037,114,1,85,45,40,70037,Волинська область
1678,70038,986,5,624,479,145,70038,Волинська область
1679,70039,216,3,129,101,28,70039,Волинська область
1680,70040,211,2,146,100,46,70040,Волинська область
1681,70041,506,6,336,252,84,70041,Волинська область
1682,70042,157,3,106,79,27,70042,Волинська область
1683,70043,257,2,188,121,67,70043,Волинська область
1684,70044,219,3,126,76,50,70044,Волинська область
1685,70045,50,0,35,21,14,70045,Волинська область
1686,70046,822,19,519,362,157,70046,Волинська область
1687,70047,419,9,242,150,92,70047,Волинська область
1688,70048,570,6,361,213,148,70048,Волинська область
1689,70049,60,1,36,27,9,70049,Волинська область
1690,70050,631,5,398,299,99,70050,Волинська область
1691,70051,186,1,135,98,37,70051,Волинська область
1692,70052,282,3,196,120,76,70052,Волинська область
1693,70053,116,2,83,56,27,70053,Волинська область
1694,70054,303,1,197,147,50,70054,Волинська область
1695,70055,144,0,94,82,12,70055,Волинська область
1696,70056,58,0,41,34,7,70056,Волинська область
1697,70057,335,2,230,158,72,70057,Волинська область
1698,70058,112,3,64,43,21,70058,Волинська область
1699,70059,331,4,202,144,58,70059,Волинська область
1700,70060,198,0,133,104,29,70060,Волинська область
1701,70061,141,4,91,67,24,70061,Волинська область
1702,70062,154,2,98,84,14,70062,Волинська область
1703,70063,535,6,360,236,124,70063,Волинська область
1704,70064,291,2,205,166,39,70064,Волинська область
1705,70065,125,3,79,53,26,70065,Волинська область
1706,70066,298,4,212,155,57,70066,Волинська область
1707,70067,49,0,44,29,15,70067,Волинська область
1708,70156,1508,33,805,504,301,70156,Волинська область
1709,70157,977,16,560,348,212,70157,Волинська область
1710,70158,1210,18,680,418,262,70158,Волинська область
1711,70159,1140,12,690,428,262,70159,Волинська область
1712,70160,252,1,155,113,42,70160,Волинська область
1713,70161,605,6,414,276,138,70161,Волинська область
1714,70162,337,3,224,163,61,70162,Волинська область
1715,70163,220,7,168,118,50,70163,Волинська область
1716,70164,623,8,411,251,160,70164,Волинська область
1717,70165,808,6,529,300,229,70165,Волинська область
1718,70166,601,5,415,281,134,70166,Волинська область
1719,70167,582,13,362,227,135,70167,Волинська область
1720,70168,404,12,266,162,104,70168,Волинська область
1721,70169,669,6,433,307,126,70169,Волинська область
1722,70171,366,6,276,176,100,70171,Волинська область
1723,70172,511,8,355,183,172,70172,Волинська область
1724,70173,688,10,499,309,190,70173,Волинська область
1725,70174,978,11,576,380,196,70174,Волинська область
1726,70175,250,2,166,109,57,70175,Волинська область
1727,70176,146,1,96,73,23,70176,Волинська область
1728,70177,281,4,154,114,40,70177,Волинська область
1729,70178,439,5,288,128,160,70178,Волинська область
1730,70179,205,1,130,68,62,70179,Волинська область
1731,70180,579,9,374,257,117,70180,Волинська область
1732,70181,426,5,295,176,119,70181,Волинська область
1733,70182,272,7,182,113,69,70182,Волинська область
1734,70183,174,5,138,83,55,70183,Волинська область
1735,70184,390,5,218,129,89,70184,Волинська область
1736,70186,774,14,505,388,117,70186,Волинська область
1737,70187,645,10,392,231,161,70187,Волинська область
1738,70188,278,1,205,134,71,70188,Волинська область
1739,70189,251,5,163,106,57,70189,Волинська область
1740,70190,429,7,271,184,87,70190,Волинська область
1741,70191,331,2,220,145,75,70191,Волинська область
1742,70192,582,23,437,308,129,70192,Волинська область
1743,70193,406,9,329,273,56,70193,Волинська область
1744,70195,146,6,97,65,32,70195,Волинська область
1745,70196,323,4,182,127,55,70196,Волинська область
1746,70197,174,1,119,61,58,70197,Волинська область
1747,70198,665,10,405,255,150,70198,Волинська область
1748,70199,400,4,262,163,99,70199,Волинська область
1749,70200,311,4,213,87,126,70200,Волинська область
1750,70201,748,12,479,306,173,70201,Волинська область
1751,70202,574,7,319,222,97,70202,Волинська область
1752,70203,300,2,223,128,95,70203,Волинська область
1753,70204,201,3,143,83,60,70204,Волинська область
1754,70205,313,4,232,107,125,70205,Волинська область
1755,70589,1876,41,1050,758,292,70589,Волинська область
1756,70590,1888,33,1113,827,286,70590,Волинська область
1757,70591,2227,43,1284,990,294,70591,Волинська область
1758,70592,1977,35,1081,837,244,70592,Волинська область
1759,70593,2081,33,1039,857,182,70593,Волинська область
1760,70594,370,3,207,157,50,70594,Волинська область
1761,70595,118,2,61,48,13,70595,Волинська область
1762,70596,72,0,44,33,11,70596,Волинська область
1763,70597,591,5,374,315,59,70597,Волинська область
1764,70598,395,5,223,155,68,70598,Волинська область
1765,70599,892,19,592,424,168,70599,Волинська область
1766,70600,246,3,167,135,32,70600,Волинська область
1767,70601,582,7,357,270,87,70601,Волинська область
1768,70602,134,1,98,61,37,70602,Волинська область
1769,70603,69,0,55,38,17,70603,Волинська область
1770,70604,50,3,38,27,11,70604,Волинська область
1771,70605,417,11,260,190,70,70605,Волинська область
1772,70606,287,4,186,124,62,70606,Волинська область
1773,70607,73,6,46,30,16,70607,Волинська область
1774,70608,515,4,368,287,81,70608,Волинська область
1775,70609,151,1,124,86,38,70609,Волинська область
1776,70610,92,0,69,42,27,70610,Волинська область
1777,70611,454,4,258,182,76,70611,Волинська область
1778,70612,102,0,66,48,18,70612,Волинська область
1779,70613,90,2,68,57,11,70613,Волинська область
1780,70614,382,5,249,174,75,70614,Волинська область
1781,70615,188,3,133,91,42,70615,Волинська область
1782,70616,1014,7,612,420,192,70616,Волинська область
1783,70617,298,3,183,132,51,70617,Волинська область
1784,70618,220,3,132,82,50,70618,Волинська область
1785,70619,226,1,128,106,22,70619,Волинська область
1786,70620,1384,23,829,691,138,70620,Волинська область
1787,70621,370,2,235,187,48,70621,Волинська область
1788,70622,520,5,338,203,135,70622,Волинська область
1789,70623,186,1,149,100,49,70623,Волинська область
1790,70624,183,2,119,87,32,70624,Волинська область
1791,70625,506,3,288,232,56,70625,Волинська область
1792,70626,128,5,52,31,21,70626,Волинська область
1793,70627,233,4,111,75,36,70627,Волинська область
1794,70628,551,5,375,284,91,70628,Волинська область
1795,70629,152,2,98,67,31,70629,Волинська область
1796,70630,684,8,422,307,115,70630,Волинська область
1797,70631,85,0,51,39,12,70631,Волинська область
1798,70632,263,3,179,120,59,70632,Волинська область
1799,70633,123,1,103,84,19,70633,Волинська область
1800,70634,110,0,73,43,30,70634,Волинська область
1801,70635,380,6,222,166,56,70635,Волинська область
1802,70636,462,11,296,203,93,70636,Волинська область
1803,70637,124,4,94,70,24,70637,Волинська область
1804,70638,201,1,148,96,52,70638,Волинська область
1805,70639,728,9,388,271,117,70639,Волинська область
1806,70640,505,4,291,223,68,70640,Волинська область
1807,70641,645,1,390,330,60,70641,Волинська область
1808,70642,169,0,122,94,28,70642,Волинська область
1809,70643,178,0,135,105,30,70643,Волинська область
1810,70644,440,4,318,278,40,70644,Волинська область
1811,70645,132,0,110,80,30,70645,Волинська область
1812,70646,127,1,100,67,33,70646,Волинська область
1813,70647,119,1,83,53,30,70647,Волинська область
1814,70648,368,14,236,181,55,70648,Волинська область
1815,70649,298,4,190,139,51,70649,Волинська область
1816,70650,438,3,279,172,107,70650,Волинська область
1817,70651,203,5,160,125,35,70651,Волинська область
1818,70652,131,0,92,56,36,70652,Волинська область
1819,70653,74,0,58,38,20,70653,Волинська область
1820,70971,1289,27,830,639,191,70971,Волинська область
1821,70972,1586,38,970,714,256,70972,Волинська область
1822,70973,1413,26,804,562,242,70973,Волинська область
1823,70974,1637,26,1035,774,261,70974,Волинська область
1824,70975,1833,23,1163,868,295,70975,Волинська область
1825,70976,1945,36,1121,810,311,70976,Волинська область
1826,70977,1762,32,1120,819,301,70977,Волинська область
1827,70978,1643,23,1072,776,296,70978,Волинська область
1828,70979,1439,37,917,692,225,70979,Волинська область
1829,70980,1541,22,975,712,263,70980,Волинська область
1830,70981,1250,27,753,573,180,70981,Волинська область
1831,70982,1328,26,792,610,182,70982,Волинська область
1832,70983,1350,30,835,593,242,70983,Волинська область
1833,70984,1478,26,868,626,242,70984,Волинська область
1834,70985,1365,26,887,637,250,70985,Волинська область
1835,70986,1182,28,748,535,213,70986,Волинська область
1836,70987,1324,28,776,557,219,70987,Волинська область
1837,70988,1482,24,885,642,243,70988,Волинська область
1838,70989,63,3,46,27,19,70989,Волинська область
1839,71105,2010,38,1128,762,366,71105,Волинська область
1840,71106,1931,32,1095,755,340,71106,Волинська область
1841,71107,1670,27,940,651,289,71107,Волинська область
1842,71108,2007,41,1168,840,328,71108,Волинська область
1843,71109,2108,50,1209,858,351,71109,Волинська область
1844,71110,2013,37,1168,801,367,71110,Волинська область
1845,71112,2055,34,1162,771,391,71112,Волинська область
1846,71113,2214,61,1263,900,363,71113,Волинська область
1847,71114,1909,38,1049,770,279,71114,Волинська область
1848,71115,2035,41,1190,858,332,71115,Волинська область
1849,71116,1956,27,1105,761,344,71116,Волинська область
1850,71117,2065,52,1203,866,337,71117,Волинська область
1851,71118,1977,39,1042,728,314,71118,Волинська область
1852,71119,1809,38,976,664,312,71119,Волинська область
1853,71120,1588,46,934,686,248,71120,Волинська область
1854,71121,1996,39,1170,802,368,71121,Волинська область
1855,71122,1920,31,1179,822,357,71122,Волинська область
1856,71123,1662,27,965,715,250,71123,Волинська область
1857,71124,1663,26,944,685,259,71124,Волинська область
1858,71125,157,4,143,105,38,71125,Волинська область
1859,1,45,0,45,12,33,1,Волинська область
1860,70068,1928,36,1104,711,393,70068,Волинська область
1861,70069,1256,20,683,422,261,70069,Волинська область
1862,70070,1140,14,637,405,232,70070,Волинська область
1863,70071,1231,24,693,385,308,70071,Волинська область
1864,70072,1103,14,658,384,274,70072,Волинська область
1865,70073,1084,15,634,335,299,70073,Волинська область
1866,70074,2004,25,1122,714,408,70074,Волинська область
1867,70075,874,17,543,324,219,70075,Волинська область
1868,70076,372,4,234,145,89,70076,Волинська область
1869,70077,487,7,299,176,123,70077,Волинська область
1870,70078,342,8,252,151,101,70078,Волинська область
1871,70079,402,3,286,166,120,70079,Волинська область
1872,70080,712,6,496,190,306,70080,Волинська область
1873,70081,384,5,273,161,112,70081,Волинська область
1874,70082,209,7,134,73,61,70082,Волинська область
1875,70083,100,3,67,24,43,70083,Волинська область
1876,70084,552,11,390,172,218,70084,Волинська область
1877,70085,307,4,183,87,96,70085,Волинська область
1878,70086,505,1,356,198,158,70086,Волинська область
1879,70087,67,0,50,38,12,70087,Волинська область
1880,70088,157,1,105,72,33,70088,Волинська область
1881,70089,184,6,119,77,42,70089,Волинська область
1882,70090,270,2,198,140,58,70090,Волинська область
1883,70091,309,0,213,103,110,70091,Волинська область
1884,70092,341,2,223,122,101,70092,Волинська область
1885,70093,79,0,68,47,21,70093,Волинська область
1886,70094,307,3,207,115,92,70094,Волинська область
1887,70095,599,6,428,229,199,70095,Волинська область
1888,70096,191,1,168,86,82,70096,Волинська область
1889,70097,756,13,564,339,225,70097,Волинська область
1890,70098,196,3,159,70,89,70098,Волинська область
1891,70099,339,2,226,130,96,70099,Волинська область
1892,70100,382,3,219,127,92,70100,Волинська область
1893,70101,402,6,238,123,115,70101,Волинська область
1894,70102,117,2,74,35,39,70102,Волинська область
1895,70103,343,8,252,175,77,70103,Волинська область
1896,70104,153,4,100,46,54,70104,Волинська область
1897,70105,560,3,371,197,174,70105,Волинська область
1898,70106,222,1,175,89,86,70106,Волинська область
1899,70107,162,2,106,69,37,70107,Волинська область
1900,70108,372,3,273,125,148,70108,Волинська область
1901,70109,240,5,177,65,112,70109,Волинська область
1902,70110,190,2,122,59,63,70110,Волинська область
1903,70111,398,8,248,143,105,70111,Волинська область
1904,70112,465,7,331,196,135,70112,Волинська область
1905,70113,906,13,579,271,308,70113,Волинська область
1906,70114,320,1,184,119,65,70114,Волинська область
1907,70116,387,5,267,160,107,70116,Волинська область
1908,70117,232,3,136,88,48,70117,Волинська область
1909,70118,709,5,518,313,205,70118,Волинська область
1910,70119,86,2,70,53,17,70119,Волинська область
1911,70120,210,3,155,103,52,70120,Волинська область
1912,70121,202,1,137,99,38,70121,Волинська область
1913,70122,411,11,282,141,141,70122,Волинська область
1914,70123,662,2,436,258,178,70123,Волинська область
1915,70124,239,5,153,68,85,70124,Волинська область
1916,70125,108,2,74,42,32,70125,Волинська область
1917,70126,674,18,401,253,148,70126,Волинська область
1918,70127,473,11,320,223,97,70127,Волинська область
1919,70128,521,9,316,195,121,70128,Волинська область
1920,70129,110,0,64,36,28,70129,Волинська область
1921,70130,154,4,72,42,30,70130,Волинська область
1922,70131,404,3,230,117,113,70131,Волинська область
1923,70132,192,2,141,51,90,70132,Волинська область
1924,70133,251,9,158,80,78,70133,Волинська область
1925,70134,399,4,269,127,142,70134,Волинська область
1926,70135,380,5,256,137,119,70135,Волинська область
1927,70136,1153,13,726,453,273,70136,Волинська область
1928,70137,189,2,112,58,54,70137,Волинська область
1929,70138,231,2,160,98,62,70138,Волинська область
1930,70139,216,2,142,71,71,70139,Волинська область
1931,70140,171,1,102,61,41,70140,Волинська область
1932,70141,461,3,259,109,150,70141,Волинська область
1933,70142,329,4,256,126,130,70142,Волинська область
1934,70143,348,3,258,167,91,70143,Волинська область
1935,70144,331,6,254,150,104,70144,Волинська область
1936,70145,539,14,365,253,112,70145,Волинська область
1937,70146,99,0,80,51,29,70146,Волинська область
1938,70147,747,12,499,358,141,70147,Волинська область
1939,70148,718,8,419,299,120,70148,Волинська область
1940,70149,944,16,594,374,220,70149,Волинська область
1941,70150,519,3,356,196,160,70150,Волинська область
1942,70151,305,3,222,129,93,70151,Волинська область
1943,70152,658,7,429,241,188,70152,Волинська область
1944,70153,89,0,66,40,26,70153,Волинська область
1945,70154,35,0,29,21,8,70154,Волинська область
1946,70155,38,0,38,8,30,70155,Волинська область
1947,70436,937,19,514,335,179,70436,Волинська область
1948,70437,787,14,506,342,164,70437,Волинська область
1949,70438,917,10,555,353,202,70438,Волинська область
1950,70439,247,1,156,111,45,70439,Волинська область
1951,70440,48,1,34,27,7,70440,Волинська область
1952,70441,342,5,224,109,115,70441,Волинська область
1953,70442,249,3,154,78,76,70442,Волинська область
1954,70443,217,4,158,89,69,70443,Волинська область
1955,70444,475,2,315,262,53,70444,Волинська область
1956,70445,167,1,135,82,53,70445,Волинська область
1957,70446,444,3,297,195,102,70446,Волинська область
1958,70447,242,1,148,59,89,70447,Волинська область
1959,70448,410,5,312,188,124,70448,Волинська область
1960,70449,102,0,72,41,31,70449,Волинська область
1961,70450,291,6,215,141,74,70450,Волинська область
1962,70451,224,1,127,82,45,70451,Волинська область
1963,70452,124,0,89,55,34,70452,Волинська область
1964,70453,177,2,111,60,51,70453,Волинська область
1965,70454,1327,16,839,545,294,70454,Волинська область
1966,70455,334,5,190,121,69,70455,Волинська область
1967,70456,60,0,48,26,22,70456,Волинська область
1968,70457,144,0,100,59,41,70457,Волинська область
1969,70458,342,4,258,180,78,70458,Волинська область
1970,70459,233,1,190,98,92,70459,Волинська область
1971,70460,432,4,324,148,176,70460,Волинська область
1972,70461,53,1,41,16,25,70461,Волинська область
1973,70462,228,3,129,82,47,70462,Волинська область
1974,70463,96,1,73,45,28,70463,Волинська область
1975,70464,323,3,204,141,63,70464,Волинська область
1976,70465,173,5,100,59,41,70465,Волинська область
1977,70466,149,0,84,51,33,70466,Волинська область
1978,70467,401,5,261,178,83,70467,Волинська область
1979,70468,558,12,460,288,172,70468,Волинська область
1980,70469,475,3,342,211,131,70469,Волинська область
1981,70470,240,5,169,104,65,70470,Волинська область
1982,70471,53,1,42,19,23,70471,Волинська область
1983,70472,259,0,156,70,86,70472,Волинська область
1984,70473,76,0,43,25,18,70473,Волинська область
1985,70474,904,20,572,340,232,70474,Волинська область
1986,70475,423,0,265,150,115,70475,Волинська область
1987,70476,484,5,324,178,146,70476,Волинська область
1988,70477,368,6,259,128,131,70477,Волинська область
1989,70478,247,5,153,103,50,70478,Волинська область
1990,70479,479,5,258,167,91,70479,Волинська область
1991,70480,54,1,35,14,21,70480,Волинська область
1992,70481,625,0,346,211,135,70481,Волинська область
1993,70482,124,0,91,47,44,70482,Волинська область
1994,70483,395,2,254,120,134,70483,Волинська область
1995,70484,259,0,169,87,82,70484,Волинська область
1996,70485,131,0,88,52,36,70485,Волинська область
1997,70486,28,0,23,10,13,70486,Волинська область
1998,70487,1159,24,741,534,207,70487,Волинська область
1999,70488,275,2,192,146,46,70488,Волинська область
2000,70489,1693,16,1000,613,387,70489,Волинська область
2001,70490,1547,23,866,545,321,70490,Волинська область
2002,70491,690,8,477,302,175,70491,Волинська область
2003,70492,747,10,543,348,195,70492,Волинська область
2004,70493,296,4,199,132,67,70493,Волинська область
2005,70494,204,5,144,90,54,70494,Волинська область
2006,70495,462,4,288,196,92,70495,Волинська область
2007,70496,823,18,560,359,201,70496,Волинська область
2008,70497,185,3,142,107,35,70497,Волинська область
2009,70498,962,21,654,357,297,70498,Волинська область
2010,70499,1161,27,742,438,304,70499,Волинська область
2011,70500,850,11,515,293,222,70500,Волинська область
2012,70501,1565,27,909,485,424,70501,Волинська область
2013,70502,716,8,474,298,176,70502,Волинська область
2014,70503,401,5,266,169,97,70503,Волинська область
2015,70504,591,11,349,236,113,70504,Волинська область
2016,70505,803,10,498,305,193,70505,Волинська область
2017,70506,833,9,560,332,228,70506,Волинська область
2018,70507,1434,24,962,584,378,70507,Волинська область
2019,70508,973,11,679,377,302,70508,Волинська область
2020,70509,439,8,278,159,119,70509,Волинська область
2021,70510,652,13,434,260,174,70510,Волинська область
2022,70511,1282,21,824,512,312,70511,Волинська область
2023,70512,1259,23,848,529,319,70512,Волинська область
2024,70513,323,7,199,122,77,70513,Волинська область
2025,70514,508,5,338,230,108,70514,Волинська область
2026,70515,878,8,483,288,195,70515,Волинська область
2027,70516,1649,24,1126,673,453,70516,Волинська область
2028,70517,1971,31,1355,797,558,70517,Волинська область
2029,70518,1727,25,1047,637,410,70518,Волинська область
2030,70519,656,7,418,257,161,70519,Волинська область
2031,70520,1781,44,1061,605,456,70520,Волинська область
2032,70521,2106,42,1411,856,555,70521,Волинська область
2033,70522,865,18,546,341,205,70522,Волинська область
2034,70523,528,11,333,220,113,70523,Волинська область
2035,70524,617,13,381,234,147,70524,Волинська область
2036,70525,444,7,294,189,105,70525,Волинська область
2037,70526,311,3,204,124,80,70526,Волинська область
2038,70527,1838,31,1183,706,477,70527,Волинська область
2039,70528,1401,25,934,578,356,70528,Волинська область
2040,70529,662,11,434,264,170,70529,Волинська область
2041,70530,1485,28,933,572,361,70530,Волинська область
2042,70531,916,15,612,415,197,70531,Волинська область
2043,70532,865,16,589,389,200,70532,Волинська область
2044,70533,771,9,456,276,180,70533,Волинська область
2045,70534,478,5,286,150,136,70534,Волинська область
2046,70535,725,16,526,276,250,70535,Волинська область
2047,70536,748,7,497,287,210,70536,Волинська область
2048,70537,1058,18,653,452,201,70537,Волинська область
2049,70538,667,4,426,206,220,70538,Волинська область
2050,70539,721,11,429,324,105,70539,Волинська область
2051,70540,508,2,332,260,72,70540,Волинська область
2052,70541,1089,15,654,381,273,70541,Волинська область
2053,70542,630,14,373,228,145,70542,Волинська область
2054,70543,28,0,24,12,12,70543,Волинська область
2055,70544,22,0,20,7,13,70544,Волинська область
2056,70781,2061,30,1170,832,338,70781,Волинська область
2057,70782,2205,47,1298,928,370,70782,Волинська область
2058,70783,1682,33,980,697,283,70783,Волинська область
2059,70784,2033,27,1191,823,368,70784,Волинська область
2060,70785,1932,27,1169,863,306,70785,Волинська область
2061,70786,1423,26,859,646,213,70786,Волинська область
2062,70787,278,2,184,118,66,70787,Волинська область
2063,70788,190,1,128,67,61,70788,Волинська область
2064,70789,189,1,125,83,42,70789,Волинська область
2065,70790,77,1,54,43,11,70790,Волинська область
2066,70791,426,6,234,155,79,70791,Волинська область
2067,70792,284,7,163,90,73,70792,Волинська область
2068,70793,344,2,229,134,95,70793,Волинська область
2069,70794,166,3,105,60,45,70794,Волинська область
2070,70795,252,2,152,109,43,70795,Волинська область
2071,70796,664,12,391,241,150,70796,Волинська область
2072,70797,227,3,160,93,67,70797,Волинська область
2073,70798,448,8,300,188,112,70798,Волинська область
2074,70799,198,1,154,116,38,70799,Волинська область
2075,70800,136,0,85,60,25,70800,Волинська область
2076,70801,1263,22,782,581,201,70801,Волинська область
2077,70802,197,3,132,99,33,70802,Волинська область
2078,70803,171,4,118,75,43,70803,Волинська область
2079,70804,193,0,143,111,32,70804,Волинська область
2080,70805,732,13,457,332,125,70805,Волинська область
2081,70806,307,8,197,135,62,70806,Волинська область
2082,70807,183,4,119,88,31,70807,Волинська область
2083,70808,486,4,282,215,67,70808,Волинська область
2084,70809,402,2,265,161,104,70809,Волинська область
2085,70810,337,3,197,121,76,70810,Волинська область
2086,70811,305,2,226,150,76,70811,Волинська область
2087,70812,175,2,125,67,58,70812,Волинська область
2088,70813,679,11,419,213,206,70813,Волинська область
2089,70814,300,9,179,143,36,70814,Волинська область
2090,70815,136,1,90,51,39,70815,Волинська область
2091,70816,267,0,171,128,43,70816,Волинська область
2092,70817,239,6,157,121,36,70817,Волинська область
2093,70818,283,1,198,155,43,70818,Волинська область
2094,70819,896,8,518,341,177,70819,Волинська область
2095,70820,195,2,110,74,36,70820,Волинська область
2096,70821,162,7,96,62,34,70821,Волинська область
2097,70822,474,4,287,194,93,70822,Волинська область
2098,70823,239,1,138,107,31,70823,Волинська область
2099,70824,561,8,399,267,132,70824,Волинська область
2100,70825,274,2,176,104,72,70825,Волинська область
2101,70826,787,11,472,347,125,70826,Волинська область
2102,70827,445,5,311,228,83,70827,Волинська область
2103,70828,397,1,251,150,101,70828,Волинська область
2104,70829,170,3,88,64,24,70829,Волинська область
2105,70830,215,3,138,103,35,70830,Волинська область
2106,70831,1042,18,649,514,135,70831,Волинська область
2107,70832,223,3,110,90,20,70832,Волинська область
2108,70833,374,3,251,151,100,70833,Волинська область
2109,70834,457,4,290,187,103,70834,Волинська область
2110,70835,364,4,213,115,98,70835,Волинська область
2111,70836,287,4,193,91,102,70836,Волинська область
2112,70837,310,6,177,96,81,70837,Волинська область
2113,70838,207,1,111,65,46,70838,Волинська область
2114,70839,37,2,29,19,10,70839,Волинська область
2115,70885,2022,47,1303,914,389,70885,Волинська область
2116,70886,1603,20,1071,744,327,70886,Волинська область
2117,70887,777,15,533,434,99,70887,Волинська область
2118,70888,2170,23,1286,833,453,70888,Волинська область
2119,70889,727,21,427,322,105,70889,Волинська область
2120,70890,164,3,105,69,36,70890,Волинська область
2121,70891,117,1,71,47,24,70891,Волинська область
2122,70892,212,1,125,78,47,70892,Волинська область
2123,70893,159,4,109,68,41,70893,Волинська область
2124,70894,351,3,240,120,120,70894,Волинська область
2125,70895,167,5,126,78,48,70895,Волинська область
2126,70896,348,6,262,171,91,70896,Волинська область
2127,70897,151,4,91,50,41,70897,Волинська область
2128,70898,212,3,144,96,48,70898,Волинська область
2129,70899,191,8,124,86,38,70899,Волинська область
2130,70900,201,5,154,90,64,70900,Волинська область
2131,70901,541,8,357,262,95,70901,Волинська область
2132,70902,645,9,412,268,144,70902,Волинська область
2133,70903,247,7,182,86,96,70903,Волинська область
2134,70904,174,5,107,64,43,70904,Волинська область
2135,70905,468,5,304,178,126,70905,Волинська область
2136,70906,132,4,100,46,54,70906,Волинська область
2137,70907,222,5,126,81,45,70907,Волинська область
2138,70908,152,3,98,67,31,70908,Волинська область
2139,70909,230,4,118,75,43,70909,Волинська область
2140,70910,139,0,81,42,39,70910,Волинська область
2141,70911,557,4,348,253,95,70911,Волинська область
2142,70912,112,2,69,47,22,70912,Волинська область
2143,70913,86,1,56,42,14,70913,Волинська область
2144,70914,356,2,259,210,49,70914,Волинська область
2145,70915,366,3,217,117,100,70915,Волинська область
2146,70916,78,2,47,24,23,70916,Волинська область
2147,70917,117,4,74,38,36,70917,Волинська область
2148,70918,411,2,271,163,108,70918,Волинська область
2149,70919,234,5,164,106,58,70919,Волинська область
2150,70920,213,2,157,106,51,70920,Волинська область
2151,70921,101,0,70,47,23,70921,Волинська область
2152,70922,331,3,214,156,58,70922,Волинська область
2153,70923,163,0,96,69,27,70923,Волинська область
2154,70924,260,2,168,137,31,70924,Волинська область
2155,70925,405,12,249,133,116,70925,Волинська область
2156,70926,262,5,162,116,46,70926,Волинська область
2157,70927,154,5,86,47,39,70927,Волинська область
2158,70928,107,2,70,23,47,70928,Волинська область
2159,70929,300,5,211,117,94,70929,Волинська область
2160,70930,315,7,188,127,61,70930,Волинська область
2161,70931,363,2,252,187,65,70931,Волинська область
2162,70932,165,1,100,74,26,70932,Волинська область
2163,70933,453,11,304,191,113,70933,Волинська область
2164,70934,202,3,143,108,35,70934,Волинська область
2165,70935,460,9,271,182,89,70935,Волинська область
2166,70936,196,1,145,83,62,70936,Волинська область
2167,70937,96,2,68,36,32,70937,Волинська область
2168,70938,256,2,161,79,82,70938,Волинська область
2169,70939,134,2,90,45,45,70939,Волинська область
2170,70940,141,1,95,57,38,70940,Волинська область
2171,70941,250,5,186,94,92,70941,Волинська область
2172,71130,112,8,101,52,49,71130,Волинська область
2173,70343,724,6,445,299,146,70343,Волинська область
2174,70344,744,4,491,362,129,70344,Волинська область
2175,70345,884,17,518,372,146,70345,Волинська область
2176,70346,686,6,434,337,97,70346,Волинська область
2177,70347,265,6,245,137,108,70347,Волинська область
2178,70348,197,2,160,123,37,70348,Волинська область
2179,70349,46,0,26,19,7,70349,Волинська область
2180,70350,100,0,61,42,19,70350,Волинська область
2181,70351,158,0,112,88,24,70351,Волинська область
2182,70352,1123,14,714,527,187,70352,Волинська область
2183,70353,1073,12,683,499,184,70353,Волинська область
2184,70354,953,9,558,415,143,70354,Волинська область
2185,70355,228,7,150,113,37,70355,Волинська область
2186,70356,306,4,208,121,87,70356,Волинська область
2187,70357,135,0,94,68,26,70357,Волинська область
2188,70358,80,0,57,38,19,70358,Волинська область
2189,70359,985,15,637,389,248,70359,Волинська область
2190,70360,219,4,125,79,46,70360,Волинська область
2191,70361,424,6,331,215,116,70361,Волинська область
2192,70362,240,6,153,83,70,70362,Волинська область
2193,70363,172,0,118,64,54,70363,Волинська область
2194,70364,95,3,73,29,44,70364,Волинська область
2195,70365,67,0,46,27,19,70365,Волинська область
2196,70366,379,6,264,169,95,70366,Волинська область
2197,70367,303,2,198,140,58,70367,Волинська область
2198,70368,492,14,314,212,102,70368,Волинська область
2199,70369,74,0,54,25,29,70369,Волинська область
2200,70370,1312,25,859,588,271,70370,Волинська область
2201,70371,447,5,309,228,81,70371,Волинська область
2202,70372,934,14,608,416,192,70372,Волинська область
2203,70373,780,13,470,327,143,70373,Волинська область
2204,70374,760,16,528,324,204,70374,Волинська область
2205,70375,568,12,391,280,111,70375,Волинська область
2206,70376,420,4,267,173,94,70376,Волинська область
2207,70377,85,2,41,25,16,70377,Волинська область
2208,70378,362,1,238,158,80,70378,Волинська область
2209,70379,169,0,102,54,48,70379,Волинська область
2210,70380,170,1,95,57,38,70380,Волинська область
2211,70381,37,0,29,15,14,70381,Волинська область
2212,70382,512,7,342,201,141,70382,Волинська область
2213,70383,151,1,100,64,36,70383,Волинська область
2214,70384,344,2,221,139,82,70384,Волинська область
2215,70385,498,4,302,203,99,70385,Волинська область
2216,70386,530,8,342,216,126,70386,Волинська область
2217,70387,282,0,186,135,51,70387,Волинська область
2218,70388,153,2,113,66,47,70388,Волинська область
2219,70389,251,3,150,115,35,70389,Волинська область
2220,70390,137,0,110,68,42,70390,Волинська область
2221,70391,114,5,60,29,31,70391,Волинська область
2222,70392,20,1,13,8,5,70392,Волинська область
2223,70393,333,4,203,132,71,70393,Волинська область
2224,70394,98,1,72,39,33,70394,Волинська область
2225,70395,66,2,48,22,26,70395,Волинська область
2226,70396,72,1,49,15,34,70396,Волинська область
2227,70397,439,3,308,192,116,70397,Волинська область
2228,70398,199,2,113,85,28,70398,Волинська область
2229,70399,143,0,112,61,51,70399,Волинська область
2230,70400,80,1,52,35,17,70400,Волинська область
2231,70401,335,1,239,190,49,70401,Волинська область
2232,70402,42,1,32,22,10,70402,Волинська область
2233,70403,715,9,484,275,209,70403,Волинська область
2234,70404,459,6,291,179,112,70404,Волинська область
2235,70405,257,1,158,87,71,70405,Волинська область
2236,70406,493,8,368,249,119,70406,Волинська область
2237,70407,1276,16,886,583,303,70407,Волинська область
2238,70408,153,7,104,70,34,70408,Волинська область
2239,70409,79,1,56,35,21,70409,Волинська область
2240,70410,204,3,155,111,44,70410,Волинська область
2241,70411,238,3,167,108,59,70411,Волинська область
2242,70412,96,3,74,52,22,70412,Волинська область
2243,70413,158,3,97,68,29,70413,Волинська область
2244,70414,190,1,140,84,56,70414,Волинська область
2245,70415,161,3,116,73,43,70415,Волинська область
2246,70416,112,0,80,55,25,70416,Волинська область
2247,70417,324,4,215,134,81,70417,Волинська область
2248,70418,188,1,137,66,71,70418,Волинська область
2249,70419,158,3,97,65,32,70419,Волинська область
2250,70420,34,1,26,17,9,70420,Волинська область
2251,70421,190,4,141,81,60,70421,Волинська область
2252,70422,36,0,33,13,20,70422,Волинська область
2253,70423,703,15,451,310,141,70423,Волинська область
2254,70424,191,4,128,93,35,70424,Волинська область
2255,70425,297,6,185,106,79,70425,Волинська область
2256,70426,181,4,161,67,94,70426,Волинська область
2257,70427,163,2,101,40,61,70427,Волинська область
2258,70428,151,0,114,62,52,70428,Волинська область
2259,70429,353,9,215,138,77,70429,Волинська область
2260,70430,158,1,104,77,27,70430,Волинська область
2261,70431,87,1,66,43,23,70431,Волинська область
2262,70432,563,21,377,225,152,70432,Волинська область
2263,70433,421,9,261,151,110,70433,Волинська область
2264,70434,583,12,382,268,114,70434,Волинська область
2265,70435,14,0,13,11,2,70435,Волинська область
2266,70732,2045,27,1243,940,303,70732,Волинська область
2267,70733,2353,44,1481,1049,432,70733,Волинська область
2268,70734,2388,50,1457,1100,357,70734,Волинська область
2269,70735,953,9,650,443,207,70735,Волинська область
2270,70736,979,19,667,451,216,70736,Волинська область
2271,70737,1229,17,810,559,251,70737,Волинська область
2272,70738,1614,31,889,733,156,70738,Волинська область
2273,70739,924,16,516,387,129,70739,Волинська область
2274,70740,377,7,225,165,60,70740,Волинська область
2275,70741,1161,17,758,559,199,70741,Волинська область
2276,70742,545,14,349,223,126,70742,Волинська область
2277,70743,107,2,73,49,24,70743,Волинська область
2278,70744,625,9,428,334,94,70744,Волинська область
2279,70745,481,7,278,174,104,70745,Волинська область
2280,70746,370,1,266,169,97,70746,Волинська область
2281,70747,859,18,526,376,150,70747,Волинська область
2282,70748,288,1,189,86,103,70748,Волинська область
2283,70749,179,2,116,68,48,70749,Волинська область
2284,70750,110,0,76,33,43,70750,Волинська область
2285,70751,51,0,41,25,16,70751,Волинська область
2286,70752,45,0,33,15,18,70752,Волинська область
2287,70753,1160,12,751,468,283,70753,Волинська область
2288,70754,186,2,128,94,34,70754,Волинська область
2289,70755,679,16,425,311,114,70755,Волинська область
2290,70756,240,3,146,111,35,70756,Волинська область
2291,70757,423,9,315,245,70,70757,Волинська область
2292,70758,426,2,248,186,62,70758,Волинська область
2293,70759,1621,33,969,786,183,70759,Волинська область
2294,70760,963,6,543,435,108,70760,Волинська область
2295,70761,560,4,358,217,141,70761,Волинська область
2296,70762,483,4,262,215,47,70762,Волинська область
2297,70763,226,1,120,83,37,70763,Волинська область
2298,70764,460,2,321,226,95,70764,Волинська область
2299,70765,146,1,101,60,41,70765,Волинська область
2300,70766,147,3,110,72,38,70766,Волинська область
2301,70767,1342,10,647,472,175,70767,Волинська область
2302,70768,1623,30,854,670,184,70768,Волинська область
2303,70769,647,9,370,271,99,70769,Волинська область
2304,70770,336,4,223,161,62,70770,Волинська область
2305,70771,417,5,244,199,45,70771,Волинська область
2306,70772,843,9,522,317,205,70772,Волинська область
2307,70773,547,5,369,186,183,70773,Волинська область
2308,70774,365,8,249,186,63,70774,Волинська область
2309,70775,1230,18,761,493,268,70775,Волинська область
2310,70776,554,5,323,239,84,70776,Волинська область
2311,70777,766,15,512,358,154,70777,Волинська область
2312,70778,1373,10,662,478,184,70778,Волинська область
2313,70779,651,22,497,360,137,70779,Волинська область
2314,70780,314,0,238,132,106,70780,Волинська область
2315,70840,2110,42,1253,912,341,70840,Волинська область
2316,70841,1977,47,1191,880,311,70841,Волинська область
2317,70842,314,4,201,149,52,70842,Волинська область
2318,70843,837,11,489,367,122,70843,Волинська область
2319,70844,505,12,327,237,90,70844,Волинська область
2320,70845,690,19,356,252,104,70845,Волинська область
2321,70846,636,4,367,253,114,70846,Волинська область
2322,70847,446,3,269,174,95,70847,Волинська область
2323,70848,1716,34,942,621,321,70848,Волинська область
2324,70849,287,14,188,149,39,70849,Волинська область
2325,70850,114,1,75,64,11,70850,Волинська область
2326,70851,519,4,304,222,82,70851,Волинська область
2327,70852,475,4,250,176,74,70852,Волинська область
2328,70853,335,6,197,84,113,70853,Волинська область
2329,70854,1346,21,849,620,229,70854,Волинська область
2330,70855,362,9,269,180,89,70855,Волинська область
2331,70856,1280,19,666,481,185,70856,Волинська область
2332,70857,684,22,402,287,115,70857,Волинська область
2333,70858,405,7,256,190,66,70858,Волинська область
2334,70859,164,4,113,56,57,70859,Волинська область
2335,70860,290,1,200,128,72,70860,Волинська область
2336,70861,201,6,127,86,41,70861,Волинська область
2337,70862,416,11,271,186,85,70862,Волинська область
2338,70863,170,1,119,88,31,70863,Волинська область
2339,70864,173,5,124,87,37,70864,Волинська область
2340,70865,87,1,53,32,21,70865,Волинська область
2341,70866,483,9,310,189,121,70866,Волинська область
2342,70867,106,1,60,48,12,70867,Волинська область
2343,70868,51,0,39,25,14,70868,Волинська область
2344,70869,397,12,258,179,79,70869,Волинська область
2345,70870,565,16,382,256,126,70870,Волинська область
2346,70871,179,5,149,84,65,70871,Волинська область
2347,70872,375,6,229,149,80,70872,Волинська область
2348,70873,1386,24,767,565,202,70873,Волинська область
2349,70874,164,4,112,71,41,70874,Волинська область
2350,70875,234,1,153,117,36,70875,Волинська область
2351,70876,153,0,89,64,25,70876,Волинська область
2352,70877,91,1,62,41,21,70877,Волинська область
2353,70878,99,0,64,35,29,70878,Волинська область
2354,70879,146,0,91,52,39,70879,Волинська область
2355,70880,252,16,148,111,37,70880,Волинська область
2356,70881,155,4,122,60,62,70881,Волинська область
2357,70882,214,1,134,102,32,70882,Волинська область
2358,70883,765,21,439,341,98,70883,Волинська область
2359,70884,224,2,136,110,26,70884,Волинська область
2360,70942,1381,23,895,599,296,70942,Волинська область
2361,70943,1566,23,981,707,274,70943,Волинська область
2362,70944,981,21,613,476,137,70944,Волинська область
2363,70945,162,4,123,84,39,70945,Волинська область
2364,70946,889,13,633,500,133,70946,Волинська область
2365,70947,304,2,207,167,40,70947,Волинська область
2366,70948,168,0,121,73,48,70948,Волинська область
2367,70949,231,0,172,115,57,70949,Волинська область
2368,70950,776,8,449,275,174,70950,Волинська область
2369,70951,157,4,101,74,27,70951,Волинська область
2370,70952,58,0,41,20,21,70952,Волинська область
2371,70953,295,3,197,126,71,70953,Волинська область
2372,70954,413,4,221,168,53,70954,Волинська область
2373,70955,105,2,70,56,14,70955,Волинська область
2374,70956,155,4,102,77,25,70956,Волинська область
2375,70957,75,2,48,35,13,70957,Волинська область
2376,70958,380,8,248,154,94,70958,Волинська область
2377,70959,968,21,626,419,207,70959,Волинська область
2378,70960,128,1,103,66,37,70960,Волинська область
2379,70961,83,2,54,53,1,70961,Волинська область
2380,70962,253,6,183,100,83,70962,Волинська область
2381,70963,39,1,27,9,18,70963,Волинська область
2382,70964,117,0,71,46,25,70964,Волинська область
2383,70965,313,7,194,126,68,70965,Волинська область
2384,70966,187,6,123,86,37,70966,Волинська область
2385,70967,199,4,133,74,59,70967,Волинська область
2386,70968,1438,20,853,695,158,70968,Волинська область
2387,70969,165,5,125,77,48,70969,Волинська область
2388,70970,370,4,219,177,42,70970,Волинська область
2389,70990,1284,24,753,509,244,70990,Волинська область
2390,70991,1886,47,1186,841,345,70991,Волинська область
2391,70992,1917,33,1071,702,369,70992,Волинська область
2392,70993,1250,30,771,541,230,70993,Волинська область
2393,70994,1739,33,1038,705,333,70994,Волинська область
2394,70995,925,24,521,335,186,70995,Волинська область
2395,70996,1029,27,596,425,171,70996,Волинська область
2396,70997,1188,25,763,527,236,70997,Волинська область
2397,70998,2139,52,1272,867,405,70998,Волинська область
2398,70999,2177,38,1396,998,398,70999,Волинська область
2399,71000,1029,13,594,399,195,71000,Волинська область
2400,71001,853,24,545,350,195,71001,Волинська область
2401,71002,1042,27,592,404,188,71002,Волинська область
2402,71003,1194,9,747,512,235,71003,Волинська область
2403,71004,2222,45,1360,917,443,71004,Волинська область
2404,71005,1886,25,1172,792,380,71005,Волинська область
2405,71006,1499,22,885,574,311,71006,Волинська область
2406,71007,1867,34,1216,854,362,71007,Волинська область
2407,71008,1553,32,957,699,258,71008,Волинська область
2408,71009,1569,28,999,669,330,71009,Волинська область
2409,71010,1924,38,1130,795,335,71010,Волинська область
2410,71011,1783,32,1067,723,344,71011,Волинська область
2411,71012,2398,49,1449,990,459,71012,Волинська область
2412,71013,1992,32,1090,764,326,71013,Волинська область
2413,71014,1286,16,770,517,253,71014,Волинська область
2414,71015,1950,43,1164,830,334,71015,Волинська область
2415,71016,1962,29,1117,811,306,71016,Волинська область
2416,71017,2360,50,1378,963,415,71017,Волинська область
2417,71018,1765,30,1019,695,324,71018,Волинська область
2418,71019,1427,29,901,641,260,71019,Волинська область
2419,71020,40,0,33,19,14,71020,Волинська область
2420,71021,159,5,137,101,36,71021,Волинська область
2421,71022,18,0,18,17,1,71022,Волинська область
2422,1,276,23,247,216,31,1,Волинська область
2423,71023,1341,17,917,558,359,71023,Волинська область
2424,71024,1497,21,925,590,335,71024,Волинська область
2425,71025,2315,36,1584,971,613,71025,Волинська область
2426,71026,2253,55,1467,884,583,71026,Волинська область
2427,71027,2214,55,1381,866,515,71027,Волинська область
2428,71028,1778,34,1164,675,489,71028,Волинська область
2429,71029,2049,44,1300,810,490,71029,Волинська область
2430,71030,2281,35,1465,866,599,71030,Волинська область
2431,71031,2168,46,1314,781,533,71031,Волинська область
2432,71032,1976,33,1211,745,466,71032,Волинська область
2433,71033,2308,55,1543,897,646,71033,Волинська область
2434,71034,2397,45,1587,920,667,71034,Волинська область
2435,71035,2299,53,1454,877,577,71035,Волинська область
2436,71036,1581,28,1036,629,407,71036,Волинська область
2437,71037,2313,57,1500,890,610,71037,Волинська область
2438,71038,2378,53,1445,846,599,71038,Волинська область
2439,71039,2236,39,1364,858,506,71039,Волинська область
2440,71040,1682,35,1008,603,405,71040,Волинська область
2441,71041,2185,36,1313,813,500,71041,Волинська область
2442,71042,2093,44,1387,764,623,71042,Волинська область
2443,71043,1199,34,755,439,316,71043,Волинська область
2444,71044,2361,53,1461,925,536,71044,Волинська область
2445,71045,2352,39,1488,897,591,71045,Волинська область
2446,71046,2174,40,1330,773,557,71046,Волинська область
2447,71047,2004,31,1352,871,481,71047,Волинська область
2448,71048,2109,35,1401,957,444,71048,Волинська область
2449,71049,2170,38,1392,891,501,71049,Волинська область
2450,71050,2018,44,1250,743,507,71050,Волинська область
2451,71051,2140,42,1346,838,508,71051,Волинська область
2452,71052,2162,52,1400,882,518,71052,Волинська область
2453,71053,2227,52,1480,864,616,71053,Волинська область
2454,71054,1923,37,1177,696,481,71054,Волинська область
2455,71055,2067,43,1273,807,466,71055,Волинська область
2456,71056,1759,47,1161,669,492,71056,Волинська область
2457,71057,1841,44,1161,695,466,71057,Волинська область
2458,71058,1657,47,1015,629,386,71058,Волинська область
2459,71059,1401,37,892,507,385,71059,Волинська область
2460,71060,1750,42,1122,675,447,71060,Волинська область
2461,71061,2315,35,1503,930,573,71061,Волинська область
2462,71062,2049,39,1293,769,524,71062,Волинська область
2463,71063,2056,46,1228,756,472,71063,Волинська область
2464,71064,2192,52,1379,851,528,71064,Волинська область
2465,71065,1572,43,1001,612,389,71065,Волинська область
2466,71066,2361,44,1462,947,515,71066,Волинська область
2467,71067,1484,24,837,521,316,71067,Волинська область
2468,71068,1382,37,852,522,330,71068,Волинська область
2469,71069,2304,32,1473,851,622,71069,Волинська область
2470,71070,139,6,128,105,23,71070,Волинська область
2471,71071,2279,62,1524,940,584,71071,Волинська область
2472,71072,2082,43,1409,820,589,71072,Волинська область
2473,71073,2134,45,1347,897,450,71073,Волинська область
2474,71074,2311,48,1459,821,638,71074,Волинська область
2475,71075,2261,34,1342,923,419,71075,Волинська область
2476,71076,2297,59,1499,869,630,71076,Волинська область
2477,71077,2265,56,1504,888,616,71077,Волинська область
2478,71078,2264,69,1492,987,505,71078,Волинська область
2479,71079,1911,47,1304,741,563,71079,Волинська область
2480,71080,2361,48,1575,950,625,71080,Волинська область
2481,71081,2186,50,1463,867,596,71081,Волинська область
2482,71082,2292,42,1553,950,603,71082,Волинська область
2483,71083,2343,58,1543,967,576,71083,Волинська область
2484,71084,2333,48,1574,938,636,71084,Волинська область
2485,71085,2414,48,1577,897,680,71085,Волинська область
2486,71086,2336,51,1574,923,651,71086,Волинська область
2487,71087,2113,37,1430,867,563,71087,Волинська область
2488,71088,2247,41,1495,926,569,71088,Волинська область
2489,71089,2178,47,1469,899,570,71089,Волинська область
2490,71090,2310,45,1504,932,572,71090,Волинська область
2491,71091,2367,50,1517,913,604,71091,Волинська область
2492,71092,2338,51,1491,950,541,71092,Волинська область
2493,71093,2182,55,1445,862,583,71093,Волинська область
2494,71094,2019,26,1123,698,425,71094,Волинська область
2495,71095,2321,45,1411,785,626,71095,Волинська область
2496,71096,109,7,99,57,42,71096,Волинська область
2497,71097,76,1,71,51,20,71097,Волинська область
2498,71098,117,5,107,75,32,71098,Волинська область
2499,71099,26,1,23,14,9,71099,Волинська область
2500,71100,71,0,71,56,15,71100,Волинська область
2501,71101,257,5,233,158,75,71101,Волинська область
2502,71103,284,7,254,172,82,71103,Волинська область
2503,71104,35,0,34,26,8,71104,Волинська область
2504,71128,47,2,44,29,15,71128,Волинська область
2505,71131,2021,36,1397,800,597,71131,Волинська область
2506,1,16,1,15,11,4,1,Волинська область
2507,70206,1244,10,717,471,246,70206,Волинська область
2508,70207,2039,36,1194,765,429,70207,Волинська область
2509,70208,1863,29,1053,733,320,70208,Волинська область
2510,70209,1752,28,1040,741,299,70209,Волинська область
2511,70210,1105,22,683,481,202,70210,Волинська область
2512,70211,598,5,376,213,163,70211,Волинська область
2513,70212,371,1,195,122,73,70212,Волинська область
2514,70213,1424,7,729,354,375,70213,Волинська область
2515,70214,789,16,518,412,106,70214,Волинська область
2516,70215,381,6,252,188,64,70215,Волинська область
2517,70216,434,8,248,171,77,70216,Волинська область
2518,70217,32,0,23,16,7,70217,Волинська область
2519,70218,378,5,231,148,83,70218,Волинська область
2520,70219,1514,32,830,605,225,70219,Волинська область
2521,70220,487,7,323,217,106,70220,Волинська область
2522,70221,239,3,172,112,60,70221,Волинська область
2523,70222,334,5,195,147,48,70222,Волинська область
2524,70223,1176,23,660,402,258,70223,Волинська область
2525,70224,1245,23,715,507,208,70224,Волинська область
2526,70225,1398,16,857,681,176,70225,Волинська область
2527,70226,729,5,479,341,138,70226,Волинська область
2528,70227,188,0,96,78,18,70227,Волинська область
2529,70228,816,13,600,447,153,70228,Волинська область
2530,70229,883,6,409,301,108,70229,Волинська область
2531,70230,463,7,284,171,113,70230,Волинська область
2532,70231,474,4,289,144,145,70231,Волинська область
2533,70232,552,7,389,198,191,70232,Волинська область
2534,70233,55,0,36,28,8,70233,Волинська область
2535,70234,114,1,87,48,39,70234,Волинська область
2536,70235,445,1,258,193,65,70235,Волинська область
2537,70236,357,3,241,177,64,70236,Волинська область
2538,70237,447,4,297,168,129,70237,Волинська область
2539,70238,491,9,329,221,108,70238,Волинська область
2540,70239,486,1,357,274,83,70239,Волинська область
2541,70240,839,4,581,294,287,70240,Волинська область
2542,70241,404,6,273,219,54,70241,Волинська область
2543,70242,1160,16,530,321,209,70242,Волинська область
2544,70243,748,9,301,201,100,70243,Волинська область
2545,70244,1079,13,791,587,204,70244,Волинська область
2546,70245,885,10,467,286,181,70245,Волинська область
2547,70246,493,13,257,172,85,70246,Волинська область
2548,70247,615,2,296,204,92,70247,Волинська область
2549,70248,360,3,195,135,60,70248,Волинська область
2550,70249,465,13,216,150,66,70249,Волинська область
2551,70250,486,11,304,152,152,70250,Волинська область
2552,70251,285,9,194,98,96,70251,Волинська область
2553,70252,1237,17,790,519,271,70252,Волинська область
2554,70253,419,11,248,117,131,70253,Волинська область
2555,70254,1460,18,795,487,308,70254,Волинська область
2556,70255,147,2,103,62,41,70255,Волинська область
2557,70256,688,24,332,136,196,70256,Волинська область
2558,70257,133,2,86,39,47,70257,Волинська область
2559,70258,763,17,502,364,138,70258,Волинська область
2560,70259,277,1,199,134,65,70259,Волинська область
2561,70260,1143,22,978,648,330,70260,Волинська область
2562,70261,148,1,129,71,58,70261,Волинська область
2563,70262,1177,27,778,556,222,70262,Волинська область
2564,70263,229,4,161,134,27,70263,Волинська область
2565,70264,368,9,268,187,81,70264,Волинська область
2566,70265,89,3,79,50,29,70265,Волинська область
2567,70266,1833,23,1151,809,342,70266,Волинська область
2568,70267,1717,25,1028,670,358,70267,Волинська область
2569,70268,1594,19,900,634,266,70268,Волинська область
2570,70269,1740,29,1030,701,329,70269,Волинська область
2571,70270,2336,38,1407,980,427,70270,Волинська область
2572,70271,1560,28,956,647,309,70271,Волинська область
2573,70272,1800,28,1121,761,360,70272,Волинська область
2574,70273,1858,35,980,676,304,70273,Волинська область
2575,70274,484,4,293,189,104,70274,Волинська область
2576,70275,273,1,175,118,57,70275,Волинська область
2577,70276,684,7,412,228,184,70276,Волинська область
2578,70277,924,8,640,412,228,70277,Волинська область
2579,70278,1414,39,830,529,301,70278,Волинська область
2580,70279,1225,18,753,506,247,70279,Волинська область
2581,70280,328,5,199,110,89,70280,Волинська область
2582,70281,637,9,400,198,202,70281,Волинська область
2583,70282,867,16,590,350,240,70282,Волинська область
2584,70283,625,2,359,237,122,70283,Волинська область
2585,70284,721,13,490,247,243,70284,Волинська область
2586,70285,281,3,203,80,123,70285,Волинська область
2587,70286,1210,21,723,431,292,70286,Волинська область
2588,70287,295,3,172,109,63,70287,Волинська область
2589,70288,253,1,188,133,55,70288,Волинська область
2590,70289,265,7,201,83,118,70289,Волинська область
2591,70290,707,12,435,297,138,70290,Волинська область
2592,70291,724,27,461,298,163,70291,Волинська область
2593,70292,111,3,84,64,20,70292,Волинська область
2594,70293,202,2,129,84,45,70293,Волинська область
2595,70294,722,16,388,230,158,70294,Волинська область
2596,70295,214,0,136,92,44,70295,Волинська область
2597,70296,1132,15,753,415,338,70296,Волинська область
2598,70297,747,10,485,308,177,70297,Волинська область
2599,70298,430,6,298,151,147,70298,Волинська область
2600,70299,665,23,434,243,191,70299,Волинська область
2601,70300,286,2,197,133,64,70300,Волинська область
2602,70301,207,0,159,91,68,70301,Волинська область
2603,70302,845,10,581,358,223,70302,Волинська область
2604,70303,158,4,111,50,61,70303,Волинська область
2605,70304,99,2,62,45,17,70304,Волинська область
2606,70305,262,2,163,106,57,70305,Волинська область
2607,70306,267,3,171,110,61,70306,Волинська область
2608,70307,510,10,333,198,135,70307,Волинська область
2609,70308,321,2,210,158,52,70308,Волинська область
2610,70309,1197,33,681,302,379,70309,Волинська область
2611,70310,1229,13,738,319,419,70310,Волинська область
2612,70311,547,12,305,211,94,70311,Волинська область
2613,70312,345,3,236,131,105,70312,Волинська область
2614,70313,308,5,223,157,66,70313,Волинська область
2615,70314,332,6,223,161,62,70314,Волинська область
2616,70315,325,3,224,95,129,70315,Волинська область
2617,70316,504,4,307,194,113,70316,Волинська область
2618,70317,453,6,351,216,135,70317,Волинська область
2619,70318,256,3,182,121,61,70318,Волинська область
2620,70319,1782,22,1105,686,419,70319,Волинська область
2621,70320,813,16,518,319,199,70320,Волинська область
2622,70322,151,2,90,60,30,70322,Волинська область
2623,70323,360,0,211,88,123,70323,Волинська область
2624,70324,533,8,344,190,154,70324,Волинська область
2625,70325,91,0,65,41,24,70325,Волинська область
2626,70326,709,10,410,282,128,70326,Волинська область
2627,70327,517,3,305,241,64,70327,Волинська область
2628,70328,433,3,326,223,103,70328,Волинська область
2629,70329,346,5,202,133,69,70329,Волинська область
2630,70330,226,1,183,74,109,70330,Волинська область
2631,70331,259,0,159,90,69,70331,Волинська область
2632,70332,77,2,43,29,14,70332,Волинська область
2633,70333,724,8,456,247,209,70333,Волинська область
2634,70334,203,1,128,79,49,70334,Волинська область
2635,70335,136,0,99,80,19,70335,Волинська область
2636,70337,763,14,559,287,272,70337,Волинська область
2637,70338,181,1,159,73,86,70338,Волинська область
2638,70339,471,3,334,225,109,70339,Волинська область
2639,70340,286,2,177,115,62,70340,Волинська область
2640,70341,38,1,31,19,12,70341,Волинська область
2641,70342,192,12,180,151,29,70342,Волинська область
2642,70545,2157,25,1225,844,381,70545,Волинська область
2643,70546,2266,14,1374,1007,367,70546,Волинська область
2644,70547,294,6,181,145,36,70547,Волинська область
2645,70548,156,1,94,78,16,70548,Волинська область
2646,70549,566,1,365,258,107,70549,Волинська область
2647,70550,168,0,87,46,41,70550,Волинська область
2648,70551,113,1,78,50,28,70551,Волинська область
2649,70552,840,10,530,319,211,70552,Волинська область
2650,70553,140,1,78,31,47,70553,Волинська область
2651,70554,1170,15,659,434,225,70554,Волинська область
2652,70555,203,1,120,89,31,70555,Волинська область
2653,70556,1216,13,668,454,214,70556,Волинська область
2654,70557,384,13,326,214,112,70557,Волинська область
2655,70558,369,7,263,150,113,70558,Волинська область
2656,70559,539,3,353,249,104,70559,Волинська область
2657,70560,356,3,211,148,63,70560,Волинська область
2658,70561,1172,9,694,497,197,70561,Волинська область
2659,70562,609,8,372,240,132,70562,Волинська область
2660,70563,294,8,179,148,31,70563,Волинська область
2661,70564,624,7,392,250,142,70564,Волинська область
2662,70565,550,4,356,241,115,70565,Волинська область
2663,70566,172,1,121,74,47,70566,Волинська область
2664,70567,1415,11,796,539,257,70567,Волинська область
2665,70568,151,2,94,55,39,70568,Волинська область
2666,70569,1430,15,771,664,107,70569,Волинська область
2667,70570,454,4,279,194,85,70570,Волинська область
2668,70571,996,13,591,469,122,70571,Волинська область
2669,70572,575,2,310,247,63,70572,Волинська область
2670,70573,214,2,154,122,32,70573,Волинська область
2671,70574,39,0,31,23,8,70574,Волинська область
2672,70575,140,1,99,50,49,70575,Волинська область
2673,70576,399,3,286,203,83,70576,Волинська область
2674,70577,303,1,199,121,78,70577,Волинська область
2675,70578,775,10,488,331,157,70578,Волинська область
2676,70579,933,11,518,366,152,70579,Волинська область
2677,70580,971,10,663,309,354,70580,Волинська область
2678,70581,411,7,271,164,107,70581,Волинська область
2679,70582,725,6,468,337,131,70582,Волинська область
2680,70583,195,2,153,80,73,70583,Волинська область
2681,70584,272,4,177,102,75,70584,Волинська область
2682,70585,28,0,24,11,13,70585,Волинська область
2683,70586,841,9,440,216,224,70586,Волинська область
2684,70587,333,4,201,111,90,70587,Волинська область
2685,70588,457,5,285,181,104,70588,Волинська область
2686,70654,1525,23,953,639,314,70654,Волинська область
2687,70655,1404,16,785,513,272,70655,Волинська область
2688,70656,1379,26,775,514,261,70656,Волинська область
2689,70657,1485,21,863,609,254,70657,Волинська область
2690,70658,1929,34,1214,818,396,70658,Волинська область
2691,70659,1281,9,734,462,272,70659,Волинська область
2692,70660,1466,29,890,600,290,70660,Волинська область
2693,70661,642,9,373,152,221,70661,Волинська область
2694,70662,447,8,304,154,150,70662,Волинська область
2695,70663,456,3,250,159,91,70663,Волинська область
2696,70664,213,3,155,89,66,70664,Волинська область
2697,70665,180,0,146,84,62,70665,Волинська область
2698,70666,249,6,161,88,73,70666,Волинська область
2699,70667,420,5,241,123,118,70667,Волинська область
2700,70668,225,5,180,97,83,70668,Волинська область
2701,70669,227,11,109,62,47,70669,Волинська область
2702,70670,489,16,325,224,101,70670,Волинська область
2703,70671,548,11,350,163,187,70671,Волинська область
2704,70672,894,10,470,203,267,70672,Волинська область
2705,70673,247,1,159,69,90,70673,Волинська область
2706,70674,753,16,483,291,192,70674,Волинська область
2707,70675,264,8,180,120,60,70675,Волинська область
2708,70676,574,4,438,297,141,70676,Волинська область
2709,70677,393,9,301,194,107,70677,Волинська область
2710,70678,71,0,54,35,19,70678,Волинська область
2711,70679,77,3,48,23,25,70679,Волинська область
2712,70680,468,6,279,181,98,70680,Волинська область
2713,70681,193,1,140,73,67,70681,Волинська область
2714,70682,591,9,361,188,173,70682,Волинська область
2715,70683,266,0,150,78,72,70683,Волинська область
2716,70684,577,11,365,230,135,70684,Волинська область
2717,70685,404,4,264,154,110,70685,Волинська область
2718,70686,234,1,151,72,79,70686,Волинська область
2719,70687,269,5,160,95,65,70687,Волинська область
2720,70688,535,6,336,141,195,70688,Волинська область
2721,70689,354,7,225,136,89,70689,Волинська область
2722,70690,292,3,227,110,117,70690,Волинська область
2723,70691,192,5,118,42,76,70691,Волинська область
2724,70692,378,3,256,122,134,70692,Волинська область
2725,70693,574,9,323,180,143,70693,Волинська область
2726,70694,142,0,86,48,38,70694,Волинська область
2727,70695,511,9,318,120,198,70695,Волинська область
2728,70696,342,11,203,120,83,70696,Волинська область
2729,70697,353,5,192,110,82,70697,Волинська область
2730,70698,223,5,155,90,65,70698,Волинська область
2731,70699,350,5,223,144,79,70699,Волинська область
2732,70700,201,4,130,58,72,70700,Волинська область
2733,70701,98,0,61,22,39,70701,Волинська область
2734,70702,915,14,575,433,142,70702,Волинська область
2735,70703,1906,33,1175,908,267,70703,Волинська область
2736,70704,972,13,645,346,299,70704,Волинська область
2737,70705,102,2,61,19,42,70705,Волинська область
2738,70706,50,1,33,25,8,70706,Волинська область
2739,70707,148,1,98,51,47,70707,Волинська область
2740,70708,151,2,106,66,40,70708,Волинська область
2741,70709,347,5,220,89,131,70709,Волинська область
2742,70710,1165,18,716,406,310,70710,Волинська область
2743,70711,1036,9,553,367,186,70711,Волинська область
2744,70712,557,6,295,182,113,70712,Волинська область
2745,70713,116,2,95,69,26,70713,Волинська область
2746,70714,393,4,231,160,71,70714,Волинська область
2747,70715,565,6,394,236,158,70715,Волинська область
2748,70716,325,11,206,106,100,70716,Волинська область
2749,70717,109,1,74,35,39,70717,Волинська область
2750,70718,324,5,239,163,76,70718,Волинська область
2751,70719,643,3,453,211,242,70719,Волинська область
2752,70720,269,8,168,81,87,70720,Волинська область
2753,70721,90,0,69,30,39,70721,Волинська область
2754,70722,96,1,72,23,49,70722,Волинська область
2755,70723,469,3,345,182,163,70723,Волинська область
2756,70724,670,4,427,257,170,70724,Волинська область
2757,70725,43,0,35,15,20,70725,Волинська область
2758,70726,868,18,617,342,275,70726,Волинська область
2759,70727,334,7,206,112,94,70727,Волинська область
2760,70728,1056,20,618,300,318,70728,Волинська область
2761,70729,21,2,16,13,3,70729,Волинська область
2762,70730,26,1,23,15,8,70730,Волинська область
2763,70731,490,29,452,412,40,70731,Волинська область
2764,71127,1472,14,835,618,217,71127,Волинська область
2765,71129,1269,14,805,555,250,71129,Волинська область
2766,121233,2031,21,1422,1261,161,121233,Дніпропетровська область
2767,121234,2030,29,1350,1217,133,121234,Дніпропетровська область
2768,121235,2061,21,1328,1156,172,121235,Дніпропетровська область
2769,121236,1448,22,979,865,114,121236,Дніпропетровська область
2770,121237,1551,21,1110,993,117,121237,Дніпропетровська область
2771,121238,1898,34,1317,1143,174,121238,Дніпропетровська область
2772,121239,1908,25,1287,1138,149,121239,Дніпропетровська область
2773,121240,1571,27,1071,939,132,121240,Дніпропетровська область
2774,121241,1655,37,1128,956,172,121241,Дніпропетровська область
2775,121242,2128,47,1407,1175,232,121242,Дніпропетровська область
2776,121243,2161,26,1464,1270,194,121243,Дніпропетровська область
2777,121244,2337,32,1616,1327,289,121244,Дніпропетровська область
2778,121245,2120,18,1483,1268,215,121245,Дніпропетровська область
2779,121246,2187,31,1474,1292,182,121246,Дніпропетровська область
2780,121247,2144,22,1544,1341,203,121247,Дніпропетровська область
2781,121248,1955,39,1352,1183,169,121248,Дніпропетровська область
2782,121249,1743,20,1161,1046,115,121249,Дніпропетровська область
2783,121250,2186,32,1457,1261,196,121250,Дніпропетровська область
2784,121251,2152,32,1513,1355,158,121251,Дніпропетровська область
2785,121252,2108,35,1458,1307,151,121252,Дніпропетровська область
2786,121253,1576,16,1073,942,131,121253,Дніпропетровська область
2787,121254,2207,30,1477,1290,187,121254,Дніпропетровська область
2788,121255,2168,36,1437,1235,202,121255,Дніпропетровська область
2789,121256,2111,27,1439,1265,174,121256,Дніпропетровська область
2790,121257,2225,38,1483,1265,218,121257,Дніпропетровська область
2791,121258,1808,32,1233,1077,156,121258,Дніпропетровська область
2792,121259,2383,26,1554,1362,192,121259,Дніпропетровська область
2793,121261,2234,35,1409,1237,172,121261,Дніпропетровська область
2794,121262,2023,33,1201,1047,154,121262,Дніпропетровська область
2795,121263,1215,21,824,742,82,121263,Дніпропетровська область
2796,121264,1494,18,917,842,75,121264,Дніпропетровська область
2797,121265,2278,34,1410,1225,185,121265,Дніпропетровська область
2798,121266,2262,29,1319,1171,148,121266,Дніпропетровська область
2799,121267,1437,25,992,887,105,121267,Дніпропетровська область
2800,121268,1973,35,1223,1064,159,121268,Дніпропетровська область
2801,121269,2090,40,1427,1231,196,121269,Дніпропетровська область
2802,121270,1824,28,1254,1072,182,121270,Дніпропетровська область
2803,121271,2157,45,1466,1252,214,121271,Дніпропетровська область
2804,121272,2100,24,1303,1109,194,121272,Дніпропетровська область
2805,121273,2131,42,1396,1252,144,121273,Дніпропетровська область
2806,121274,2142,32,1445,1239,206,121274,Дніпропетровська область
2807,121275,2179,35,1409,1242,167,121275,Дніпропетровська область
2808,121276,2129,27,1466,1263,203,121276,Дніпропетровська область
2809,121277,1625,25,948,842,106,121277,Дніпропетровська область
2810,121278,1511,28,949,828,121,121278,Дніпропетровська область
2811,121279,2081,46,1339,1145,194,121279,Дніпропетровська область
2812,121280,1934,18,1280,1094,186,121280,Дніпропетровська область
2813,121281,1796,22,1197,1025,172,121281,Дніпропетровська область
2814,121282,1495,28,1010,845,165,121282,Дніпропетровська область
2815,121283,180,5,165,148,17,121283,Дніпропетровська область
2816,121284,90,1,89,74,15,121284,Дніпропетровська область
2817,121285,32,1,27,24,3,121285,Дніпропетровська область
2818,121444,1964,37,1253,1100,153,121444,Дніпропетровська область
2819,121445,2057,20,1317,1180,137,121445,Дніпропетровська область
2820,121446,1606,24,1070,915,155,121446,Дніпропетровська область
2821,121447,1919,27,1308,1170,138,121447,Дніпропетровська область
2822,121448,2063,34,1401,1261,140,121448,Дніпропетровська область
2823,121449,1827,27,1186,1045,141,121449,Дніпропетровська область
2824,121450,1639,14,1098,1005,93,121450,Дніпропетровська область
2825,121451,1406,18,908,824,84,121451,Дніпропетровська область
2826,121452,1846,34,1197,1053,144,121452,Дніпропетровська область
2827,121453,1993,23,1323,1157,166,121453,Дніпропетровська область
2828,121454,1468,19,908,788,120,121454,Дніпропетровська область
2829,121455,1841,24,1151,1005,146,121455,Дніпропетровська область
2830,121456,1662,21,1019,921,98,121456,Дніпропетровська область
2831,121457,1681,41,1029,913,116,121457,Дніпропетровська область
2832,121458,1507,24,960,799,161,121458,Дніпропетровська область
2833,121459,1647,16,1005,870,135,121459,Дніпропетровська область
2834,121460,2319,35,1429,1252,177,121460,Дніпропетровська область
2835,121461,2370,24,1439,1297,142,121461,Дніпропетровська область
2836,121462,1329,18,877,779,98,121462,Дніпропетровська область
2837,121463,1986,16,1302,1157,145,121463,Дніпропетровська область
2838,121467,1383,16,922,807,115,121467,Дніпропетровська область
2839,121468,2162,24,1426,1283,143,121468,Дніпропетровська область
2840,121469,2039,22,1379,1209,170,121469,Дніпропетровська область
2841,121470,2095,37,1383,1206,177,121470,Дніпропетровська область
2842,121471,2074,31,1434,1251,183,121471,Дніпропетровська область
2843,121472,1936,30,1336,1147,189,121472,Дніпропетровська область
2844,121473,2144,44,1397,1178,219,121473,Дніпропетровська область
2845,121474,2122,23,1396,1212,184,121474,Дніпропетровська область
2846,121475,611,45,440,335,105,121475,Дніпропетровська область
2847,121477,1231,58,1046,890,156,121477,Дніпропетровська область
2848,121478,31,0,30,23,7,121478,Дніпропетровська область
2849,121479,135,3,125,121,4,121479,Дніпропетровська область
2850,121481,155,6,142,139,3,121481,Дніпропетровська область
2851,121785,35,1,33,33,0,121785,Дніпропетровська область
2852,1,896,114,761,743,18,1,Дніпропетровська область
2853,2,785,51,727,692,35,2,Дніпропетровська область
2854,121063,2317,19,1377,1241,136,121063,Дніпропетровська область
2855,121064,2234,33,1350,1232,118,121064,Дніпропетровська область
2856,121071,2269,26,1452,1250,202,121071,Дніпропетровська область
2857,121072,2214,22,1463,1275,188,121072,Дніпропетровська область
2858,121073,1939,31,1271,1097,174,121073,Дніпропетровська область
2859,121074,1821,23,1204,1066,138,121074,Дніпропетровська область
2860,121075,2296,41,1544,1336,208,121075,Дніпропетровська область
2861,121076,2258,19,1490,1300,190,121076,Дніпропетровська область
2862,121077,2238,21,1472,1256,216,121077,Дніпропетровська область
2863,121084,1980,25,1338,1184,154,121084,Дніпропетровська область
2864,121087,2236,36,1459,1267,192,121087,Дніпропетровська область
2865,121088,2132,26,1451,1270,181,121088,Дніпропетровська область
2866,121089,2218,42,1469,1258,211,121089,Дніпропетровська область
2867,121090,2180,32,1442,1244,198,121090,Дніпропетровська область
2868,121091,1798,22,1221,1041,180,121091,Дніпропетровська область
2869,121092,948,19,661,571,90,121092,Дніпропетровська область
2870,121093,2108,45,1463,1243,220,121093,Дніпропетровська область
2871,121094,2235,24,1540,1301,239,121094,Дніпропетровська область
2872,121095,2183,36,1502,1295,207,121095,Дніпропетровська область
2873,121096,2244,25,1430,1244,186,121096,Дніпропетровська область
2874,121097,2222,26,1448,1236,212,121097,Дніпропетровська область
2875,121098,2190,43,1462,1224,238,121098,Дніпропетровська область
2876,121099,1960,41,1296,1100,196,121099,Дніпропетровська область
2877,121100,2070,35,1365,1124,241,121100,Дніпропетровська область
2878,121101,2276,38,1541,1287,254,121101,Дніпропетровська область
2879,121102,1824,26,1246,1069,177,121102,Дніпропетровська область
2880,121103,299,7,286,256,30,121103,Дніпропетровська область
2881,121318,2207,30,1374,1119,255,121318,Дніпропетровська область
2882,121319,1709,25,1052,922,130,121319,Дніпропетровська область
2883,121320,2153,32,1241,1023,218,121320,Дніпропетровська область
2884,121321,1797,27,1036,889,147,121321,Дніпропетровська область
2885,121322,1622,25,1000,792,208,121322,Дніпропетровська область
2886,121323,2216,30,1376,1195,181,121323,Дніпропетровська область
2887,121324,1438,20,842,716,126,121324,Дніпропетровська область
2888,121325,2097,30,1211,1042,169,121325,Дніпропетровська область
2889,121326,1035,13,641,571,70,121326,Дніпропетровська область
2890,121327,1961,26,1249,1073,176,121327,Дніпропетровська область
2891,121328,2083,35,1260,1095,165,121328,Дніпропетровська область
2892,121329,1336,13,845,720,125,121329,Дніпропетровська область
2893,121330,2169,38,1378,1228,150,121330,Дніпропетровська область
2894,121331,1259,13,760,682,78,121331,Дніпропетровська область
2895,121332,1087,14,702,629,73,121332,Дніпропетровська область
2896,121333,1064,24,704,624,80,121333,Дніпропетровська область
2897,121334,2162,31,1346,1146,200,121334,Дніпропетровська область
2898,121335,2159,42,1441,1214,227,121335,Дніпропетровська область
2899,121336,2231,50,1497,1298,199,121336,Дніпропетровська область
2900,121337,1734,31,1186,995,191,121337,Дніпропетровська область
2901,121338,2039,44,1387,1127,260,121338,Дніпропетровська область
2902,121339,2057,19,1401,1199,202,121339,Дніпропетровська область
2903,121340,2052,27,1488,1206,282,121340,Дніпропетровська область
2904,121341,2157,36,1557,1330,227,121341,Дніпропетровська область
2905,121342,2121,34,1464,1243,221,121342,Дніпропетровська область
2906,121343,2247,22,1459,1262,197,121343,Дніпропетровська область
2907,121344,1723,32,1172,998,174,121344,Дніпропетровська область
2908,121345,1378,23,957,801,156,121345,Дніпропетровська область
2909,121346,1889,27,1311,1082,229,121346,Дніпропетровська область
2910,121347,1711,19,1138,949,189,121347,Дніпропетровська область
2911,121348,1862,21,1259,1095,164,121348,Дніпропетровська область
2912,121349,1654,27,1069,878,191,121349,Дніпропетровська область
2913,121350,1764,19,1063,905,158,121350,Дніпропетровська область
2914,121351,1666,21,1060,906,154,121351,Дніпропетровська область
2915,121352,2080,36,1419,1238,181,121352,Дніпропетровська область
2916,121353,1487,26,1005,838,167,121353,Дніпропетровська область
2917,121354,1590,19,1065,921,144,121354,Дніпропетровська область
2918,121355,1271,21,869,723,146,121355,Дніпропетровська область
2919,121356,1355,12,900,771,129,121356,Дніпропетровська область
2920,121357,1875,25,1187,1035,152,121357,Дніпропетровська область
2921,121358,1904,22,1160,1054,106,121358,Дніпропетровська область
2922,121359,1998,30,1200,1073,127,121359,Дніпропетровська область
2923,121360,1761,29,1156,1040,116,121360,Дніпропетровська область
2924,121361,1522,17,907,810,97,121361,Дніпропетровська область
2925,121362,852,8,500,454,46,121362,Дніпропетровська область
2926,121363,1643,22,1063,948,115,121363,Дніпропетровська область
2927,121364,542,8,526,442,84,121364,Дніпропетровська область
2928,121365,223,9,210,193,17,121365,Дніпропетровська область
2929,121366,174,2,169,148,21,121366,Дніпропетровська область
2930,121367,89,5,81,74,7,121367,Дніпропетровська область
2931,121369,696,27,659,570,89,121369,Дніпропетровська область
2932,121370,594,24,566,454,112,121370,Дніпропетровська область
2933,121786,168,9,159,149,10,121786,Дніпропетровська область
2934,121787,1263,15,849,691,158,121787,Дніпропетровська область
2935,1,43,0,43,39,4,1,Дніпропетровська область
2936,121105,1979,35,1224,965,259,121105,Дніпропетровська область
2937,121106,1998,22,1278,993,285,121106,Дніпропетровська область
2938,121108,2211,45,1397,1093,304,121108,Дніпропетровська область
2939,121109,1860,24,1128,904,224,121109,Дніпропетровська область
2940,121110,2143,36,1297,1037,260,121110,Дніпропетровська область
2941,121111,1951,24,1163,950,213,121111,Дніпропетровська область
2942,121112,2350,28,1386,1141,245,121112,Дніпропетровська область
2943,121113,2257,38,1394,1148,246,121113,Дніпропетровська область
2944,121114,2409,30,1567,1231,336,121114,Дніпропетровська область
2945,121115,2106,48,1312,1075,237,121115,Дніпропетровська область
2946,121116,1927,37,1238,1021,217,121116,Дніпропетровська область
2947,121117,2112,27,1334,1175,159,121117,Дніпропетровська область
2948,121118,2067,36,1419,1182,237,121118,Дніпропетровська область
2949,121119,2001,43,1398,1179,219,121119,Дніпропетровська область
2950,121120,2228,31,1544,1324,220,121120,Дніпропетровська область
2951,121121,2091,33,1454,1235,219,121121,Дніпропетровська область
2952,121122,2222,38,1525,1275,250,121122,Дніпропетровська область
2953,121123,1953,31,1356,1152,204,121123,Дніпропетровська область
2954,121124,2016,25,1421,1198,223,121124,Дніпропетровська область
2955,121125,1726,19,1134,969,165,121125,Дніпропетровська область
2956,121126,1711,25,1106,940,166,121126,Дніпропетровська область
2957,121127,1762,20,1207,1050,157,121127,Дніпропетровська область
2958,121128,1826,30,1199,1019,180,121128,Дніпропетровська область
2959,121129,2000,33,1352,1118,234,121129,Дніпропетровська область
2960,121130,2218,30,1471,1258,213,121130,Дніпропетровська область
2961,121131,1748,21,1091,945,146,121131,Дніпропетровська область
2962,121132,2178,37,1474,1257,217,121132,Дніпропетровська область
2963,121133,1777,33,1284,1092,192,121133,Дніпропетровська область
2964,121134,1987,39,1349,1134,215,121134,Дніпропетровська область
2965,121135,2127,28,1452,1224,228,121135,Дніпропетровська область
2966,121136,2021,37,1426,1200,226,121136,Дніпропетровська область
2967,121137,2136,31,1533,1271,262,121137,Дніпропетровська область
2968,121138,2175,37,1524,1251,273,121138,Дніпропетровська область
2969,121139,2337,20,1243,1055,188,121139,Дніпропетровська область
2970,121140,1933,25,1270,1110,160,121140,Дніпропетровська область
2971,121141,2206,35,1505,1291,214,121141,Дніпропетровська область
2972,121142,2195,24,1510,1266,244,121142,Дніпропетровська область
2973,121143,1899,20,1274,1113,161,121143,Дніпропетровська область
2974,121144,1805,30,1152,1011,141,121144,Дніпропетровська область
2975,121145,1703,31,1137,985,152,121145,Дніпропетровська область
2976,121146,2188,22,1553,1332,221,121146,Дніпропетровська область
2977,121147,2219,42,1491,1280,211,121147,Дніпропетровська область
2978,121148,2213,39,1488,1271,217,121148,Дніпропетровська область
2979,121149,2100,29,1439,1245,194,121149,Дніпропетровська область
2980,121150,1996,15,1229,1065,164,121150,Дніпропетровська область
2981,121151,1696,21,1098,993,105,121151,Дніпропетровська область
2982,121152,1826,22,1156,1043,113,121152,Дніпропетровська область
2983,121153,1756,23,1147,1031,116,121153,Дніпропетровська область
2984,121154,2077,27,1343,1185,158,121154,Дніпропетровська область
2985,121155,1535,21,954,842,112,121155,Дніпропетровська область
2986,121156,1762,24,996,915,81,121156,Дніпропетровська область
2987,121157,1648,18,1044,920,124,121157,Дніпропетровська область
2988,121158,2109,31,1479,1241,238,121158,Дніпропетровська область
2989,121159,94,1,90,82,8,121159,Дніпропетровська область
2990,121160,414,8,398,353,45,121160,Дніпропетровська область
2991,121286,2112,33,1386,1106,280,121286,Дніпропетровська область
2992,121287,2065,23,1399,1184,215,121287,Дніпропетровська область
2993,121288,2279,25,1467,1235,232,121288,Дніпропетровська область
2994,121289,1974,32,1202,1037,165,121289,Дніпропетровська область
2995,121290,2050,26,1264,1055,209,121290,Дніпропетровська область
2996,121291,1898,23,1172,962,210,121291,Дніпропетровська область
2997,121293,2079,25,1261,1067,194,121293,Дніпропетровська область
2998,121294,1399,25,907,755,152,121294,Дніпропетровська область
2999,121295,1520,26,927,758,169,121295,Дніпропетровська область
3000,121296,2144,32,1408,1177,231,121296,Дніпропетровська область
3001,121297,1323,26,855,716,139,121297,Дніпропетровська область
3002,121298,1391,19,880,712,168,121298,Дніпропетровська область
3003,121310,1498,26,944,721,223,121310,Дніпропетровська область
3004,121311,1329,15,748,649,99,121311,Дніпропетровська область
3005,121312,1664,29,929,780,149,121312,Дніпропетровська область
3006,121313,2237,25,1306,1095,211,121313,Дніпропетровська область
3007,121314,109,2,106,97,9,121314,Дніпропетровська область
3008,121315,123,5,114,106,8,121315,Дніпропетровська область
3009,1,15,0,15,15,0,1,Дніпропетровська область
3010,121162,1715,26,1143,837,306,121162,Дніпропетровська область
3011,121163,1768,36,1173,867,306,121163,Дніпропетровська область
3012,121164,1498,23,970,769,201,121164,Дніпропетровська область
3013,121165,1655,37,1097,831,266,121165,Дніпропетровська область
3014,121166,1922,25,1121,921,200,121166,Дніпропетровська область
3015,121167,1173,14,766,634,132,121167,Дніпропетровська область
3016,121168,1303,22,898,689,209,121168,Дніпропетровська область
3017,121169,1516,30,971,764,207,121169,Дніпропетровська область
3018,121170,1841,34,1141,882,259,121170,Дніпропетровська область
3019,121171,1535,23,908,727,181,121171,Дніпропетровська область
3020,121172,1416,35,931,740,191,121172,Дніпропетровська область
3021,121173,1615,18,1052,853,199,121173,Дніпропетровська область
3022,121174,1769,28,1158,947,211,121174,Дніпропетровська область
3023,121175,1728,19,1094,888,206,121175,Дніпропетровська область
3024,121176,1438,16,816,674,142,121176,Дніпропетровська область
3025,121177,1588,29,965,793,172,121177,Дніпропетровська область
3026,121178,1705,26,1111,927,184,121178,Дніпропетровська область
3027,121179,1563,21,974,808,166,121179,Дніпропетровська область
3028,121180,1890,30,1207,968,239,121180,Дніпропетровська область
3029,121181,1948,36,1251,1001,250,121181,Дніпропетровська область
3030,121182,1180,18,784,651,133,121182,Дніпропетровська область
3031,121183,1141,10,631,564,67,121183,Дніпропетровська область
3032,121184,2134,41,1407,1140,267,121184,Дніпропетровська область
3033,121185,1458,20,885,727,158,121185,Дніпропетровська область
3034,121186,1437,9,566,527,39,121186,Дніпропетровська область
3035,121187,1904,53,1172,917,255,121187,Дніпропетровська область
3036,121188,1679,16,841,748,93,121188,Дніпропетровська область
3037,121189,1998,32,1303,972,331,121189,Дніпропетровська область
3038,121190,1744,18,1169,1033,136,121190,Дніпропетровська область
3039,121191,2265,17,1232,1111,121,121191,Дніпропетровська область
3040,121192,2062,27,1353,1138,215,121192,Дніпропетровська область
3041,121193,2365,47,1549,1313,236,121193,Дніпропетровська область
3042,121194,1688,31,1174,940,234,121194,Дніпропетровська область
3043,121195,2012,30,1444,1228,216,121195,Дніпропетровська область
3044,121196,1774,21,1184,963,221,121196,Дніпропетровська область
3045,121197,1782,28,1184,1009,175,121197,Дніпропетровська область
3046,121198,2113,42,1398,1105,293,121198,Дніпропетровська область
3047,121199,2242,42,1504,1179,325,121199,Дніпропетровська область
3048,121200,2131,27,1540,1249,291,121200,Дніпропетровська область
3049,121201,2028,37,1402,1137,265,121201,Дніпропетровська область
3050,121202,1879,58,1280,1040,240,121202,Дніпропетровська область
3051,121203,1970,33,1239,1017,222,121203,Дніпропетровська область
3052,121204,2157,52,1496,1222,274,121204,Дніпропетровська область
3053,121205,1825,32,1247,1026,221,121205,Дніпропетровська область
3054,121206,1932,34,1265,1060,205,121206,Дніпропетровська область
3055,121207,2156,37,1402,1138,264,121207,Дніпропетровська область
3056,121208,1692,21,1164,962,202,121208,Дніпропетровська область
3057,121209,1865,22,1268,1070,198,121209,Дніпропетровська область
3058,121210,1571,27,1104,931,173,121210,Дніпропетровська область
3059,121211,2254,28,1461,1221,240,121211,Дніпропетровська область
3060,121212,1865,22,1199,1019,180,121212,Дніпропетровська область
3061,121213,2140,25,1465,1162,303,121213,Дніпропетровська область
3062,121214,1739,51,1159,963,196,121214,Дніпропетровська область
3063,121215,1510,24,1039,825,214,121215,Дніпропетровська область
3064,121216,2013,37,1289,1059,230,121216,Дніпропетровська область
3065,121217,2119,51,1388,1143,245,121217,Дніпропетровська область
3066,121218,1945,38,1343,1094,249,121218,Дніпропетровська область
3067,121219,1869,21,1245,1022,223,121219,Дніпропетровська область
3068,121220,2064,42,1427,1147,280,121220,Дніпропетровська область
3069,121221,2048,41,1382,1150,232,121221,Дніпропетровська область
3070,121222,541,11,314,267,47,121222,Дніпропетровська область
3071,121223,533,8,520,469,51,121223,Дніпропетровська область
3072,121224,42,1,40,23,17,121224,Дніпропетровська область
3073,121225,131,4,126,119,7,121225,Дніпропетровська область
3074,121226,118,4,114,98,16,121226,Дніпропетровська область
3075,121227,20,0,20,17,3,121227,Дніпропетровська область
3076,121228,176,1,171,154,17,121228,Дніпропетровська область
3077,121229,144,2,141,121,20,121229,Дніпропетровська область
3078,121230,128,2,126,112,14,121230,Дніпропетровська область
3079,121299,1311,17,918,743,175,121299,Дніпропетровська область
3080,121300,1318,28,792,646,146,121300,Дніпропетровська область
3081,121301,1502,20,962,771,191,121301,Дніпропетровська область
3082,121302,1395,22,913,684,229,121302,Дніпропетровська область
3083,121303,2186,54,1332,1032,300,121303,Дніпропетровська область
3084,121304,1134,31,756,604,152,121304,Дніпропетровська область
3085,121305,1496,29,1046,842,204,121305,Дніпропетровська область
3086,121306,2200,33,1347,1115,232,121306,Дніпропетровська область
3087,121307,1904,34,1235,999,236,121307,Дніпропетровська область
3088,121308,2247,41,1430,1184,246,121308,Дніпропетровська область
3089,121309,1811,30,1166,916,250,121309,Дніпропетровська область
3090,121316,112,3,107,81,26,121316,Дніпропетровська область
3091,121317,103,0,93,81,12,121317,Дніпропетровська область
3092,121464,2249,35,1503,1293,210,121464,Дніпропетровська область
3093,121465,1683,22,1103,944,159,121465,Дніпропетровська область
3094,121466,1748,24,1108,960,148,121466,Дніпропетровська область
3095,121480,75,4,68,45,23,121480,Дніпропетровська область
3096,121059,2274,34,1584,1329,255,121059,Дніпропетровська область
3097,121060,2164,33,1477,1231,246,121060,Дніпропетровська область
3098,121061,2296,42,1633,1387,246,121061,Дніпропетровська область
3099,121062,2244,28,1406,1208,198,121062,Дніпропетровська область
3100,121371,2393,39,1409,1278,131,121371,Дніпропетровська область
3101,121372,2001,19,1231,1112,119,121372,Дніпропетровська область
3102,121373,2286,39,1310,1148,162,121373,Дніпропетровська область
3103,121374,2078,28,1274,1125,149,121374,Дніпропетровська область
3104,121375,2128,27,1233,1095,138,121375,Дніпропетровська область
3105,121376,2271,33,1415,1267,148,121376,Дніпропетровська область
3106,121377,1799,19,743,657,86,121377,Дніпропетровська область
3107,121378,2127,29,1292,1133,159,121378,Дніпропетровська область
3108,121379,1847,23,1069,968,101,121379,Дніпропетровська область
3109,121380,2193,32,1403,1278,125,121380,Дніпропетровська область
3110,121381,1653,22,988,885,103,121381,Дніпропетровська область
3111,121382,1553,9,963,871,92,121382,Дніпропетровська область
3112,121383,2289,23,1410,1251,159,121383,Дніпропетровська область
3113,121384,1947,19,1210,1137,73,121384,Дніпропетровська область
3114,121385,1120,10,699,625,74,121385,Дніпропетровська область
3115,121386,2349,18,1441,1323,118,121386,Дніпропетровська область
3116,121387,2282,39,1454,1277,177,121387,Дніпропетровська область
3117,121388,2141,40,1454,1205,249,121388,Дніпропетровська область
3118,121389,2255,36,1305,1168,137,121389,Дніпропетровська область
3119,121390,2086,28,1404,1247,157,121390,Дніпропетровська область
3120,121391,1738,43,1093,970,123,121391,Дніпропетровська область
3121,121392,1736,24,1036,917,119,121392,Дніпропетровська область
3122,121393,2276,32,1553,1390,163,121393,Дніпропетровська область
3123,121394,2210,29,1363,1217,146,121394,Дніпропетровська область
3124,121395,1692,25,932,840,92,121395,Дніпропетровська область
3125,121396,1252,20,804,693,111,121396,Дніпропетровська область
3126,121397,1056,10,662,576,86,121397,Дніпропетровська область
3127,121398,1790,16,1119,1012,107,121398,Дніпропетровська область
3128,121399,1836,25,1232,1054,178,121399,Дніпропетровська область
3129,121400,2040,15,1326,1151,175,121400,Дніпропетровська область
3130,121401,1925,30,1276,1116,160,121401,Дніпропетровська область
3131,121402,1502,14,877,783,94,121402,Дніпропетровська область
3132,121403,1158,15,762,684,78,121403,Дніпропетровська область
3133,121404,1923,29,1292,1102,190,121404,Дніпропетровська область
3134,121405,1524,26,1017,876,141,121405,Дніпропетровська область
3135,121406,1541,19,1065,943,122,121406,Дніпропетровська область
3136,121407,1666,37,1049,876,173,121407,Дніпропетровська область
3137,121408,1975,21,1334,1196,138,121408,Дніпропетровська область
3138,121409,1295,17,826,756,70,121409,Дніпропетровська область
3139,121410,1984,16,1156,1016,140,121410,Дніпропетровська область
3140,121411,1151,10,734,665,69,121411,Дніпропетровська область
3141,121412,1506,19,880,791,89,121412,Дніпропетровська область
3142,121413,1833,26,1033,937,96,121413,Дніпропетровська область
3143,121414,2165,23,1317,1184,133,121414,Дніпропетровська область
3144,121415,1438,19,995,850,145,121415,Дніпропетровська область
3145,121416,2187,26,1319,1165,154,121416,Дніпропетровська область
3146,121417,2251,32,1555,1307,248,121417,Дніпропетровська область
3147,121418,2073,24,1468,1212,256,121418,Дніпропетровська область
3148,121419,2244,32,1468,1244,224,121419,Дніпропетровська область
3149,121420,2129,37,1378,1149,229,121420,Дніпропетровська область
3150,121421,2276,34,1485,1319,166,121421,Дніпропетровська область
3151,121422,2029,27,1463,1197,266,121422,Дніпропетровська область
3152,121423,2230,35,1489,1262,227,121423,Дніпропетровська область
3153,121424,2079,37,1446,1254,192,121424,Дніпропетровська область
3154,121425,2170,20,1414,1230,184,121425,Дніпропетровська область
3155,121426,2065,35,1385,1178,207,121426,Дніпропетровська область
3156,121427,2159,37,1446,1232,214,121427,Дніпропетровська область
3157,121428,2090,31,1357,1153,204,121428,Дніпропетровська область
3158,121429,2164,30,1458,1257,201,121429,Дніпропетровська область
3159,121430,2173,46,1479,1291,188,121430,Дніпропетровська область
3160,121431,1998,42,1361,1169,192,121431,Дніпропетровська область
3161,121432,1650,24,1153,992,161,121432,Дніпропетровська область
3162,121433,2077,25,1434,1197,237,121433,Дніпропетровська область
3163,121434,1997,30,1382,1173,209,121434,Дніпропетровська область
3164,121435,2080,38,1419,1191,228,121435,Дніпропетровська область
3165,121436,1862,28,1297,1104,193,121436,Дніпропетровська область
3166,121437,2078,30,1423,1186,237,121437,Дніпропетровська область
3167,121438,1203,15,785,679,106,121438,Дніпропетровська область
3168,121439,130,6,118,110,8,121439,Дніпропетровська область
3169,121440,776,17,746,641,105,121440,Дніпропетровська область
3170,121441,211,3,207,184,23,121441,Дніпропетровська область
3171,121442,290,4,284,256,28,121442,Дніпропетровська область
3172,121443,616,17,594,565,29,121443,Дніпропетровська область
3173,120103,2268,31,1392,1261,131,120103,Дніпропетровська область
3174,120104,2448,27,1477,1341,136,120104,Дніпропетровська область
3175,120105,2401,24,1333,1203,130,120105,Дніпропетровська область
3176,120106,2468,31,1538,1347,191,120106,Дніпропетровська область
3177,120107,2393,36,1431,1291,140,120107,Дніпропетровська область
3178,120108,2112,29,1309,1181,128,120108,Дніпропетровська область
3179,120109,2342,37,1529,1334,195,120109,Дніпропетровська область
3180,120110,1751,18,1121,1011,110,120110,Дніпропетровська область
3181,120111,1071,6,661,594,67,120111,Дніпропетровська область
3182,120112,1987,30,1193,1040,153,120112,Дніпропетровська область
3183,120113,999,21,656,572,84,120113,Дніпропетровська область
3184,120114,1000,16,569,527,42,120114,Дніпропетровська область
3185,120115,1714,29,1179,945,234,120115,Дніпропетровська область
3186,120116,1543,31,1081,900,181,120116,Дніпропетровська область
3187,120118,1838,22,1306,1082,224,120118,Дніпропетровська область
3188,120119,1609,34,1066,903,163,120119,Дніпропетровська область
3189,120120,1410,18,993,860,133,120120,Дніпропетровська область
3190,120121,722,14,506,457,49,120121,Дніпропетровська область
3191,120122,2241,29,1436,1331,105,120122,Дніпропетровська область
3192,120123,1375,23,790,720,70,120123,Дніпропетровська область
3193,120124,1188,14,731,663,68,120124,Дніпропетровська область
3194,120125,1003,11,569,518,51,120125,Дніпропетровська область
3195,120126,995,10,547,511,36,120126,Дніпропетровська область
3196,120127,1062,17,634,566,68,120127,Дніпропетровська область
3197,120128,1627,36,1033,938,95,120128,Дніпропетровська область
3198,120129,934,6,612,573,39,120129,Дніпропетровська область
3199,120130,1591,14,993,864,129,120130,Дніпропетровська область
3200,120131,852,11,530,465,65,120131,Дніпропетровська область
3201,120132,1256,12,912,820,92,120132,Дніпропетровська область
3202,120133,456,3,290,267,23,120133,Дніпропетровська область
3203,120134,796,11,510,444,66,120134,Дніпропетровська область
3204,120135,944,8,591,531,60,120135,Дніпропетровська область
3205,120136,2063,15,1314,1250,64,120136,Дніпропетровська область
3206,120137,1964,23,1224,1121,103,120137,Дніпропетровська область
3207,120138,1089,12,661,597,64,120138,Дніпропетровська область
3208,120139,849,5,515,479,36,120139,Дніпропетровська область
3209,120140,408,4,248,219,29,120140,Дніпропетровська область
3210,120141,647,13,398,341,57,120141,Дніпропетровська область
3211,120143,2425,24,1615,1438,177,120143,Дніпропетровська область
3212,120144,2303,37,1476,1292,184,120144,Дніпропетровська область
3213,120145,1630,26,1036,901,135,120145,Дніпропетровська область
3214,120146,2022,36,1440,1183,257,120146,Дніпропетровська область
3215,120378,1314,18,878,753,125,120378,Дніпропетровська область
3216,120379,1311,21,896,706,190,120379,Дніпропетровська область
3217,120380,1156,14,748,632,116,120380,Дніпропетровська область
3218,120381,1517,15,955,844,111,120381,Дніпропетровська область
3219,120382,1747,28,1032,903,129,120382,Дніпропетровська область
3220,120383,613,9,318,282,36,120383,Дніпропетровська область
3221,120384,1031,12,650,593,57,120384,Дніпропетровська область
3222,120385,1499,17,1015,820,195,120385,Дніпропетровська область
3223,120386,1489,28,882,801,81,120386,Дніпропетровська область
3224,120387,284,3,207,182,25,120387,Дніпропетровська область
3225,120388,2362,37,1472,1290,182,120388,Дніпропетровська область
3226,120389,2312,52,1469,1255,214,120389,Дніпропетровська область
3227,120390,968,23,613,497,116,120390,Дніпропетровська область
3228,120391,2242,19,1507,1272,235,120391,Дніпропетровська область
3229,121046,2097,25,1328,1193,135,121046,Дніпропетровська область
3230,121047,1694,28,1005,891,114,121047,Дніпропетровська область
3231,121048,2312,16,1460,1333,127,121048,Дніпропетровська область
3232,121049,2181,24,1386,1230,156,121049,Дніпропетровська область
3233,121050,2431,13,1538,1305,233,121050,Дніпропетровська область
3234,121051,2286,35,1444,1304,140,121051,Дніпропетровська область
3235,121052,2390,28,1454,1331,123,121052,Дніпропетровська область
3236,121053,2283,25,1499,1360,139,121053,Дніпропетровська область
3237,121054,2336,27,1410,1250,160,121054,Дніпропетровська область
3238,121055,2273,25,1416,1261,155,121055,Дніпропетровська область
3239,121056,2232,32,1541,1279,262,121056,Дніпропетровська область
3240,121057,2169,30,1483,1249,234,121057,Дніпропетровська область
3241,121058,2266,32,1621,1346,275,121058,Дніпропетровська область
3242,121065,2192,34,1330,1206,124,121065,Дніпропетровська область
3243,121066,2320,30,1540,1348,192,121066,Дніпропетровська область
3244,121067,2229,46,1389,1204,185,121067,Дніпропетровська область
3245,121068,2133,23,1372,1260,112,121068,Дніпропетровська область
3246,121069,1859,25,1162,1047,115,121069,Дніпропетровська область
3247,121070,1822,20,1264,1101,163,121070,Дніпропетровська область
3248,121078,2163,32,1506,1321,185,121078,Дніпропетровська область
3249,121079,2206,26,1505,1287,218,121079,Дніпропетровська область
3250,121080,2062,30,1471,1281,190,121080,Дніпропетровська область
3251,121081,2205,37,1482,1307,175,121081,Дніпропетровська область
3252,121082,2060,36,1440,1249,191,121082,Дніпропетровська область
3253,121083,2118,37,1493,1301,192,121083,Дніпропетровська область
3254,121085,1861,18,1245,1106,139,121085,Дніпропетровська область
3255,121086,790,14,543,473,70,121086,Дніпропетровська область
3256,121104,70,3,67,65,2,121104,Дніпропетровська область
3257,121781,1355,31,772,683,89,121781,Дніпропетровська область
3258,121784,1720,29,1197,987,210,121784,Дніпропетровська область
3259,120948,2333,30,1335,1218,117,120948,Дніпропетровська область
3260,120949,2416,15,1406,1303,103,120949,Дніпропетровська область
3261,120950,2112,21,1237,1153,84,120950,Дніпропетровська область
3262,120951,2272,30,1354,1256,98,120951,Дніпропетровська область
3263,120952,1165,9,707,673,34,120952,Дніпропетровська область
3264,120953,1633,23,944,873,71,120953,Дніпропетровська область
3265,120954,1880,27,1131,1022,109,120954,Дніпропетровська область
3266,120955,2180,34,1332,1227,105,120955,Дніпропетровська область
3267,120956,2064,28,1257,1134,123,120956,Дніпропетровська область
3268,120957,2124,27,1278,1174,104,120957,Дніпропетровська область
3269,120958,2171,31,1389,1284,105,120958,Дніпропетровська область
3270,120959,2172,33,1294,1166,128,120959,Дніпропетровська область
3271,120960,2116,29,1327,1188,139,120960,Дніпропетровська область
3272,120961,2232,27,1409,1308,101,120961,Дніпропетровська область
3273,120962,2221,18,1342,1250,92,120962,Дніпропетровська область
3274,120963,2233,30,1296,1211,85,120963,Дніпропетровська область
3275,120964,2281,20,1373,1273,100,120964,Дніпропетровська область
3276,120965,2110,23,1383,1244,139,120965,Дніпропетровська область
3277,120966,2109,34,1310,1188,122,120966,Дніпропетровська область
3278,120967,2247,29,1446,1341,105,120967,Дніпропетровська область
3279,120968,1986,27,1314,1204,110,120968,Дніпропетровська область
3280,120969,1917,13,1245,1122,123,120969,Дніпропетровська область
3281,120970,2219,35,1508,1381,127,120970,Дніпропетровська область
3282,120971,1643,19,1047,972,75,120971,Дніпропетровська область
3283,120972,1666,29,1044,980,64,120972,Дніпропетровська область
3284,120973,1863,11,1184,1097,87,120973,Дніпропетровська область
3285,120974,1767,28,970,928,42,120974,Дніпропетровська область
3286,120975,1795,24,1104,1015,89,120975,Дніпропетровська область
3287,120976,1673,18,1059,978,81,120976,Дніпропетровська область
3288,120977,53,0,53,38,15,120977,Дніпропетровська область
3289,120978,118,6,104,91,13,120978,Дніпропетровська область
3290,120979,2304,30,1450,1345,105,120979,Дніпропетровська область
3291,120980,1877,22,1188,1100,88,120980,Дніпропетровська область
3292,120981,2324,28,1539,1399,140,120981,Дніпропетровська область
3293,120982,1779,32,1152,1045,107,120982,Дніпропетровська область
3294,120983,1852,34,1233,1110,123,120983,Дніпропетровська область
3295,120984,2035,27,1289,1151,138,120984,Дніпропетровська область
3296,120985,2334,41,1574,1361,213,120985,Дніпропетровська область
3297,120986,2020,24,1382,1256,126,120986,Дніпропетровська область
3298,120987,2126,43,1419,1291,128,120987,Дніпропетровська область
3299,120988,2095,30,1354,1185,169,120988,Дніпропетровська область
3300,120989,2139,26,1465,1328,137,120989,Дніпропетровська область
3301,120990,1624,31,1047,951,96,120990,Дніпропетровська область
3302,120991,1870,33,1276,1182,94,120991,Дніпропетровська область
3303,120992,1953,26,1148,1061,87,120992,Дніпропетровська область
3304,120993,1574,19,1041,948,93,120993,Дніпропетровська область
3305,120994,1543,20,974,907,67,120994,Дніпропетровська область
3306,120995,1976,26,1260,1171,89,120995,Дніпропетровська область
3307,120996,2193,26,1414,1296,118,120996,Дніпропетровська область
3308,120997,1931,20,1311,1204,107,120997,Дніпропетровська область
3309,120998,1574,16,1065,979,86,120998,Дніпропетровська область
3310,120999,1765,20,1125,1017,108,120999,Дніпропетровська область
3311,121000,2082,27,1392,1271,121,121000,Дніпропетровська область
3312,121001,1918,31,1273,1178,95,121001,Дніпропетровська область
3313,121002,1985,31,1339,1226,113,121002,Дніпропетровська область
3314,121003,2122,25,1333,1188,145,121003,Дніпропетровська область
3315,121004,1731,10,1109,988,121,121004,Дніпропетровська область
3316,121005,2160,29,1478,1363,115,121005,Дніпропетровська область
3317,121006,1965,18,1330,1206,124,121006,Дніпропетровська область
3318,121007,2100,17,1430,1294,136,121007,Дніпропетровська область
3319,121008,1883,21,1211,1096,115,121008,Дніпропетровська область
3320,121009,2216,40,1455,1302,153,121009,Дніпропетровська область
3321,121010,2088,30,1371,1250,121,121010,Дніпропетровська область
3322,121012,2129,26,1228,1104,124,121012,Дніпропетровська область
3323,121013,2284,44,1226,1109,117,121013,Дніпропетровська область
3324,121014,2295,37,1369,1248,121,121014,Дніпропетровська область
3325,121015,2242,33,1477,1309,168,121015,Дніпропетровська область
3326,121016,2310,36,1455,1307,148,121016,Дніпропетровська область
3327,121017,2127,47,1418,1227,191,121017,Дніпропетровська область
3328,121018,2236,38,1431,1272,159,121018,Дніпропетровська область
3329,121019,2091,29,1246,1135,111,121019,Дніпропетровська область
3330,121020,2178,34,1250,1141,109,121020,Дніпропетровська область
3331,121021,2155,39,1377,1233,144,121021,Дніпропетровська область
3332,121028,2195,21,1362,1262,100,121028,Дніпропетровська область
3333,121030,2108,35,1291,1177,114,121030,Дніпропетровська область
3334,121036,2186,28,1351,1254,97,121036,Дніпропетровська область
3335,121037,2293,22,1391,1283,108,121037,Дніпропетровська область
3336,121038,1401,21,882,822,60,121038,Дніпропетровська область
3337,121040,252,10,242,206,36,121040,Дніпропетровська область
3338,121041,93,5,88,84,4,121041,Дніпропетровська область
3339,121042,228,5,223,209,14,121042,Дніпропетровська область
3340,121043,67,1,63,57,6,121043,Дніпропетровська область
3341,1,590,28,553,545,8,1,Дніпропетровська область
3342,121554,2005,30,1317,1200,117,121554,Дніпропетровська область
3343,121555,1587,17,1105,1019,86,121555,Дніпропетровська область
3344,121556,1748,12,1223,1127,96,121556,Дніпропетровська область
3345,121557,2204,24,1445,1308,137,121557,Дніпропетровська область
3346,121558,1773,20,1210,1127,83,121558,Дніпропетровська область
3347,121559,1799,14,1255,1137,118,121559,Дніпропетровська область
3348,121560,1776,19,1191,1080,111,121560,Дніпропетровська область
3349,121561,1659,16,1180,1067,113,121561,Дніпропетровська область
3350,121562,1512,18,1058,963,95,121562,Дніпропетровська область
3351,121563,1447,9,1017,940,77,121563,Дніпропетровська область
3352,121564,2060,23,1415,1290,125,121564,Дніпропетровська область
3353,121565,1479,12,1050,932,118,121565,Дніпропетровська область
3354,121566,1588,11,1051,936,115,121566,Дніпропетровська область
3355,121567,1582,11,1093,1019,74,121567,Дніпропетровська область
3356,121568,1959,24,1342,1225,117,121568,Дніпропетровська область
3357,121569,1639,22,1144,1019,125,121569,Дніпропетровська область
3358,121570,2009,27,1435,1302,133,121570,Дніпропетровська область
3359,121571,1498,11,1057,964,93,121571,Дніпропетровська область
3360,121572,1749,27,1226,1126,100,121572,Дніпропетровська область
3361,121573,2059,12,1358,1228,130,121573,Дніпропетровська область
3362,121574,2132,19,1458,1339,119,121574,Дніпропетровська область
3363,121575,2056,21,1450,1321,129,121575,Дніпропетровська область
3364,121576,2090,19,1426,1286,140,121576,Дніпропетровська область
3365,121577,2107,25,1472,1302,170,121577,Дніпропетровська область
3366,121578,1897,11,1275,1165,110,121578,Дніпропетровська область
3367,121579,2061,41,1400,1303,97,121579,Дніпропетровська область
3368,121580,1869,13,1325,1197,128,121580,Дніпропетровська область
3369,121581,2122,24,1525,1397,128,121581,Дніпропетровська область
3370,121582,2145,21,1420,1287,133,121582,Дніпропетровська область
3371,121583,1664,28,1128,1019,109,121583,Дніпропетровська область
3372,121584,1835,17,1202,1085,117,121584,Дніпропетровська область
3373,121585,1786,13,1211,1104,107,121585,Дніпропетровська область
3374,121586,1921,25,1289,1193,96,121586,Дніпропетровська область
3375,121587,1739,30,1165,1089,76,121587,Дніпропетровська область
3376,121588,1969,30,1392,1254,138,121588,Дніпропетровська область
3377,121589,2077,24,1440,1297,143,121589,Дніпропетровська область
3378,121590,1598,14,1126,995,131,121590,Дніпропетровська область
3379,121591,1706,11,1158,1052,106,121591,Дніпропетровська область
3380,121592,1798,20,1238,1139,99,121592,Дніпропетровська область
3381,121593,2081,26,1404,1262,142,121593,Дніпропетровська область
3382,121594,1506,13,962,893,69,121594,Дніпропетровська область
3383,121595,1638,19,1082,981,101,121595,Дніпропетровська область
3384,121596,1653,22,1124,1036,88,121596,Дніпропетровська область
3385,121597,1857,20,1210,1132,78,121597,Дніпропетровська область
3386,121598,1854,20,1246,1142,104,121598,Дніпропетровська область
3387,121599,1931,21,1294,1199,95,121599,Дніпропетровська область
3388,121600,2121,20,1439,1332,107,121600,Дніпропетровська область
3389,121601,2021,21,1393,1282,111,121601,Дніпропетровська область
3390,121602,2203,17,1434,1315,119,121602,Дніпропетровська область
3391,121603,2215,27,1560,1372,188,121603,Дніпропетровська область
3392,121604,2025,27,1460,1309,151,121604,Дніпропетровська область
3393,121605,2147,30,1480,1360,120,121605,Дніпропетровська область
3394,121606,2225,24,1544,1400,144,121606,Дніпропетровська область
3395,121607,121,2,119,107,12,121607,Дніпропетровська область
3396,121608,93,2,90,87,3,121608,Дніпропетровська область
3397,121609,141,3,138,126,12,121609,Дніпропетровська область
3398,121610,221,16,204,183,21,121610,Дніпропетровська область
3399,121694,1752,20,1155,1061,94,121694,Дніпропетровська область
3400,121695,1676,16,1073,990,83,121695,Дніпропетровська область
3401,121696,1825,17,1212,1120,92,121696,Дніпропетровська область
3402,121697,2157,27,1471,1357,114,121697,Дніпропетровська область
3403,121698,2012,32,1401,1292,109,121698,Дніпропетровська область
3404,121699,2010,22,1345,1240,105,121699,Дніпропетровська область
3405,121700,2088,20,1432,1300,132,121700,Дніпропетровська область
3406,121701,2194,37,1565,1350,215,121701,Дніпропетровська область
3407,121702,2027,14,1462,1322,140,121702,Дніпропетровська область
3408,121703,2185,27,1435,1308,127,121703,Дніпропетровська область
3409,121704,1936,28,1380,1267,113,121704,Дніпропетровська область
3410,121705,1853,38,1319,1199,120,121705,Дніпропетровська область
3411,121706,1701,19,1174,1068,106,121706,Дніпропетровська область
3412,121707,2021,35,1397,1255,142,121707,Дніпропетровська область
3413,121708,2031,30,1435,1310,125,121708,Дніпропетровська область
3414,121709,2080,30,1358,1249,109,121709,Дніпропетровська область
3415,121710,1186,11,793,725,68,121710,Дніпропетровська область
3416,121711,1581,17,1003,923,80,121711,Дніпропетровська область
3417,121712,1514,15,1073,982,91,121712,Дніпропетровська область
3418,121713,1489,9,991,895,96,121713,Дніпропетровська область
3419,121714,1704,35,1174,1077,97,121714,Дніпропетровська область
3420,121715,1635,17,1099,1003,96,121715,Дніпропетровська область
3421,121716,1861,23,1292,1155,137,121716,Дніпропетровська область
3422,121717,1102,51,678,626,52,121717,Дніпропетровська область
3423,121718,1688,29,1107,970,137,121718,Дніпропетровська область
3424,121719,1475,21,1026,927,99,121719,Дніпропетровська область
3425,121720,2069,24,1328,1216,112,121720,Дніпропетровська область
3426,121721,1804,21,1218,1098,120,121721,Дніпропетровська область
3427,121722,2046,16,1446,1302,144,121722,Дніпропетровська область
3428,121723,2121,17,1333,1246,87,121723,Дніпропетровська область
3429,121724,456,2,246,226,20,121724,Дніпропетровська область
3430,121725,2106,24,1422,1311,111,121725,Дніпропетровська область
3431,121726,1983,19,1293,1179,114,121726,Дніпропетровська область
3432,121727,1927,24,1350,1253,97,121727,Дніпропетровська область
3433,121728,1028,7,691,603,88,121728,Дніпропетровська область
3434,121730,41,2,39,36,3,121730,Дніпропетровська область
3435,121731,143,2,140,130,10,121731,Дніпропетровська область
3436,121732,77,0,76,71,5,121732,Дніпропетровська область
3437,121733,51,0,51,48,3,121733,Дніпропетровська область
3438,121780,121,0,120,115,5,121780,Дніпропетровська область
3439,121512,2224,8,1509,1409,100,121512,Дніпропетровська область
3440,121513,1607,10,1011,929,82,121513,Дніпропетровська область
3441,121514,1894,16,1190,1116,74,121514,Дніпропетровська область
3442,121515,1871,15,1165,1068,97,121515,Дніпропетровська область
3443,121516,1660,23,1090,1013,77,121516,Дніпропетровська область
3444,121517,2224,22,1553,1431,122,121517,Дніпропетровська область
3445,121518,2163,23,1616,1503,113,121518,Дніпропетровська область
3446,121519,1793,24,1284,1202,82,121519,Дніпропетровська область
3447,121520,1830,16,1297,1208,89,121520,Дніпропетровська область
3448,121521,1772,36,1203,1103,100,121521,Дніпропетровська область
3449,121522,1361,16,951,855,96,121522,Дніпропетровська область
3450,121523,2025,20,1327,1220,107,121523,Дніпропетровська область
3451,121524,1976,19,1294,1197,97,121524,Дніпропетровська область
3452,121525,1543,10,1034,950,84,121525,Дніпропетровська область
3453,121526,1698,16,1228,1114,114,121526,Дніпропетровська область
3454,121527,2142,20,1522,1397,125,121527,Дніпропетровська область
3455,121528,1922,30,1360,1244,116,121528,Дніпропетровська область
3456,121529,1560,15,1089,989,100,121529,Дніпропетровська область
3457,121530,1848,12,1321,1220,101,121530,Дніпропетровська область
3458,121531,2088,18,1470,1270,200,121531,Дніпропетровська область
3459,121532,2127,30,1430,1292,138,121532,Дніпропетровська область
3460,121533,1095,16,762,682,80,121533,Дніпропетровська область
3461,121534,1644,19,1166,1055,111,121534,Дніпропетровська область
3462,121535,1268,17,871,783,88,121535,Дніпропетровська область
3463,121536,1864,19,1265,1148,117,121536,Дніпропетровська область
3464,121537,1133,14,771,707,64,121537,Дніпропетровська область
3465,121538,2021,10,1381,1262,119,121538,Дніпропетровська область
3466,121539,1104,3,745,681,64,121539,Дніпропетровська область
3467,121540,1817,19,1253,1159,94,121540,Дніпропетровська область
3468,121541,1913,17,1357,1235,122,121541,Дніпропетровська область
3469,121542,1945,22,1365,1241,124,121542,Дніпропетровська область
3470,121543,1895,21,1299,1198,101,121543,Дніпропетровська область
3471,121544,1809,23,1247,1162,85,121544,Дніпропетровська область
3472,121545,2252,16,1480,1352,128,121545,Дніпропетровська область
3473,121546,2046,28,1415,1283,132,121546,Дніпропетровська область
3474,121547,2204,25,1527,1406,121,121547,Дніпропетровська область
3475,121548,2089,24,1465,1370,95,121548,Дніпропетровська область
3476,121549,2268,17,1535,1387,148,121549,Дніпропетровська область
3477,121550,2143,28,1499,1376,123,121550,Дніпропетровська область
3478,121551,2155,30,1485,1350,135,121551,Дніпропетровська область
3479,121552,61,4,57,50,7,121552,Дніпропетровська область
3480,121553,245,6,233,192,41,121553,Дніпропетровська область
3481,121638,1616,18,1131,1044,87,121638,Дніпропетровська область
3482,121639,1639,14,1039,941,98,121639,Дніпропетровська область
3483,121640,1584,25,1083,994,89,121640,Дніпропетровська область
3484,121641,1706,22,1112,1006,106,121641,Дніпропетровська область
3485,121642,1473,13,937,869,68,121642,Дніпропетровська область
3486,121643,1958,19,1369,1248,121,121643,Дніпропетровська область
3487,121644,1950,23,1381,1238,143,121644,Дніпропетровська область
3488,121645,2135,25,1496,1351,145,121645,Дніпропетровська область
3489,121646,1672,21,1158,1031,127,121646,Дніпропетровська область
3490,121647,2118,18,1337,1233,104,121647,Дніпропетровська область
3491,121648,2136,30,1453,1317,136,121648,Дніпропетровська область
3492,121649,2021,20,1437,1281,156,121649,Дніпропетровська область
3493,121650,2010,23,1359,1237,122,121650,Дніпропетровська область
3494,121651,2004,36,1329,1211,118,121651,Дніпропетровська область
3495,121652,1848,19,1267,1140,127,121652,Дніпропетровська область
3496,121653,1763,19,1230,1104,126,121653,Дніпропетровська область
3497,121654,1610,27,1134,1039,95,121654,Дніпропетровська область
3498,121655,1979,37,1355,1238,117,121655,Дніпропетровська область
3499,121656,1908,21,1295,1162,133,121656,Дніпропетровська область
3500,121657,1920,26,1425,1288,137,121657,Дніпропетровська область
3501,121658,1894,20,1331,1232,99,121658,Дніпропетровська область
3502,121659,2140,18,1497,1363,134,121659,Дніпропетровська область
3503,121660,2186,20,1543,1398,145,121660,Дніпропетровська область
3504,121661,1974,17,1359,1255,104,121661,Дніпропетровська область
3505,121662,2000,24,1417,1311,106,121662,Дніпропетровська область
3506,121663,2060,27,1426,1292,134,121663,Дніпропетровська область
3507,121664,2086,22,1431,1299,132,121664,Дніпропетровська область
3508,121665,1906,27,1337,1221,116,121665,Дніпропетровська область
3509,121666,1884,31,1278,1180,98,121666,Дніпропетровська область
3510,121667,1960,28,1371,1234,137,121667,Дніпропетровська область
3511,121668,2044,33,1431,1308,123,121668,Дніпропетровська область
3512,121669,2031,29,1394,1274,120,121669,Дніпропетровська область
3513,121670,2013,21,1394,1279,115,121670,Дніпропетровська область
3514,121671,2042,20,1375,1253,122,121671,Дніпропетровська область
3515,121672,2035,22,1436,1335,101,121672,Дніпропетровська область
3516,121673,2189,15,1502,1391,111,121673,Дніпропетровська область
3517,121674,1990,25,1320,1226,94,121674,Дніпропетровська область
3518,121675,2102,21,1449,1345,104,121675,Дніпропетровська область
3519,121676,1945,22,1337,1233,104,121676,Дніпропетровська область
3520,121677,1850,28,1181,1083,98,121677,Дніпропетровська область
3521,121678,1834,21,1289,1195,94,121678,Дніпропетровська область
3522,121679,1788,21,1200,1050,150,121679,Дніпропетровська область
3523,121680,2268,24,1582,1425,157,121680,Дніпропетровська область
3524,121681,2162,21,1553,1410,143,121681,Дніпропетровська область
3525,121682,1958,22,1338,1213,125,121682,Дніпропетровська область
3526,121683,1658,22,1133,1028,105,121683,Дніпропетровська область
3527,121690,80,0,80,75,5,121690,Дніпропетровська область
3528,121691,273,1,270,248,22,121691,Дніпропетровська область
3529,121692,120,2,118,110,8,121692,Дніпропетровська область
3530,121693,35,0,35,33,2,121693,Дніпропетровська область
3531,121788,67,1,66,58,8,121788,Дніпропетровська область
3532,121482,1722,28,1102,1004,98,121482,Дніпропетровська область
3533,121483,1354,16,876,795,81,121483,Дніпропетровська область
3534,121484,1536,13,1041,958,83,121484,Дніпропетровська область
3535,121485,1491,10,993,886,107,121485,Дніпропетровська область
3536,121486,1749,23,1207,1086,121,121486,Дніпропетровська область
3537,121487,1921,26,1312,1184,128,121487,Дніпропетровська область
3538,121488,1261,18,856,758,98,121488,Дніпропетровська область
3539,121489,1902,31,1330,1176,154,121489,Дніпропетровська область
3540,121490,1905,49,1331,1179,152,121490,Дніпропетровська область
3541,121491,1575,20,1115,1004,111,121491,Дніпропетровська область
3542,121492,2224,28,1442,1311,131,121492,Дніпропетровська область
3543,121493,1889,22,1337,1202,135,121493,Дніпропетровська область
3544,121494,1789,26,1260,1120,140,121494,Дніпропетровська область
3545,121495,1727,26,1164,1047,117,121495,Дніпропетровська область
3546,121496,1263,13,859,770,89,121496,Дніпропетровська область
3547,121497,1136,13,805,705,100,121497,Дніпропетровська область
3548,121498,1361,11,921,836,85,121498,Дніпропетровська область
3549,121499,1399,8,919,845,74,121499,Дніпропетровська область
3550,121500,2175,20,1361,1238,123,121500,Дніпропетровська область
3551,121501,2191,26,1290,1220,70,121501,Дніпропетровська область
3552,121502,915,3,666,633,33,121502,Дніпропетровська область
3553,121503,1503,12,977,906,71,121503,Дніпропетровська область
3554,121504,2219,30,1500,1400,100,121504,Дніпропетровська область
3555,121505,2217,24,1519,1398,121,121505,Дніпропетровська область
3556,121506,1675,25,1125,1026,99,121506,Дніпропетровська область
3557,121507,1885,21,1200,1094,106,121507,Дніпропетровська область
3558,121508,64,1,63,55,8,121508,Дніпропетровська область
3559,121509,40,3,37,36,1,121509,Дніпропетровська область
3560,121510,28,0,28,21,7,121510,Дніпропетровська область
3561,121511,655,39,616,597,19,121511,Дніпропетровська область
3562,121611,2018,21,1380,1298,82,121611,Дніпропетровська область
3563,121612,1926,19,1352,1239,113,121612,Дніпропетровська область
3564,121613,1571,24,1106,1011,95,121613,Дніпропетровська область
3565,121614,1615,24,1150,1053,97,121614,Дніпропетровська область
3566,121615,1595,21,1121,1014,107,121615,Дніпропетровська область
3567,121616,1677,15,1077,1009,68,121616,Дніпропетровська область
3568,121617,1781,10,1243,1160,83,121617,Дніпропетровська область
3569,121618,1863,13,1330,1239,91,121618,Дніпропетровська область
3570,121619,2058,15,1328,1243,85,121619,Дніпропетровська область
3571,121636,90,1,89,83,6,121636,Дніпропетровська область
3572,121684,1918,26,1295,1150,145,121684,Дніпропетровська область
3573,121685,2018,23,1365,1197,168,121685,Дніпропетровська область
3574,121686,1908,29,1288,1144,144,121686,Дніпропетровська область
3575,121687,1508,27,1043,912,131,121687,Дніпропетровська область
3576,121688,1544,23,1024,901,123,121688,Дніпропетровська область
3577,121689,1521,26,1044,921,123,121689,Дніпропетровська область
3578,121734,1072,7,769,737,32,121734,Дніпропетровська область
3579,121735,1047,5,616,566,50,121735,Дніпропетровська область
3580,121736,1663,18,1044,975,69,121736,Дніпропетровська область
3581,121737,1811,29,1159,1071,88,121737,Дніпропетровська область
3582,121738,1669,19,1180,1080,100,121738,Дніпропетровська область
3583,121739,2010,29,1321,1178,143,121739,Дніпропетровська область
3584,121740,1375,15,861,780,81,121740,Дніпропетровська область
3585,121741,1995,18,1337,1240,97,121741,Дніпропетровська область
3586,121742,1812,28,1236,1087,149,121742,Дніпропетровська область
3587,121743,1760,19,1206,1100,106,121743,Дніпропетровська область
3588,121744,1741,31,1225,1085,140,121744,Дніпропетровська область
3589,121745,2273,27,1448,1326,122,121745,Дніпропетровська область
3590,121746,1683,24,1233,1122,111,121746,Дніпропетровська область
3591,121747,1754,17,1165,1077,88,121747,Дніпропетровська область
3592,121748,1810,20,1267,1170,97,121748,Дніпропетровська область
3593,121749,1898,22,1328,1218,110,121749,Дніпропетровська область
3594,121750,2048,14,1459,1339,120,121750,Дніпропетровська область
3595,121751,2040,27,1418,1308,110,121751,Дніпропетровська область
3596,121752,2041,33,1335,1256,79,121752,Дніпропетровська область
3597,121753,848,4,516,494,22,121753,Дніпропетровська область
3598,121754,1111,7,705,662,43,121754,Дніпропетровська область
3599,121756,2006,26,1299,1165,134,121756,Дніпропетровська область
3600,121757,1974,36,1326,1164,162,121757,Дніпропетровська область
3601,121758,1848,27,1141,1053,88,121758,Дніпропетровська область
3602,121759,2144,24,1410,1289,121,121759,Дніпропетровська область
3603,121760,1740,24,1085,1008,77,121760,Дніпропетровська область
3604,121761,1941,28,1316,1193,123,121761,Дніпропетровська область
3605,121762,1441,25,1065,960,105,121762,Дніпропетровська область
3606,121763,1416,16,894,844,50,121763,Дніпропетровська область
3607,121764,1256,6,810,770,40,121764,Дніпропетровська область
3608,121765,1710,20,1112,957,155,121765,Дніпропетровська область
3609,121766,1803,11,1217,1088,129,121766,Дніпропетровська область
3610,121767,1641,23,1113,979,134,121767,Дніпропетровська область
3611,121768,1607,31,999,875,124,121768,Дніпропетровська область
3612,121769,1175,21,762,657,105,121769,Дніпропетровська область
3613,121770,1421,23,947,823,124,121770,Дніпропетровська область
3614,121771,1450,11,895,825,70,121771,Дніпропетровська область
3615,121772,1797,19,1205,1074,131,121772,Дніпропетровська область
3616,121773,1448,21,989,853,136,121773,Дніпропетровська область
3617,121774,1753,26,1207,1073,134,121774,Дніпропетровська область
3618,121775,68,1,66,64,2,121775,Дніпропетровська область
3619,121776,102,1,101,86,15,121776,Дніпропетровська область
3620,120062,1797,29,1046,917,129,120062,Дніпропетровська область
3621,120063,1624,23,1072,950,122,120063,Дніпропетровська область
3622,120064,1973,23,1215,1091,124,120064,Дніпропетровська область
3623,120065,2081,29,1325,1187,138,120065,Дніпропетровська область
3624,120066,676,7,402,364,38,120066,Дніпропетровська область
3625,120067,2183,25,1313,1227,86,120067,Дніпропетровська область
3626,120068,1049,8,655,609,46,120068,Дніпропетровська область
3627,120069,982,12,569,512,57,120069,Дніпропетровська область
3628,120070,2220,23,1240,1161,79,120070,Дніпропетровська область
3629,120071,2185,20,1142,1069,73,120071,Дніпропетровська область
3630,120072,1722,15,992,893,99,120072,Дніпропетровська область
3631,120073,1102,9,613,567,46,120073,Дніпропетровська область
3632,120074,224,3,136,122,14,120074,Дніпропетровська область
3633,120075,533,0,278,246,32,120075,Дніпропетровська область
3634,120076,1908,21,1233,1137,96,120076,Дніпропетровська область
3635,120077,2032,22,1307,1180,127,120077,Дніпропетровська область
3636,120078,1731,7,1006,943,63,120078,Дніпропетровська область
3637,120079,1492,28,909,848,61,120079,Дніпропетровська область
3638,120080,957,7,453,415,38,120080,Дніпропетровська область
3639,120081,204,3,147,134,13,120081,Дніпропетровська область
3640,120082,345,2,215,194,21,120082,Дніпропетровська область
3641,120083,520,3,315,288,27,120083,Дніпропетровська область
3642,120084,722,7,411,380,31,120084,Дніпропетровська область
3643,120085,305,6,156,127,29,120085,Дніпропетровська область
3644,120086,457,4,304,253,51,120086,Дніпропетровська область
3645,120087,183,2,104,91,13,120087,Дніпропетровська область
3646,120088,648,6,364,324,40,120088,Дніпропетровська область
3647,120089,614,7,420,371,49,120089,Дніпропетровська область
3648,120090,576,3,364,332,32,120090,Дніпропетровська область
3649,120091,391,7,214,179,35,120091,Дніпропетровська область
3650,120092,236,0,128,111,17,120092,Дніпропетровська область
3651,120093,225,1,142,125,17,120093,Дніпропетровська область
3652,120094,370,2,198,189,9,120094,Дніпропетровська область
3653,120095,216,3,140,128,12,120095,Дніпропетровська область
3654,120096,1113,4,669,626,43,120096,Дніпропетровська область
3655,120097,284,1,182,172,10,120097,Дніпропетровська область
3656,120098,425,7,204,185,19,120098,Дніпропетровська область
3657,120099,153,2,85,77,8,120099,Дніпропетровська область
3658,120100,1347,17,824,760,64,120100,Дніпропетровська область
3659,120101,1141,9,703,644,59,120101,Дніпропетровська область
3660,120102,98,0,85,74,11,120102,Дніпропетровська область
3661,120441,1306,14,725,666,59,120441,Дніпропетровська область
3662,120442,1931,29,1133,1019,114,120442,Дніпропетровська область
3663,120443,1995,20,1057,958,99,120443,Дніпропетровська область
3664,120444,1959,25,1137,1014,123,120444,Дніпропетровська область
3665,120445,1989,18,1210,1090,120,120445,Дніпропетровська область
3666,120446,1889,17,1034,976,58,120446,Дніпропетровська область
3667,120447,1872,19,986,920,66,120447,Дніпропетровська область
3668,120448,1717,15,1056,982,74,120448,Дніпропетровська область
3669,120449,1437,4,870,818,52,120449,Дніпропетровська область
3670,120450,381,9,216,195,21,120450,Дніпропетровська область
3671,120451,427,7,308,273,35,120451,Дніпропетровська область
3672,120452,434,2,271,242,29,120452,Дніпропетровська область
3673,120453,304,5,165,151,14,120453,Дніпропетровська область
3674,120454,272,7,194,166,28,120454,Дніпропетровська область
3675,120455,319,2,206,190,16,120455,Дніпропетровська область
3676,120456,199,0,136,126,10,120456,Дніпропетровська область
3677,120457,668,3,376,355,21,120457,Дніпропетровська область
3678,120458,643,2,351,304,47,120458,Дніпропетровська область
3679,120459,860,7,447,421,26,120459,Дніпропетровська область
3680,120460,536,9,383,360,23,120460,Дніпропетровська область
3681,120461,1220,9,671,611,60,120461,Дніпропетровська область
3682,120462,607,5,331,305,26,120462,Дніпропетровська область
3683,120463,562,3,367,349,18,120463,Дніпропетровська область
3684,120464,251,3,129,124,5,120464,Дніпропетровська область
3685,120465,770,9,425,396,29,120465,Дніпропетровська область
3686,120466,530,6,292,261,31,120466,Дніпропетровська область
3687,120467,458,2,289,260,29,120467,Дніпропетровська область
3688,120468,581,5,331,302,29,120468,Дніпропетровська область
3689,120469,389,5,237,223,14,120469,Дніпропетровська область
3690,120470,555,6,294,268,26,120470,Дніпропетровська область
3691,120471,675,8,365,342,23,120471,Дніпропетровська область
3692,120472,632,6,458,426,32,120472,Дніпропетровська область
3693,120473,1502,13,829,742,87,120473,Дніпропетровська область
3694,120474,388,2,204,194,10,120474,Дніпропетровська область
3695,120475,232,3,149,127,22,120475,Дніпропетровська область
3696,120476,307,2,236,205,31,120476,Дніпропетровська область
3697,120477,176,1,129,122,7,120477,Дніпропетровська область
3698,120478,348,1,207,191,16,120478,Дніпропетровська область
3699,120479,248,0,181,164,17,120479,Дніпропетровська область
3700,120480,253,10,240,239,1,120480,Дніпропетровська область
3701,120613,1453,18,991,892,99,120613,Дніпропетровська область
3702,120614,1949,27,1392,1208,184,120614,Дніпропетровська область
3703,120615,1222,18,815,727,88,120615,Дніпропетровська область
3704,120616,1270,13,873,786,87,120616,Дніпропетровська область
3705,120617,575,6,372,345,27,120617,Дніпропетровська область
3706,120618,364,2,271,236,35,120618,Дніпропетровська область
3707,120619,1352,13,908,798,110,120619,Дніпропетровська область
3708,120620,472,6,322,277,45,120620,Дніпропетровська область
3709,120621,963,13,543,497,46,120621,Дніпропетровська область
3710,120622,1058,17,691,610,81,120622,Дніпропетровська область
3711,120623,785,7,507,437,70,120623,Дніпропетровська область
3712,120624,1252,8,752,705,47,120624,Дніпропетровська область
3713,120625,508,3,420,352,68,120625,Дніпропетровська область
3714,120626,600,5,383,328,55,120626,Дніпропетровська область
3715,120627,415,5,290,255,35,120627,Дніпропетровська область
3716,120628,1082,10,626,539,87,120628,Дніпропетровська область
3717,120629,661,8,434,394,40,120629,Дніпропетровська область
3718,120630,555,5,439,363,76,120630,Дніпропетровська область
3719,120631,647,4,469,424,45,120631,Дніпропетровська область
3720,120632,371,22,323,297,26,120632,Дніпропетровська область
3721,120633,983,7,658,585,73,120633,Дніпропетровська область
3722,120634,607,3,373,345,28,120634,Дніпропетровська область
3723,120635,511,4,285,269,16,120635,Дніпропетровська область
3724,120682,2130,29,1489,1342,147,120682,Дніпропетровська область
3725,120683,2111,20,1342,1205,137,120683,Дніпропетровська область
3726,120684,2252,20,1451,1332,119,120684,Дніпропетровська область
3727,120685,2142,38,1459,1347,112,120685,Дніпропетровська область
3728,120686,2119,35,1433,1296,137,120686,Дніпропетровська область
3729,120687,2043,28,1361,1240,121,120687,Дніпропетровська область
3730,120688,1791,28,1207,1102,105,120688,Дніпропетровська область
3731,120689,2015,17,1344,1232,112,120689,Дніпропетровська область
3732,120690,1216,9,598,544,54,120690,Дніпропетровська область
3733,120691,1972,23,958,832,126,120691,Дніпропетровська область
3734,120692,2016,27,1211,1045,166,120692,Дніпропетровська область
3735,120693,1864,31,1134,1003,131,120693,Дніпропетровська область
3736,120694,1720,27,1052,926,126,120694,Дніпропетровська область
3737,120695,1666,13,1003,907,96,120695,Дніпропетровська область
3738,120696,1885,18,1161,1031,130,120696,Дніпропетровська область
3739,120697,1586,11,973,866,107,120697,Дніпропетровська область
3740,120698,2066,22,1239,1104,135,120698,Дніпропетровська область
3741,120699,1793,32,1094,958,136,120699,Дніпропетровська область
3742,120700,2136,30,1399,1215,184,120700,Дніпропетровська область
3743,120701,2040,24,1289,1149,140,120701,Дніпропетровська область
3744,120702,1930,24,1215,1072,143,120702,Дніпропетровська область
3745,120703,1661,17,1044,936,108,120703,Дніпропетровська область
3746,120704,1692,25,1033,914,119,120704,Дніпропетровська область
3747,120705,1896,27,1195,1074,121,120705,Дніпропетровська область
3748,120706,1988,16,1283,1160,123,120706,Дніпропетровська область
3749,120707,1901,28,978,898,80,120707,Дніпропетровська область
3750,120708,1734,28,1066,968,98,120708,Дніпропетровська область
3751,120709,1870,26,1189,1067,122,120709,Дніпропетровська область
3752,120710,542,8,329,312,17,120710,Дніпропетровська область
3753,120711,44,2,42,40,2,120711,Дніпропетровська область
3754,120712,585,42,537,514,23,120712,Дніпропетровська область
3755,121778,383,4,251,230,21,121778,Дніпропетровська область
3756,121779,981,9,728,654,74,121779,Дніпропетровська область
3757,120264,1247,11,750,686,64,120264,Дніпропетровська область
3758,120265,1508,23,905,814,91,120265,Дніпропетровська область
3759,120266,1779,23,1112,1011,101,120266,Дніпропетровська область
3760,120267,270,0,173,162,11,120267,Дніпропетровська область
3761,120268,529,2,285,272,13,120268,Дніпропетровська область
3762,120269,414,0,249,244,5,120269,Дніпропетровська область
3763,120270,881,3,473,438,35,120270,Дніпропетровська область
3764,120271,565,2,292,256,36,120271,Дніпропетровська область
3765,120272,986,5,521,476,45,120272,Дніпропетровська область
3766,120273,1064,12,609,542,67,120273,Дніпропетровська область
3767,120274,1530,20,923,830,93,120274,Дніпропетровська область
3768,120275,1146,11,757,677,80,120275,Дніпропетровська область
3769,120276,1399,17,851,792,59,120276,Дніпропетровська область
3770,120277,617,7,367,342,25,120277,Дніпропетровська область
3771,120278,193,1,110,95,15,120278,Дніпропетровська область
3772,120279,639,6,360,335,25,120279,Дніпропетровська область
3773,120280,801,6,494,461,33,120280,Дніпропетровська область
3774,120281,1103,13,607,565,42,120281,Дніпропетровська область
3775,120282,964,7,573,534,39,120282,Дніпропетровська область
3776,120283,1347,12,898,827,71,120283,Дніпропетровська область
3777,120284,1007,5,591,534,57,120284,Дніпропетровська область
3778,120285,905,1,543,502,41,120285,Дніпропетровська область
3779,120286,219,1,151,137,14,120286,Дніпропетровська область
3780,120287,2175,26,1270,1138,132,120287,Дніпропетровська область
3781,120288,1955,24,1227,1119,108,120288,Дніпропетровська область
3782,120289,1485,14,899,838,61,120289,Дніпропетровська область
3783,120290,502,7,290,268,22,120290,Дніпропетровська область
3784,120291,1119,5,661,631,30,120291,Дніпропетровська область
3785,120292,341,2,229,224,5,120292,Дніпропетровська область
3786,120293,434,4,281,260,21,120293,Дніпропетровська область
3787,120294,256,5,192,177,15,120294,Дніпропетровська область
3788,120737,2249,35,1360,1229,131,120737,Дніпропетровська область
3789,120738,1453,13,857,769,88,120738,Дніпропетровська область
3790,120739,2141,22,1288,1146,142,120739,Дніпропетровська область
3791,120740,2103,26,1276,1136,140,120740,Дніпропетровська область
3792,120741,2162,27,1350,1184,166,120741,Дніпропетровська область
3793,120742,2188,35,1295,1151,144,120742,Дніпропетровська область
3794,120743,1872,24,1150,972,178,120743,Дніпропетровська область
3795,120744,2150,25,1305,1119,186,120744,Дніпропетровська область
3796,120745,1236,24,724,610,114,120745,Дніпропетровська область
3797,120746,1675,34,1049,886,163,120746,Дніпропетровська область
3798,120747,2094,15,1238,1039,199,120747,Дніпропетровська область
3799,120748,2008,39,1226,1047,179,120748,Дніпропетровська область
3800,120749,2124,37,1323,1148,175,120749,Дніпропетровська область
3801,120750,1589,16,1018,869,149,120750,Дніпропетровська область
3802,120751,1642,37,954,823,131,120751,Дніпропетровська область
3803,120752,944,17,614,515,99,120752,Дніпропетровська область
3804,120753,1290,30,771,650,121,120753,Дніпропетровська область
3805,120754,1758,33,1028,900,128,120754,Дніпропетровська область
3806,120755,1970,28,1124,978,146,120755,Дніпропетровська область
3807,120756,2090,32,1309,1096,213,120756,Дніпропетровська область
3808,120757,1107,16,639,548,91,120757,Дніпропетровська область
3809,120758,1124,11,603,526,77,120758,Дніпропетровська область
3810,120759,1449,29,884,794,90,120759,Дніпропетровська область
3811,120760,995,16,580,508,72,120760,Дніпропетровська область
3812,120761,857,20,507,449,58,120761,Дніпропетровська область
3813,120762,1207,17,694,617,77,120762,Дніпропетровська область
3814,120763,1261,23,773,674,99,120763,Дніпропетровська область
3815,120764,1328,13,782,686,96,120764,Дніпропетровська область
3816,120765,1994,29,1168,987,181,120765,Дніпропетровська область
3817,120766,1922,31,1184,1021,163,120766,Дніпропетровська область
3818,120767,2139,35,1263,1102,161,120767,Дніпропетровська область
3819,120768,2060,26,1246,1088,158,120768,Дніпропетровська область
3820,120769,2019,41,1261,1061,200,120769,Дніпропетровська область
3821,120770,2034,24,1275,1081,194,120770,Дніпропетровська область
3822,120771,1360,8,806,673,133,120771,Дніпропетровська область
3823,120772,1675,26,987,856,131,120772,Дніпропетровська область
3824,120773,2089,29,1296,1125,171,120773,Дніпропетровська область
3825,120774,2103,42,1291,1117,174,120774,Дніпропетровська область
3826,120775,1979,23,1038,894,144,120775,Дніпропетровська область
3827,120776,1749,28,1004,873,131,120776,Дніпропетровська область
3828,120777,2192,42,1353,1170,183,120777,Дніпропетровська область
3829,120778,2109,37,1271,1085,186,120778,Дніпропетровська область
3830,120779,2019,38,1192,1041,151,120779,Дніпропетровська область
3831,120780,2036,33,1226,1076,150,120780,Дніпропетровська область
3832,120781,1978,18,1119,986,133,120781,Дніпропетровська область
3833,120782,1337,16,838,742,96,120782,Дніпропетровська область
3834,120783,2129,20,1204,1054,150,120783,Дніпропетровська область
3835,120784,2132,27,1210,1075,135,120784,Дніпропетровська область
3836,120785,1327,11,844,764,80,120785,Дніпропетровська область
3837,120786,1558,12,853,752,101,120786,Дніпропетровська область
3838,120787,2144,39,1371,1228,143,120787,Дніпропетровська область
3839,120788,1945,27,1182,1013,169,120788,Дніпропетровська область
3840,120789,1575,29,987,854,133,120789,Дніпропетровська область
3841,120790,1800,27,1059,915,144,120790,Дніпропетровська область
3842,120791,1334,15,887,735,152,120791,Дніпропетровська область
3843,120792,215,3,212,195,17,120792,Дніпропетровська область
3844,120793,27,0,27,24,3,120793,Дніпропетровська область
3845,120794,32,0,32,29,3,120794,Дніпропетровська область
3846,120795,64,2,61,51,10,120795,Дніпропетровська область
3847,120796,68,1,65,61,4,120796,Дніпропетровська область
3848,120831,1400,9,806,749,57,120831,Дніпропетровська область
3849,120832,2152,31,1289,1183,106,120832,Дніпропетровська область
3850,120833,1808,13,1117,1022,95,120833,Дніпропетровська область
3851,120834,1089,10,684,626,58,120834,Дніпропетровська область
3852,120835,395,2,228,199,29,120835,Дніпропетровська область
3853,120836,1268,16,744,642,102,120836,Дніпропетровська область
3854,120837,1318,11,783,696,87,120837,Дніпропетровська область
3855,120838,1251,12,797,708,89,120838,Дніпропетровська область
3856,120839,1967,19,1142,1003,139,120839,Дніпропетровська область
3857,120840,1325,15,789,703,86,120840,Дніпропетровська область
3858,120841,1461,8,860,765,95,120841,Дніпропетровська область
3859,120842,2117,21,1216,1082,134,120842,Дніпропетровська область
3860,120843,1483,8,932,832,100,120843,Дніпропетровська область
3861,120844,1623,13,976,849,127,120844,Дніпропетровська область
3862,120845,1923,21,1199,1082,117,120845,Дніпропетровська область
3863,120846,2081,16,1309,1199,110,120846,Дніпропетровська область
3864,120847,1969,20,1121,1012,109,120847,Дніпропетровська область
3865,120848,2072,28,1195,1106,89,120848,Дніпропетровська область
3866,120849,1684,11,967,864,103,120849,Дніпропетровська область
3867,120850,209,3,111,102,9,120850,Дніпропетровська область
3868,120851,155,2,153,78,75,120851,Дніпропетровська область
3869,120852,95,0,94,90,4,120852,Дніпропетровська область
3870,120351,2042,15,1343,1268,75,120351,Дніпропетровська область
3871,120352,1575,9,1044,985,59,120352,Дніпропетровська область
3872,120353,104,0,68,59,9,120353,Дніпропетровська область
3873,120354,137,0,96,85,11,120354,Дніпропетровська область
3874,120355,1384,15,963,863,100,120355,Дніпропетровська область
3875,120356,1594,14,1119,1031,88,120356,Дніпропетровська область
3876,120357,1648,16,1054,954,100,120357,Дніпропетровська область
3877,120358,1078,8,748,673,75,120358,Дніпропетровська область
3878,120359,1655,10,1141,1039,102,120359,Дніпропетровська область
3879,120360,323,3,235,208,27,120360,Дніпропетровська область
3880,120361,286,4,192,180,12,120361,Дніпропетровська область
3881,120362,715,4,460,422,38,120362,Дніпропетровська область
3882,120363,744,4,500,470,30,120363,Дніпропетровська область
3883,120364,719,5,450,404,46,120364,Дніпропетровська область
3884,120365,271,1,173,149,24,120365,Дніпропетровська область
3885,120366,596,5,385,349,36,120366,Дніпропетровська область
3886,120367,452,0,309,288,21,120367,Дніпропетровська область
3887,120368,1803,19,1210,1104,106,120368,Дніпропетровська область
3888,120369,1399,17,970,919,51,120369,Дніпропетровська область
3889,120370,218,1,122,112,10,120370,Дніпропетровська область
3890,120371,1152,9,779,742,37,120371,Дніпропетровська область
3891,120372,543,4,327,310,17,120372,Дніпропетровська область
3892,120373,291,1,187,180,7,120373,Дніпропетровська область
3893,120374,599,4,450,419,31,120374,Дніпропетровська область
3894,120375,391,7,312,287,25,120375,Дніпропетровська область
3895,120376,1036,14,677,573,104,120376,Дніпропетровська область
3896,120377,160,1,96,75,21,120377,Дніпропетровська область
3897,120853,2153,24,1480,1338,142,120853,Дніпропетровська область
3898,120854,2146,24,1444,1336,108,120854,Дніпропетровська область
3899,120855,1465,13,943,872,71,120855,Дніпропетровська область
3900,120856,1940,24,1260,1180,80,120856,Дніпропетровська область
3901,120857,1462,19,996,930,66,120857,Дніпропетровська область
3902,120858,1981,23,1321,1175,146,120858,Дніпропетровська область
3903,120859,2247,29,1476,1323,153,120859,Дніпропетровська область
3904,120860,2151,32,1465,1282,183,120860,Дніпропетровська область
3905,120861,1820,29,1260,1079,181,120861,Дніпропетровська область
3906,120862,2023,23,1426,1273,153,120862,Дніпропетровська область
3907,120863,1725,28,1210,1049,161,120863,Дніпропетровська область
3908,120864,2283,35,1505,1285,220,120864,Дніпропетровська область
3909,120865,1204,18,792,728,64,120865,Дніпропетровська область
3910,120866,1130,9,729,650,79,120866,Дніпропетровська область
3911,120867,2199,22,1454,1309,145,120867,Дніпропетровська область
3912,120868,2220,21,1530,1363,167,120868,Дніпропетровська область
3913,120869,2263,31,1594,1406,188,120869,Дніпропетровська область
3914,120870,2309,23,1615,1438,177,120870,Дніпропетровська область
3915,120871,2130,25,1394,1215,179,120871,Дніпропетровська область
3916,120872,2077,19,1398,1261,137,120872,Дніпропетровська область
3917,120873,2031,33,1414,1227,187,120873,Дніпропетровська область
3918,120874,2001,30,1363,1200,163,120874,Дніпропетровська область
3919,120875,1544,11,1078,978,100,120875,Дніпропетровська область
3920,120876,1352,7,917,848,69,120876,Дніпропетровська область
3921,120877,1331,20,855,768,87,120877,Дніпропетровська область
3922,120878,1736,14,1158,1061,97,120878,Дніпропетровська область
3923,120879,1872,24,1214,1082,132,120879,Дніпропетровська область
3924,120880,1609,30,1039,944,95,120880,Дніпропетровська область
3925,120881,1325,6,948,848,100,120881,Дніпропетровська область
3926,120882,1809,23,1242,1134,108,120882,Дніпропетровська область
3927,120883,1543,13,1063,951,112,120883,Дніпропетровська область
3928,120884,1751,12,1198,1100,98,120884,Дніпропетровська область
3929,120885,1711,23,1093,991,102,120885,Дніпропетровська область
3930,120886,2214,22,1537,1373,164,120886,Дніпропетровська область
3931,120887,2171,33,1517,1375,142,120887,Дніпропетровська область
3932,120888,2089,27,1433,1286,147,120888,Дніпропетровська область
3933,120889,2217,39,1481,1359,122,120889,Дніпропетровська область
3934,120890,2214,22,1465,1318,147,120890,Дніпропетровська область
3935,120891,2222,17,1457,1326,131,120891,Дніпропетровська область
3936,120892,2207,35,1450,1315,135,120892,Дніпропетровська область
3937,120893,1960,20,1376,1242,134,120893,Дніпропетровська область
3938,120894,1884,25,1247,1151,96,120894,Дніпропетровська область
3939,120895,2216,31,1479,1344,135,120895,Дніпропетровська область
3940,120896,2237,16,1511,1368,143,120896,Дніпропетровська область
3941,120897,2168,37,1457,1340,117,120897,Дніпропетровська область
3942,120899,53,5,45,38,7,120899,Дніпропетровська область
3943,120900,63,2,60,60,0,120900,Дніпропетровська область
3944,120901,55,2,53,44,9,120901,Дніпропетровська область
3945,120903,31,0,31,24,7,120903,Дніпропетровська область
3946,120905,1561,16,995,887,108,120905,Дніпропетровська область
3947,120906,1736,22,1105,983,122,120906,Дніпропетровська область
3948,120907,1396,15,915,805,110,120907,Дніпропетровська область
3949,120908,1571,17,1033,915,118,120908,Дніпропетровська область
3950,120909,1689,25,1075,970,105,120909,Дніпропетровська область
3951,120910,1791,16,1148,1036,112,120910,Дніпропетровська область
3952,120911,1642,13,1121,989,132,120911,Дніпропетровська область
3953,120912,1657,27,1087,979,108,120912,Дніпропетровська область
3954,120913,2062,25,1427,1287,140,120913,Дніпропетровська область
3955,120914,2231,29,1484,1320,164,120914,Дніпропетровська область
3956,120915,2151,26,1407,1236,171,120915,Дніпропетровська область
3957,120916,53,1,52,38,14,120916,Дніпропетровська область
3958,120936,2058,31,1435,1324,111,120936,Дніпропетровська область
3959,120937,1773,26,1218,1131,87,120937,Дніпропетровська область
3960,120938,2038,28,1486,1351,135,120938,Дніпропетровська область
3961,120939,1989,19,1380,1279,101,120939,Дніпропетровська область
3962,120940,1761,21,1220,1116,104,120940,Дніпропетровська область
3963,120941,1962,19,1365,1299,66,120941,Дніпропетровська область
3964,120942,2154,35,1544,1444,100,120942,Дніпропетровська область
3965,120943,1937,32,1317,1223,94,120943,Дніпропетровська область
3966,120944,2009,17,1370,1249,121,120944,Дніпропетровська область
3967,120945,1318,5,890,830,60,120945,Дніпропетровська область
3968,120946,1286,16,821,786,35,120946,Дніпропетровська область
3969,120947,56,1,54,44,10,120947,Дніпропетровська область
3970,121783,40,1,39,35,4,121783,Дніпропетровська область
3971,120001,2027,19,1236,1170,66,120001,Дніпропетровська область
3972,120002,2178,23,1371,1265,106,120002,Дніпропетровська область
3973,120003,2125,28,1357,1229,128,120003,Дніпропетровська область
3974,120004,2214,23,1363,1270,93,120004,Дніпропетровська область
3975,120005,1577,22,923,847,76,120005,Дніпропетровська область
3976,120006,1688,11,1041,936,105,120006,Дніпропетровська область
3977,120007,650,4,398,386,12,120007,Дніпропетровська область
3978,120008,2151,36,1367,1217,150,120008,Дніпропетровська область
3979,120009,2148,22,1333,1218,115,120009,Дніпропетровська область
3980,120010,2174,31,1385,1264,121,120010,Дніпропетровська область
3981,120011,2248,24,1205,1125,80,120011,Дніпропетровська область
3982,120012,1883,16,1121,1049,72,120012,Дніпропетровська область
3983,120013,613,0,295,269,26,120013,Дніпропетровська область
3984,120014,1625,9,911,851,60,120014,Дніпропетровська область
3985,120015,1013,9,542,500,42,120015,Дніпропетровська область
3986,120016,1111,12,568,520,48,120016,Дніпропетровська область
3987,120017,713,3,368,343,25,120017,Дніпропетровська область
3988,120018,459,6,296,274,22,120018,Дніпропетровська область
3989,120019,1821,10,1097,1017,80,120019,Дніпропетровська область
3990,120020,1004,8,538,506,32,120020,Дніпропетровська область
3991,120021,386,3,204,196,8,120021,Дніпропетровська область
3992,120022,226,1,137,126,11,120022,Дніпропетровська область
3993,120023,1048,14,639,599,40,120023,Дніпропетровська область
3994,120024,1823,21,916,862,54,120024,Дніпропетровська область
3995,120025,998,6,524,483,41,120025,Дніпропетровська область
3996,120026,583,7,342,322,20,120026,Дніпропетровська область
3997,120027,446,3,262,233,29,120027,Дніпропетровська область
3998,120028,1738,20,1045,973,72,120028,Дніпропетровська область
3999,120029,1673,17,1047,996,51,120029,Дніпропетровська область
4000,120030,757,8,456,425,31,120030,Дніпропетровська область
4001,120031,866,5,537,495,42,120031,Дніпропетровська область
4002,120032,1201,15,676,618,58,120032,Дніпропетровська область
4003,120033,747,4,431,398,33,120033,Дніпропетровська область
4004,120034,117,2,114,104,10,120034,Дніпропетровська область
4005,120147,947,4,580,530,50,120147,Дніпропетровська область
4006,120148,1664,17,1155,1056,99,120148,Дніпропетровська область
4007,120149,1247,10,737,690,47,120149,Дніпропетровська область
4008,120150,514,6,348,320,28,120150,Дніпропетровська область
4009,120151,253,2,151,148,3,120151,Дніпропетровська область
4010,120152,752,3,399,362,37,120152,Дніпропетровська область
4011,120153,547,5,361,338,23,120153,Дніпропетровська область
4012,120154,1298,23,767,726,41,120154,Дніпропетровська область
4013,120155,1188,12,748,680,68,120155,Дніпропетровська область
4014,120156,1517,12,934,848,86,120156,Дніпропетровська область
4015,120157,1204,15,729,678,51,120157,Дніпропетровська область
4016,120158,462,9,327,296,31,120158,Дніпропетровська область
4017,120159,817,6,538,499,39,120159,Дніпропетровська область
4018,120160,497,2,320,303,17,120160,Дніпропетровська область
4019,120161,2219,35,1516,1369,147,120161,Дніпропетровська область
4020,120162,1042,5,620,568,52,120162,Дніпропетровська область
4021,120163,1519,18,984,908,76,120163,Дніпропетровська область
4022,120164,1774,14,1071,948,123,120164,Дніпропетровська область
4023,120165,652,3,441,416,25,120165,Дніпропетровська область
4024,120166,251,1,117,110,7,120166,Дніпропетровська область
4025,120167,1618,12,924,869,55,120167,Дніпропетровська область
4026,120168,1065,13,700,617,83,120168,Дніпропетровська область
4027,120169,898,4,573,538,35,120169,Дніпропетровська область
4028,120170,2014,27,1315,1229,86,120170,Дніпропетровська область
4029,120171,1192,6,757,703,54,120171,Дніпропетровська область
4030,120172,1108,10,745,716,29,120172,Дніпропетровська область
4031,120173,574,31,429,373,56,120173,Дніпропетровська область
4032,120174,709,3,430,393,37,120174,Дніпропетровська область
4033,120175,235,1,144,137,7,120175,Дніпропетровська область
4034,120176,117,0,85,80,5,120176,Дніпропетровська область
4035,120177,1555,11,911,842,69,120177,Дніпропетровська область
4036,120178,132,6,126,84,42,120178,Дніпропетровська область
4037,120179,46,1,45,39,6,120179,Дніпропетровська область
4038,120563,1884,18,1245,1137,108,120563,Дніпропетровська область
4039,120564,1857,18,1141,1043,98,120564,Дніпропетровська область
4040,120565,1058,5,650,610,40,120565,Дніпропетровська область
4041,120566,671,3,374,336,38,120566,Дніпропетровська область
4042,120567,569,8,322,303,19,120567,Дніпропетровська область
4043,120568,515,3,323,292,31,120568,Дніпропетровська область
4044,120569,224,1,127,116,11,120569,Дніпропетровська область
4045,120570,900,2,486,418,68,120570,Дніпропетровська область
4046,120571,330,4,196,161,35,120571,Дніпропетровська область
4047,120572,101,0,71,57,14,120572,Дніпропетровська область
4048,120573,1222,9,638,582,56,120573,Дніпропетровська область
4049,120574,412,2,239,221,18,120574,Дніпропетровська область
4050,120575,449,4,304,284,20,120575,Дніпропетровська область
4051,120576,387,3,246,232,14,120576,Дніпропетровська область
4052,120577,687,6,443,397,46,120577,Дніпропетровська область
4053,120578,616,8,382,343,39,120578,Дніпропетровська область
4054,120579,203,2,136,121,15,120579,Дніпропетровська область
4055,120580,461,4,275,247,28,120580,Дніпропетровська область
4056,120581,400,4,245,212,33,120581,Дніпропетровська область
4057,120582,319,4,197,184,13,120582,Дніпропетровська область
4058,120583,422,1,254,232,22,120583,Дніпропетровська область
4059,120584,645,4,372,340,32,120584,Дніпропетровська область
4060,120585,605,6,406,384,22,120585,Дніпропетровська область
4061,120586,555,6,317,280,37,120586,Дніпропетровська область
4062,120587,816,9,483,448,35,120587,Дніпропетровська область
4063,120588,610,8,361,337,24,120588,Дніпропетровська область
4064,120589,473,7,297,270,27,120589,Дніпропетровська область
4065,120590,328,2,229,165,64,120590,Дніпропетровська область
4066,120591,321,2,227,214,13,120591,Дніпропетровська область
4067,120592,44,1,41,35,6,120592,Дніпропетровська область
4068,120593,265,10,248,238,10,120593,Дніпропетровська область
4069,120636,286,1,191,181,10,120636,Дніпропетровська область
4070,120637,948,4,569,531,38,120637,Дніпропетровська область
4071,120638,604,3,334,315,19,120638,Дніпропетровська область
4072,120639,415,7,294,283,11,120639,Дніпропетровська область
4073,120640,1148,53,656,615,41,120640,Дніпропетровська область
4074,120642,426,5,290,278,12,120642,Дніпропетровська область
4075,120643,456,6,251,237,14,120643,Дніпропетровська область
4076,120644,310,4,205,187,18,120644,Дніпропетровська область
4077,120645,330,1,174,163,11,120645,Дніпропетровська область
4078,120646,1007,5,609,583,26,120646,Дніпропетровська область
4079,120647,655,8,434,410,24,120647,Дніпропетровська область
4080,120648,682,3,421,392,29,120648,Дніпропетровська область
4081,120649,813,8,571,540,31,120649,Дніпропетровська область
4082,120650,625,1,357,314,43,120650,Дніпропетровська область
4083,120651,566,6,379,362,17,120651,Дніпропетровська область
4084,120652,513,5,296,282,14,120652,Дніпропетровська область
4085,120653,799,7,515,486,29,120653,Дніпропетровська область
4086,120654,448,4,255,228,27,120654,Дніпропетровська область
4087,120655,374,3,218,204,14,120655,Дніпропетровська область
4088,120656,1437,15,978,877,101,120656,Дніпропетровська область
4089,120657,540,5,310,280,30,120657,Дніпропетровська область
4090,120658,1095,14,661,627,34,120658,Дніпропетровська область
4091,120659,580,8,369,345,24,120659,Дніпропетровська область
4092,120660,1025,12,678,635,43,120660,Дніпропетровська область
4093,120661,1555,11,988,932,56,120661,Дніпропетровська область
4094,120662,490,12,328,309,19,120662,Дніпропетровська область
4095,120663,1559,23,971,906,65,120663,Дніпропетровська область
4096,120664,1870,9,1216,1137,79,120664,Дніпропетровська область
4097,120665,60,0,56,53,3,120665,Дніпропетровська область
4098,120666,54,1,52,51,1,120666,Дніпропетровська область
4099,121620,1054,13,704,660,44,121620,Дніпропетровська область
4100,121621,1121,4,596,550,46,121621,Дніпропетровська область
4101,121622,917,9,598,576,22,121622,Дніпропетровська область
4102,121623,954,2,686,630,56,121623,Дніпропетровська область
4103,121624,1886,16,1136,1060,76,121624,Дніпропетровська область
4104,121625,1602,17,1060,987,73,121625,Дніпропетровська область
4105,121626,1889,27,1256,1173,83,121626,Дніпропетровська область
4106,121627,2001,18,1367,1249,118,121627,Дніпропетровська область
4107,121628,1717,9,1179,1068,111,121628,Дніпропетровська область
4108,121629,1936,22,1368,1251,117,121629,Дніпропетровська область
4109,121630,1877,17,1334,1239,95,121630,Дніпропетровська область
4110,121631,1790,20,1242,1134,108,121631,Дніпропетровська область
4111,121632,1740,22,1210,1122,88,121632,Дніпропетровська область
4112,121633,1743,14,1273,1154,119,121633,Дніпропетровська область
4113,121634,1802,15,1242,1141,101,121634,Дніпропетровська область
4114,121635,1766,19,1233,1101,132,121635,Дніпропетровська область
4115,121637,102,0,102,97,5,121637,Дніпропетровська область
4116,121729,1346,11,794,756,38,121729,Дніпропетровська область
4117,120209,480,5,272,239,33,120209,Дніпропетровська область
4118,120210,466,1,298,282,16,120210,Дніпропетровська область
4119,120211,156,0,115,98,17,120211,Дніпропетровська область
4120,120212,907,11,578,530,48,120212,Дніпропетровська область
4121,120213,866,8,536,505,31,120213,Дніпропетровська область
4122,120214,927,9,670,642,28,120214,Дніпропетровська область
4123,120215,317,0,254,233,21,120215,Дніпропетровська область
4124,120216,522,4,293,270,23,120216,Дніпропетровська область
4125,120217,289,3,151,142,9,120217,Дніпропетровська область
4126,120218,806,6,498,458,40,120218,Дніпропетровська область
4127,120219,1735,33,1175,969,206,120219,Дніпропетровська область
4128,120220,1770,21,1177,1133,44,120220,Дніпропетровська область
4129,120221,2301,32,1538,1386,152,120221,Дніпропетровська область
4130,120222,2286,35,1430,1330,100,120222,Дніпропетровська область
4131,120223,568,7,366,336,30,120223,Дніпропетровська область
4132,120224,309,3,253,202,51,120224,Дніпропетровська область
4133,120225,397,1,283,247,36,120225,Дніпропетровська область
4134,120226,792,4,507,464,43,120226,Дніпропетровська область
4135,120227,592,8,364,335,29,120227,Дніпропетровська область
4136,120228,411,2,264,235,29,120228,Дніпропетровська область
4137,120229,992,7,815,708,107,120229,Дніпропетровська область
4138,120230,639,6,467,434,33,120230,Дніпропетровська область
4139,120231,504,6,320,299,21,120231,Дніпропетровська область
4140,120232,1038,7,656,561,95,120232,Дніпропетровська область
4141,120233,616,6,421,375,46,120233,Дніпропетровська область
4142,120234,197,3,137,122,15,120234,Дніпропетровська область
4143,120235,485,4,297,277,20,120235,Дніпропетровська область
4144,120236,377,1,244,233,11,120236,Дніпропетровська область
4145,120237,772,5,466,452,14,120237,Дніпропетровська область
4146,120238,740,6,454,410,44,120238,Дніпропетровська область
4147,120239,843,8,560,526,34,120239,Дніпропетровська область
4148,120240,256,3,198,181,17,120240,Дніпропетровська область
4149,120241,341,3,256,233,23,120241,Дніпропетровська область
4150,120295,597,4,420,391,29,120295,Дніпропетровська область
4151,120296,662,7,488,406,82,120296,Дніпропетровська область
4152,120297,530,6,287,262,25,120297,Дніпропетровська область
4153,120298,365,2,238,224,14,120298,Дніпропетровська область
4154,120299,195,0,121,112,9,120299,Дніпропетровська область
4155,120300,1412,10,772,704,68,120300,Дніпропетровська область
4156,120301,584,7,393,366,27,120301,Дніпропетровська область
4157,120302,2071,23,1216,1028,188,120302,Дніпропетровська область
4158,120303,1865,19,1095,959,136,120303,Дніпропетровська область
4159,120304,401,3,213,182,31,120304,Дніпропетровська область
4160,120305,1883,22,1017,928,89,120305,Дніпропетровська область
4161,120306,735,8,434,408,26,120306,Дніпропетровська область
4162,120307,263,3,162,152,10,120307,Дніпропетровська область
4163,120308,880,6,535,495,40,120308,Дніпропетровська область
4164,120309,1337,15,738,688,50,120309,Дніпропетровська область
4165,120310,1566,13,856,802,54,120310,Дніпропетровська область
4166,120311,1344,14,871,794,77,120311,Дніпропетровська область
4167,120312,210,0,116,107,9,120312,Дніпропетровська область
4168,120313,506,2,331,292,39,120313,Дніпропетровська область
4169,120314,1510,14,949,901,48,120314,Дніпропетровська область
4170,120315,1796,15,1093,1033,60,120315,Дніпропетровська область
4171,120316,179,0,125,111,14,120316,Дніпропетровська область
4172,120317,788,8,478,445,33,120317,Дніпропетровська область
4173,120318,874,7,647,589,58,120318,Дніпропетровська область
4174,120319,2039,23,1285,1194,91,120319,Дніпропетровська область
4175,120320,1237,13,722,674,48,120320,Дніпропетровська область
4176,120321,726,15,457,414,43,120321,Дніпропетровська область
4177,120322,925,15,645,592,53,120322,Дніпропетровська область
4178,120323,1422,11,858,767,91,120323,Дніпропетровська область
4179,120324,528,7,386,359,27,120324,Дніпропетровська область
4180,120325,621,4,364,341,23,120325,Дніпропетровська область
4181,120326,423,3,311,288,23,120326,Дніпропетровська область
4182,120327,226,2,150,134,16,120327,Дніпропетровська область
4183,120328,354,3,228,217,11,120328,Дніпропетровська область
4184,120329,127,1,103,92,11,120329,Дніпропетровська область
4185,120330,1077,9,690,641,49,120330,Дніпропетровська область
4186,120331,1446,18,891,810,81,120331,Дніпропетровська область
4187,120332,1337,12,875,785,90,120332,Дніпропетровська область
4188,120333,2166,22,1283,1192,91,120333,Дніпропетровська область
4189,120334,1651,18,994,930,64,120334,Дніпропетровська область
4190,120335,1108,3,682,646,36,120335,Дніпропетровська область
4191,120336,1466,8,920,875,45,120336,Дніпропетровська область
4192,120337,879,12,532,518,14,120337,Дніпропетровська область
4193,120338,2014,30,1190,1057,133,120338,Дніпропетровська область
4194,120339,1464,19,918,844,74,120339,Дніпропетровська область
4195,120340,795,10,488,438,50,120340,Дніпропетровська область
4196,120341,360,6,224,205,19,120341,Дніпропетровська область
4197,120342,247,0,146,135,11,120342,Дніпропетровська область
4198,120343,823,6,479,431,48,120343,Дніпропетровська область
4199,120344,290,1,171,160,11,120344,Дніпропетровська область
4200,120345,1605,15,1038,976,62,120345,Дніпропетровська область
4201,120346,897,7,561,525,36,120346,Дніпропетровська область
4202,120347,756,8,460,442,18,120347,Дніпропетровська область
4203,120348,1883,15,1148,1018,130,120348,Дніпропетровська область
4204,120349,1648,16,1026,896,130,120349,Дніпропетровська область
4205,120350,182,1,176,153,23,120350,Дніпропетровська область
4206,120667,722,4,439,390,49,120667,Дніпропетровська область
4207,120668,1211,9,789,735,54,120668,Дніпропетровська область
4208,120669,1812,14,1214,1139,75,120669,Дніпропетровська область
4209,120670,436,5,272,253,19,120670,Дніпропетровська область
4210,120671,516,2,361,336,25,120671,Дніпропетровська область
4211,120672,378,3,242,230,12,120672,Дніпропетровська область
4212,120673,297,1,181,170,11,120673,Дніпропетровська область
4213,120674,309,7,192,175,17,120674,Дніпропетровська область
4214,120675,589,5,332,312,20,120675,Дніпропетровська область
4215,120676,197,2,121,109,12,120676,Дніпропетровська область
4216,120677,509,1,293,253,40,120677,Дніпропетровська область
4217,120678,662,2,443,422,21,120678,Дніпропетровська область
4218,120679,676,2,423,392,31,120679,Дніпропетровська область
4219,120680,1205,6,799,714,85,120680,Дніпропетровська область
4220,120681,355,1,253,236,17,120681,Дніпропетровська область
4221,120797,1489,18,966,866,100,120797,Дніпропетровська область
4222,120798,1950,30,1247,1091,156,120798,Дніпропетровська область
4223,120799,1867,35,1272,1074,198,120799,Дніпропетровська область
4224,120800,2007,42,1406,1201,205,120800,Дніпропетровська область
4225,120801,1286,7,857,774,83,120801,Дніпропетровська область
4226,120802,886,13,606,515,91,120802,Дніпропетровська область
4227,120803,1544,24,1037,909,128,120803,Дніпропетровська область
4228,120804,1278,22,840,727,113,120804,Дніпропетровська область
4229,120805,2073,38,1360,1149,211,120805,Дніпропетровська область
4230,120806,1909,31,1212,1059,153,120806,Дніпропетровська область
4231,120807,1026,18,704,580,124,120807,Дніпропетровська область
4232,120808,2029,30,1379,1188,191,120808,Дніпропетровська область
4233,120809,2106,36,1417,1250,167,120809,Дніпропетровська область
4234,120810,1371,18,943,811,132,120810,Дніпропетровська область
4235,120811,1446,28,1001,841,160,120811,Дніпропетровська область
4236,120812,2263,28,1565,1381,184,120812,Дніпропетровська область
4237,120813,2216,50,1445,1269,176,120813,Дніпропетровська область
4238,120814,2077,26,1274,1147,127,120814,Дніпропетровська область
4239,120815,1708,19,1098,979,119,120815,Дніпропетровська область
4240,120816,1216,24,786,698,88,120816,Дніпропетровська область
4241,120817,2001,30,1274,1150,124,120817,Дніпропетровська область
4242,120818,407,7,258,234,24,120818,Дніпропетровська область
4243,120819,1316,17,817,725,92,120819,Дніпропетровська область
4244,120820,1355,23,859,770,89,120820,Дніпропетровська область
4245,120821,1367,18,840,758,82,120821,Дніпропетровська область
4246,120822,1244,14,811,718,93,120822,Дніпропетровська область
4247,120823,1963,10,1183,1090,93,120823,Дніпропетровська область
4248,120824,1430,17,890,822,68,120824,Дніпропетровська область
4249,120825,2214,28,1381,1272,109,120825,Дніпропетровська область
4250,120826,2376,29,1503,1350,153,120826,Дніпропетровська область
4251,120827,1631,8,918,848,70,120827,Дніпропетровська область
4252,120828,1866,26,1066,972,94,120828,Дніпропетровська область
4253,120829,105,3,102,95,7,120829,Дніпропетровська область
4254,120035,2046,16,1303,1189,114,120035,Дніпропетровська область
4255,120036,1928,25,1211,1103,108,120036,Дніпропетровська область
4256,120037,1950,16,1209,1093,116,120037,Дніпропетровська область
4257,120038,1810,20,1087,1035,52,120038,Дніпропетровська область
4258,120039,1372,14,826,784,42,120039,Дніпропетровська область
4259,120040,913,4,524,477,47,120040,Дніпропетровська область
4260,120041,1111,14,583,535,48,120041,Дніпропетровська область
4261,120042,600,3,407,369,38,120042,Дніпропетровська область
4262,120043,801,7,490,466,24,120043,Дніпропетровська область
4263,120044,841,3,519,493,26,120044,Дніпропетровська область
4264,120045,966,12,610,569,41,120045,Дніпропетровська область
4265,120046,336,0,236,204,32,120046,Дніпропетровська область
4266,120047,406,1,277,256,21,120047,Дніпропетровська область
4267,120048,310,2,212,187,25,120048,Дніпропетровська область
4268,120049,1336,29,886,685,201,120049,Дніпропетровська область
4269,120050,425,3,273,242,31,120050,Дніпропетровська область
4270,120051,641,10,381,355,26,120051,Дніпропетровська область
4271,120052,807,5,483,431,52,120052,Дніпропетровська область
4272,120053,387,3,236,209,27,120053,Дніпропетровська область
4273,120054,247,2,132,115,17,120054,Дніпропетровська область
4274,120055,589,7,391,340,51,120055,Дніпропетровська область
4275,120056,391,0,276,261,15,120056,Дніпропетровська область
4276,120057,932,15,669,544,125,120057,Дніпропетровська область
4277,120058,1261,11,652,607,45,120058,Дніпропетровська область
4278,120059,303,2,259,229,30,120059,Дніпропетровська область
4279,120060,469,2,291,265,26,120060,Дніпропетровська область
4280,120061,303,2,241,213,28,120061,Дніпропетровська область
4281,120243,509,4,385,340,45,120243,Дніпропетровська область
4282,120244,1677,19,1009,918,91,120244,Дніпропетровська область
4283,120245,1246,9,767,691,76,120245,Дніпропетровська область
4284,120246,1331,15,834,737,97,120246,Дніпропетровська область
4285,120247,1815,20,1081,977,104,120247,Дніпропетровська область
4286,120248,761,6,448,418,30,120248,Дніпропетровська область
4287,120249,295,1,177,151,26,120249,Дніпропетровська область
4288,120250,1694,16,958,885,73,120250,Дніпропетровська область
4289,120251,503,2,282,236,46,120251,Дніпропетровська область
4290,120252,733,5,429,392,37,120252,Дніпропетровська область
4291,120253,555,8,324,268,56,120253,Дніпропетровська область
4292,120254,455,2,286,208,78,120254,Дніпропетровська область
4293,120255,281,0,180,140,40,120255,Дніпропетровська область
4294,120256,775,5,422,372,50,120256,Дніпропетровська область
4295,120258,741,5,462,386,76,120258,Дніпропетровська область
4296,120259,1179,17,706,589,117,120259,Дніпропетровська область
4297,120260,784,7,500,386,114,120260,Дніпропетровська область
4298,120261,526,1,302,252,50,120261,Дніпропетровська область
4299,120262,652,10,434,341,93,120262,Дніпропетровська область
4300,120263,581,10,341,313,28,120263,Дніпропетровська область
4301,120392,2165,23,1454,1280,174,120392,Дніпропетровська область
4302,120393,2216,20,1476,1367,109,120393,Дніпропетровська область
4303,120394,2143,18,1355,1242,113,120394,Дніпропетровська область
4304,120395,441,4,314,278,36,120395,Дніпропетровська область
4305,120396,1339,12,933,877,56,120396,Дніпропетровська область
4306,120397,1010,3,641,597,44,120397,Дніпропетровська область
4307,120398,321,3,202,184,18,120398,Дніпропетровська область
4308,120399,1570,8,1055,932,123,120399,Дніпропетровська область
4309,120400,930,12,627,573,54,120400,Дніпропетровська область
4310,120401,608,5,414,377,37,120401,Дніпропетровська область
4311,120402,512,3,344,305,39,120402,Дніпропетровська область
4312,120403,1417,7,924,803,121,120403,Дніпропетровська область
4313,120404,1595,20,1035,887,148,120404,Дніпропетровська область
4314,120405,804,3,496,441,55,120405,Дніпропетровська область
4315,120406,561,0,355,314,41,120406,Дніпропетровська область
4316,120407,399,2,245,226,19,120407,Дніпропетровська область
4317,120408,247,0,186,170,16,120408,Дніпропетровська область
4318,120409,311,2,238,210,28,120409,Дніпропетровська область
4319,120410,531,5,390,351,39,120410,Дніпропетровська область
4320,120411,791,3,572,511,61,120411,Дніпропетровська область
4321,120412,640,0,424,400,24,120412,Дніпропетровська область
4322,120413,406,4,294,280,14,120413,Дніпропетровська область
4323,120414,875,6,561,509,52,120414,Дніпропетровська область
4324,120415,228,1,150,140,10,120415,Дніпропетровська область
4325,120416,771,5,522,493,29,120416,Дніпропетровська область
4326,120417,269,0,208,166,42,120417,Дніпропетровська область
4327,120418,1058,12,657,597,60,120418,Дніпропетровська область
4328,120419,846,5,521,481,40,120419,Дніпропетровська область
4329,120420,1579,24,917,796,121,120420,Дніпропетровська область
4330,120421,974,13,599,554,45,120421,Дніпропетровська область
4331,120422,321,3,211,188,23,120422,Дніпропетровська область
4332,120423,1507,22,932,859,73,120423,Дніпропетровська область
4333,120424,352,5,226,209,17,120424,Дніпропетровська область
4334,120425,1070,10,744,672,72,120425,Дніпропетровська область
4335,120426,773,12,531,482,49,120426,Дніпропетровська область
4336,120427,1860,27,1088,1018,70,120427,Дніпропетровська область
4337,120428,464,2,268,242,26,120428,Дніпропетровська область
4338,120429,1933,20,1282,1177,105,120429,Дніпропетровська область
4339,120430,685,2,414,380,34,120430,Дніпропетровська область
4340,120431,1452,18,959,861,98,120431,Дніпропетровська область
4341,120432,1485,22,973,892,81,120432,Дніпропетровська область
4342,120433,1242,19,850,758,92,120433,Дніпропетровська область
4343,120434,1211,10,803,705,98,120434,Дніпропетровська область
4344,120435,1523,13,975,916,59,120435,Дніпропетровська область
4345,120436,1585,13,1062,954,108,120436,Дніпропетровська область
4346,120437,1957,7,1106,1053,53,120437,Дніпропетровська область
4347,120438,2136,12,1224,1165,59,120438,Дніпропетровська область
4348,120439,539,13,359,334,25,120439,Дніпропетровська область
4349,120440,1004,14,642,600,42,120440,Дніпропетровська область
4350,120481,1220,16,838,702,136,120481,Дніпропетровська область
4351,120482,1734,23,1068,977,91,120482,Дніпропетровська область
4352,120483,1862,29,1342,1094,248,120483,Дніпропетровська область
4353,120484,1805,28,1156,977,179,120484,Дніпропетровська область
4354,120485,356,8,242,222,20,120485,Дніпропетровська область
4355,120486,276,4,197,150,47,120486,Дніпропетровська область
4356,120487,1262,9,746,687,59,120487,Дніпропетровська область
4357,120488,165,0,101,91,10,120488,Дніпропетровська область
4358,120489,1176,6,847,789,58,120489,Дніпропетровська область
4359,120490,469,6,319,293,26,120490,Дніпропетровська область
4360,120491,467,2,311,293,18,120491,Дніпропетровська область
4361,120492,218,0,119,104,15,120492,Дніпропетровська область
4362,120493,534,2,321,275,46,120493,Дніпропетровська область
4363,120494,323,1,216,194,22,120494,Дніпропетровська область
4364,120495,598,13,333,299,34,120495,Дніпропетровська область
4365,120496,341,2,226,211,15,120496,Дніпропетровська область
4366,120497,542,5,335,306,29,120497,Дніпропетровська область
4367,120498,633,9,385,353,32,120498,Дніпропетровська область
4368,120499,710,3,463,421,42,120499,Дніпропетровська область
4369,120500,344,0,205,187,18,120500,Дніпропетровська область
4370,120501,837,10,530,440,90,120501,Дніпропетровська область
4371,120502,161,1,128,116,12,120502,Дніпропетровська область
4372,120503,782,10,449,425,24,120503,Дніпропетровська область
4373,120504,797,9,497,470,27,120504,Дніпропетровська область
4374,120505,909,12,542,491,51,120505,Дніпропетровська область
4375,120506,356,3,226,177,49,120506,Дніпропетровська область
4376,120507,1198,12,730,647,83,120507,Дніпропетровська область
4377,120508,558,10,366,320,46,120508,Дніпропетровська область
4378,120509,824,13,499,461,38,120509,Дніпропетровська область
4379,120510,737,6,437,388,49,120510,Дніпропетровська область
4380,120511,703,8,477,416,61,120511,Дніпропетровська область
4381,120512,268,1,159,139,20,120512,Дніпропетровська область
4382,120513,228,3,125,100,25,120513,Дніпропетровська область
4383,120514,973,10,553,518,35,120514,Дніпропетровська область
4384,120515,561,3,360,329,31,120515,Дніпропетровська область
4385,120516,1353,14,817,726,91,120516,Дніпропетровська область
4386,120517,615,2,393,349,44,120517,Дніпропетровська область
4387,120518,567,4,354,333,21,120518,Дніпропетровська область
4388,120519,160,0,122,81,41,120519,Дніпропетровська область
4389,120520,260,1,150,146,4,120520,Дніпропетровська область
4390,120521,350,4,201,183,18,120521,Дніпропетровська область
4391,120522,756,30,726,593,133,120522,Дніпропетровська область
4392,120917,671,9,420,386,34,120917,Дніпропетровська область
4393,120918,2188,20,1476,1348,128,120918,Дніпропетровська область
4394,120919,1534,21,966,903,63,120919,Дніпропетровська область
4395,120920,1337,5,782,717,65,120920,Дніпропетровська область
4396,120921,1541,13,942,861,81,120921,Дніпропетровська область
4397,120922,1749,19,1145,1061,84,120922,Дніпропетровська область
4398,120924,910,19,594,550,44,120924,Дніпропетровська область
4399,120925,925,17,617,560,57,120925,Дніпропетровська область
4400,120926,1251,20,806,746,60,120926,Дніпропетровська область
4401,120927,1384,3,875,790,85,120927,Дніпропетровська область
4402,120928,854,8,519,489,30,120928,Дніпропетровська область
4403,120929,1685,27,1025,952,73,120929,Дніпропетровська область
4404,120930,1982,19,1248,1151,97,120930,Дніпропетровська область
4405,120931,1161,13,725,629,96,120931,Дніпропетровська область
4406,120932,1589,18,976,882,94,120932,Дніпропетровська область
4407,120933,2025,23,1322,1224,98,120933,Дніпропетровська область
4408,120934,1726,21,1142,1042,100,120934,Дніпропетровська область
4409,120935,213,4,207,187,20,120935,Дніпропетровська область
4410,120180,1190,17,1173,1066,107,120180,Дніпропетровська область
4411,120181,1926,24,1238,1100,138,120181,Дніпропетровська область
4412,120182,766,7,486,420,66,120182,Дніпропетровська область
4413,120183,525,2,292,270,22,120183,Дніпропетровська область
4414,120184,516,0,330,293,37,120184,Дніпропетровська область
4415,120185,1236,16,769,717,52,120185,Дніпропетровська область
4416,120186,739,6,468,427,41,120186,Дніпропетровська область
4417,120187,2216,25,1301,1188,113,120187,Дніпропетровська область
4418,120188,604,6,351,338,13,120188,Дніпропетровська область
4419,120189,1005,18,610,562,48,120189,Дніпропетровська область
4420,120190,486,4,274,262,12,120190,Дніпропетровська область
4421,120191,512,2,306,278,28,120191,Дніпропетровська область
4422,120192,919,9,575,529,46,120192,Дніпропетровська область
4423,120193,384,6,246,221,25,120193,Дніпропетровська область
4424,120194,1093,8,694,621,73,120194,Дніпропетровська область
4425,120195,525,4,314,298,16,120195,Дніпропетровська область
4426,120196,909,10,536,511,25,120196,Дніпропетровська область
4427,120197,604,7,362,345,17,120197,Дніпропетровська область
4428,120198,1119,9,656,597,59,120198,Дніпропетровська область
4429,120199,624,5,394,351,43,120199,Дніпропетровська область
4430,120200,1065,5,570,537,33,120200,Дніпропетровська область
4431,120201,798,9,484,452,32,120201,Дніпропетровська область
4432,120202,532,4,364,334,30,120202,Дніпропетровська область
4433,120203,327,1,236,213,23,120203,Дніпропетровська область
4434,120204,1288,22,778,688,90,120204,Дніпропетровська область
4435,120205,1110,10,704,624,80,120205,Дніпропетровська область
4436,120206,861,8,537,507,30,120206,Дніпропетровська область
4437,120207,676,9,414,376,38,120207,Дніпропетровська область
4438,120208,650,4,457,422,35,120208,Дніпропетровська область
4439,120523,1195,10,710,645,65,120523,Дніпропетровська область
4440,120524,360,4,188,160,28,120524,Дніпропетровська область
4441,120525,667,4,430,405,25,120525,Дніпропетровська область
4442,120526,914,7,552,484,68,120526,Дніпропетровська область
4443,120527,564,4,328,302,26,120527,Дніпропетровська область
4444,120528,610,9,385,339,46,120528,Дніпропетровська область
4445,120529,518,6,342,293,49,120529,Дніпропетровська область
4446,120530,496,2,280,266,14,120530,Дніпропетровська область
4447,120531,306,0,156,137,19,120531,Дніпропетровська область
4448,120532,294,1,202,167,35,120532,Дніпропетровська область
4449,120533,1234,12,716,650,66,120533,Дніпропетровська область
4450,120534,250,1,166,137,29,120534,Дніпропетровська область
4451,120535,576,6,379,324,55,120535,Дніпропетровська область
4452,120536,210,1,130,120,10,120536,Дніпропетровська область
4453,120537,337,4,231,196,35,120537,Дніпропетровська область
4454,120538,281,0,220,207,13,120538,Дніпропетровська область
4455,120539,515,4,271,226,45,120539,Дніпропетровська область
4456,120540,214,3,156,133,23,120540,Дніпропетровська область
4457,120541,591,2,303,266,37,120541,Дніпропетровська область
4458,120542,631,6,330,310,20,120542,Дніпропетровська область
4459,120543,1267,5,719,638,81,120543,Дніпропетровська область
4460,120544,265,2,149,128,21,120544,Дніпропетровська область
4461,120545,672,2,442,381,61,120545,Дніпропетровська область
4462,120546,587,4,343,311,32,120546,Дніпропетровська область
4463,120547,457,5,296,236,60,120547,Дніпропетровська область
4464,120548,565,2,324,293,31,120548,Дніпропетровська область
4465,120549,727,11,421,373,48,120549,Дніпропетровська область
4466,120550,842,7,493,419,74,120550,Дніпропетровська область
4467,120551,222,2,120,109,11,120551,Дніпропетровська область
4468,120552,686,2,374,340,34,120552,Дніпропетровська область
4469,120553,543,3,334,321,13,120553,Дніпропетровська область
4470,120554,1880,16,1231,1060,171,120554,Дніпропетровська область
4471,120555,2131,12,1247,1111,136,120555,Дніпропетровська область
4472,120556,2343,23,1451,1281,170,120556,Дніпропетровська область
4473,120557,1314,10,749,683,66,120557,Дніпропетровська область
4474,120558,898,14,489,453,36,120558,Дніпропетровська область
4475,120559,1843,13,982,889,93,120559,Дніпропетровська область
4476,120560,458,0,308,281,27,120560,Дніпропетровська область
4477,120561,415,2,250,223,27,120561,Дніпропетровська область
4478,120562,873,45,820,667,153,120562,Дніпропетровська область
4479,120594,1509,20,904,809,95,120594,Дніпропетровська область
4480,120595,1925,18,1261,1143,118,120595,Дніпропетровська область
4481,120596,2281,25,1433,1326,107,120596,Дніпропетровська область
4482,120597,491,5,277,235,42,120597,Дніпропетровська область
4483,120598,1032,16,710,668,42,120598,Дніпропетровська область
4484,120599,513,5,268,252,16,120599,Дніпропетровська область
4485,120600,1454,18,844,754,90,120600,Дніпропетровська область
4486,120601,410,3,279,231,48,120601,Дніпропетровська область
4487,120602,1192,10,778,716,62,120602,Дніпропетровська область
4488,120603,920,10,621,538,83,120603,Дніпропетровська область
4489,120604,447,1,309,286,23,120604,Дніпропетровська область
4490,120605,1723,26,1083,908,175,120605,Дніпропетровська область
4491,120606,592,7,321,295,26,120606,Дніпропетровська область
4492,120607,742,10,468,416,52,120607,Дніпропетровська область
4493,120608,960,6,504,465,39,120608,Дніпропетровська область
4494,120609,1332,14,806,733,73,120609,Дніпропетровська область
4495,120610,1224,25,755,669,86,120610,Дніпропетровська область
4496,120611,340,4,167,155,12,120611,Дніпропетровська область
4497,120612,894,17,551,454,97,120612,Дніпропетровська область
4498,120713,353,5,214,183,31,120713,Дніпропетровська область
4499,120714,905,9,524,459,65,120714,Дніпропетровська область
4500,120715,879,6,542,487,55,120715,Дніпропетровська область
4501,120716,829,15,462,411,51,120716,Дніпропетровська область
4502,120717,1372,15,793,717,76,120717,Дніпропетровська область
4503,120718,1505,21,944,841,103,120718,Дніпропетровська область
4504,120719,869,9,516,463,53,120719,Дніпропетровська область
4505,120720,1853,16,1104,986,118,120720,Дніпропетровська область
4506,120721,1617,11,899,808,91,120721,Дніпропетровська область
4507,120722,1396,19,805,711,94,120722,Дніпропетровська область
4508,120723,981,5,579,522,57,120723,Дніпропетровська область
4509,120724,2213,32,1344,1215,129,120724,Дніпропетровська область
4510,120725,2053,20,1200,1095,105,120725,Дніпропетровська область
4511,120726,1682,18,896,820,76,120726,Дніпропетровська область
4512,120727,1676,15,980,901,79,120727,Дніпропетровська область
4513,120728,2050,29,1269,1154,115,120728,Дніпропетровська область
4514,120729,2047,24,1189,1071,118,120729,Дніпропетровська область
4515,120730,2194,22,1281,1155,126,120730,Дніпропетровська область
4516,120731,2008,17,1214,1089,125,120731,Дніпропетровська область
4517,120732,1452,20,833,763,70,120732,Дніпропетровська область
4518,120733,387,1,237,225,12,120733,Дніпропетровська область
4519,120734,908,7,512,476,36,120734,Дніпропетровська область
4520,120735,1572,3,945,861,84,120735,Дніпропетровська область
4521,120736,1777,14,923,817,106,120736,Дніпропетровська область
4522,121022,2129,32,1249,1137,112,121022,Дніпропетровська область
4523,121023,2187,31,1286,1148,138,121023,Дніпропетровська область
4524,121024,2385,33,1559,1412,147,121024,Дніпропетровська область
4525,121025,2154,31,1235,1133,102,121025,Дніпропетровська область
4526,121026,2306,33,1477,1329,148,121026,Дніпропетровська область
4527,121027,2176,37,1245,1142,103,121027,Дніпропетровська область
4528,121029,2033,39,1336,1221,115,121029,Дніпропетровська область
4529,121031,2016,25,1250,1134,116,121031,Дніпропетровська область
4530,121032,2210,32,1287,1166,121,121032,Дніпропетровська область
4531,121033,2276,28,1425,1295,130,121033,Дніпропетровська область
4532,121034,2156,9,1342,1237,105,121034,Дніпропетровська область
4533,121035,2221,17,1400,1297,103,121035,Дніпропетровська область
4534,121039,1554,23,1007,910,97,121039,Дніпропетровська область
4535,121044,285,6,279,198,81,121044,Дніпропетровська область
4536,121045,278,3,273,257,16,121045,Дніпропетровська область
4537,121777,83,3,66,37,29,121777,Дніпропетровська область
4538,121782,1336,7,909,860,49,121782,Дніпропетровська область
4539,1,296,30,254,92,162,1,Донецька область
4540,2,319,14,303,132,171,2,Донецька область
4541,3,366,9,321,187,134,3,Донецька область
4542,4,920,26,888,305,583,4,Донецька область
4543,5,316,15,260,97,163,5,Донецька область
4544,6,556,8,467,305,162,6,Донецька область
4545,140566,2095,34,950,776,174,140566,Донецька область
4546,140567,611,2,134,70,64,140567,Донецька область
4547,140568,1014,16,769,447,322,140568,Донецька область
4548,140569,1463,33,679,518,161,140569,Донецька область
4549,140570,1574,30,727,628,99,140570,Донецька область
4550,140572,622,7,287,227,60,140572,Донецька область
4551,140573,491,1,214,176,38,140573,Донецька область
4552,140574,726,22,438,359,79,140574,Донецька область
4553,140575,1309,31,624,429,195,140575,Донецька область
4554,140576,419,2,302,203,99,140576,Донецька область
4555,140577,1723,48,908,666,242,140577,Донецька область
4556,140578,782,6,572,337,235,140578,Донецька область
4557,140579,1845,7,497,235,262,140579,Донецька область
4558,140580,554,9,312,238,74,140580,Донецька область
4559,140582,693,3,478,295,183,140582,Донецька область
4560,140585,564,1,247,153,94,140585,Донецька область
4561,140587,969,21,372,348,24,140587,Донецька область
4562,140588,1394,17,492,443,49,140588,Донецька область
4563,140589,912,16,352,318,34,140589,Донецька область
4564,140590,956,19,365,343,22,140590,Донецька область
4565,140591,1199,21,493,438,55,140591,Донецька область
4566,140592,1005,15,385,350,35,140592,Донецька область
4567,140593,1209,18,446,411,35,140593,Донецька область
4568,140594,1897,44,800,730,70,140594,Донецька область
4569,140595,2147,13,825,761,64,140595,Донецька область
4570,140596,1822,40,783,712,71,140596,Донецька область
4571,140597,1093,20,479,439,40,140597,Донецька область
4572,140598,1954,30,762,681,81,140598,Донецька область
4573,140599,2044,31,857,793,64,140599,Донецька область
4574,140600,1852,28,761,704,57,140600,Донецька область
4575,140601,1949,33,832,762,70,140601,Донецька область
4576,140602,1985,37,872,787,85,140602,Донецька область
4577,1,602,52,550,537,13,1,Донецька область
4578,2,256,8,222,167,55,2,Донецька область
4579,3,227,6,182,125,57,3,Донецька область
4580,4,210,2,202,139,63,4,Донецька область
4581,5,332,37,292,107,185,5,Донецька область
4582,6,714,26,676,423,253,6,Донецька область
4583,7,864,247,464,263,201,7,Донецька область
4584,8,484,20,457,206,251,8,Донецька область
4585,9,261,24,214,124,90,9,Донецька область
4586,10,638,36,560,300,260,10,Донецька область
4587,11,870,12,807,328,479,11,Донецька область
4588,12,180,13,165,79,86,12,Донецька область
4589,13,574,20,530,339,191,13,Донецька область
4590,140041,989,9,455,419,36,140041,Донецька область
4591,140042,1458,7,703,653,50,140042,Донецька область
4592,140043,1487,16,764,718,46,140043,Донецька область
4593,140044,1393,9,676,629,47,140044,Донецька область
4594,140045,1502,12,756,703,53,140045,Донецька область
4595,140046,839,6,387,367,20,140046,Донецька область
4596,140047,738,9,368,300,68,140047,Донецька область
4597,140048,873,6,421,348,73,140048,Донецька область
4598,140049,242,2,121,105,16,140049,Донецька область
4599,140050,243,2,131,101,30,140050,Донецька область
4600,140051,836,8,432,404,28,140051,Донецька область
4601,140052,597,3,337,314,23,140052,Донецька область
4602,140053,439,4,185,174,11,140053,Донецька область
4603,140054,253,4,153,140,13,140054,Донецька область
4604,140055,588,9,399,262,137,140055,Донецька область
4605,140056,806,7,387,362,25,140056,Донецька область
4606,140057,326,13,178,154,24,140057,Донецька область
4607,140058,1005,14,594,487,107,140058,Донецька область
4608,140059,916,14,660,451,209,140059,Донецька область
4609,140060,569,4,368,342,26,140060,Донецька область
4610,140061,565,8,346,296,50,140061,Донецька область
4611,140062,503,5,306,289,17,140062,Донецька область
4612,140063,146,0,100,65,35,140063,Донецька область
4613,140064,396,3,215,179,36,140064,Донецька область
4614,140066,583,6,307,279,28,140066,Донецька область
4615,140067,370,1,138,131,7,140067,Донецька область
4616,140068,1225,15,718,672,46,140068,Донецька область
4617,140069,420,5,229,194,35,140069,Донецька область
4618,140070,730,6,365,354,11,140070,Донецька область
4619,140071,451,5,232,215,17,140071,Донецька область
4620,140073,1904,23,765,724,41,140073,Донецька область
4621,140074,1255,18,606,559,47,140074,Донецька область
4622,140075,1462,11,822,744,78,140075,Донецька область
4623,140076,218,4,125,110,15,140076,Донецька область
4624,140077,220,3,166,146,20,140077,Донецька область
4625,140078,343,0,196,186,10,140078,Донецька область
4626,140079,502,4,283,261,22,140079,Донецька область
4627,140080,512,3,282,265,17,140080,Донецька область
4628,140081,1479,16,921,867,54,140081,Донецька область
4629,140082,309,5,137,121,16,140082,Донецька область
4630,140083,278,3,180,165,15,140083,Донецька область
4631,140084,489,4,335,261,74,140084,Донецька область
4632,140085,511,4,267,243,24,140085,Донецька область
4633,140086,972,8,500,476,24,140086,Донецька область
4634,140603,615,7,318,292,26,140603,Донецька область
4635,140604,1461,17,791,738,53,140604,Донецька область
4636,140605,1589,26,883,789,94,140605,Донецька область
4637,140606,1341,14,757,705,52,140606,Донецька область
4638,140607,986,17,507,450,57,140607,Донецька область
4639,140608,749,9,379,350,29,140608,Донецька область
4640,140609,1009,29,667,538,129,140609,Донецька область
4641,140610,840,15,479,416,63,140610,Донецька область
4642,140611,1183,10,689,644,45,140611,Донецька область
4643,140612,1146,27,642,569,73,140612,Донецька область
4644,140613,1372,20,845,753,92,140613,Донецька область
4645,140614,888,10,533,466,67,140614,Донецька область
4646,140615,1413,20,847,781,66,140615,Донецька область
4647,140616,1743,24,996,917,79,140616,Донецька область
4648,140617,1873,23,930,841,89,140617,Донецька область
4649,140618,2013,31,1187,1106,81,140618,Донецька область
4650,140619,995,16,582,514,68,140619,Донецька область
4651,140620,1321,12,774,713,61,140620,Донецька область
4652,140621,1460,24,816,757,59,140621,Донецька область
4653,140622,1173,23,680,614,66,140622,Донецька область
4654,140623,1564,30,896,829,67,140623,Донецька область
4655,140624,1920,35,1109,1021,88,140624,Донецька область
4656,140625,2123,32,1252,1158,94,140625,Донецька область
4657,140626,2056,25,1195,1086,109,140626,Донецька область
4658,140627,1791,29,1000,920,80,140627,Донецька область
4659,140628,1779,29,998,905,93,140628,Донецька область
4660,140629,1166,21,620,569,51,140629,Донецька область
4661,140630,1585,22,826,743,83,140630,Донецька область
4662,140631,1514,22,848,775,73,140631,Донецька область
4663,140632,1636,31,883,800,83,140632,Донецька область
4664,140633,1146,23,638,581,57,140633,Донецька область
4665,140634,1323,13,813,767,46,140634,Донецька область
4666,140635,1451,21,791,750,41,140635,Донецька область
4667,140636,1871,34,1050,973,77,140636,Донецька область
4668,140637,1576,20,824,760,64,140637,Донецька область
4669,140638,1696,30,945,877,68,140638,Донецька область
4670,140639,2143,21,1151,1076,75,140639,Донецька область
4671,140641,1816,18,936,897,39,140641,Донецька область
4672,140642,441,7,278,250,28,140642,Донецька область
4673,140643,536,7,250,244,6,140643,Донецька область
4674,140644,882,4,407,382,25,140644,Донецька область
4675,140645,1836,19,1146,1087,59,140645,Донецька область
4676,140646,1865,27,1141,1094,47,140646,Донецька область
4677,140647,1636,22,904,857,47,140647,Донецька область
4678,140648,841,7,407,391,16,140648,Донецька область
4679,140649,854,12,393,383,10,140649,Донецька область
4680,140650,1083,19,498,457,41,140650,Донецька область
4681,140651,753,3,383,322,61,140651,Донецька область
4682,140652,894,12,416,373,43,140652,Донецька область
4683,140653,882,11,420,378,42,140653,Донецька область
4684,140654,675,13,357,306,51,140654,Донецька область
4685,140655,627,7,291,239,52,140655,Донецька область
4686,140656,725,7,365,320,45,140656,Донецька область
4687,140657,1523,21,741,696,45,140657,Донецька область
4688,140658,899,6,484,436,48,140658,Донецька область
4689,140659,929,9,526,480,46,140659,Донецька область
4690,140660,1276,16,640,599,41,140660,Донецька область
4691,140661,112,2,106,93,13,140661,Донецька область
4692,141098,1996,36,1167,1056,111,141098,Донецька область
4693,141099,1769,34,1063,973,90,141099,Донецька область
4694,141100,1486,18,883,807,76,141100,Донецька область
4695,141101,1451,24,837,793,44,141101,Донецька область
4696,141102,804,6,414,363,51,141102,Донецька область
4697,141103,279,5,173,147,26,141103,Донецька область
4698,141104,1278,10,755,683,72,141104,Донецька область
4699,141105,965,10,562,512,50,141105,Донецька область
4700,141106,1190,13,567,513,54,141106,Донецька область
4701,141107,1227,18,654,595,59,141107,Донецька область
4702,141108,860,9,428,410,18,141108,Донецька область
4703,141109,667,36,350,316,34,141109,Донецька область
4704,141110,1749,18,924,875,49,141110,Донецька область
4705,141111,1377,15,710,659,51,141111,Донецька область
4706,141112,1256,8,677,646,31,141112,Донецька область
4707,141113,1791,9,996,933,63,141113,Донецька область
4708,141114,284,3,174,122,52,141114,Донецька область
4709,141115,213,1,163,92,71,141115,Донецька область
4710,141116,427,3,254,238,16,141116,Донецька область
4711,141117,253,2,173,123,50,141117,Донецька область
4712,141118,152,2,105,60,45,141118,Донецька область
4713,141119,239,4,166,113,53,141119,Донецька область
4714,141120,909,7,456,427,29,141120,Донецька область
4715,141121,706,3,352,327,25,141121,Донецька область
4716,141122,373,0,204,175,29,141122,Донецька область
4717,141123,973,14,591,535,56,141123,Донецька область
4718,141124,1024,10,533,505,28,141124,Донецька область
4719,141125,1048,10,535,467,68,141125,Донецька область
4720,141126,558,8,275,251,24,141126,Донецька область
4721,141127,270,1,147,132,15,141127,Донецька область
4722,141128,1067,12,685,612,73,141128,Донецька область
4723,141129,1330,16,777,687,90,141129,Донецька область
4724,141130,149,3,117,98,19,141130,Донецька область
4725,141131,718,5,394,340,54,141131,Донецька область
4726,141132,682,3,344,302,42,141132,Донецька область
4727,141133,335,3,188,154,34,141133,Донецька область
4728,141134,955,9,653,477,176,141134,Донецька область
4729,141135,854,10,393,372,21,141135,Донецька область
4730,141136,173,2,87,79,8,141136,Донецька область
4731,141137,314,4,151,128,23,141137,Донецька область
4732,141138,569,2,298,267,31,141138,Донецька область
4733,141139,945,14,580,524,56,141139,Донецька область
4734,141140,425,2,236,214,22,141140,Донецька область
4735,141141,439,2,254,235,19,141141,Донецька область
4736,141142,386,3,251,220,31,141142,Донецька область
4737,141143,80,0,78,62,16,141143,Донецька область
4738,141144,57,1,44,40,4,141144,Донецька область
4739,142443,96,4,92,86,6,142443,Донецька область
4740,1,63,1,60,50,10,1,Донецька область
4741,140393,1479,18,1108,794,314,140393,Донецька область
4742,140394,1450,16,991,811,180,140394,Донецька область
4743,140395,379,2,316,211,105,140395,Донецька область
4744,140396,952,6,611,496,115,140396,Донецька область
4745,140397,535,4,365,308,57,140397,Донецька область
4746,140398,607,7,335,288,47,140398,Донецька область
4747,140399,452,4,294,255,39,140399,Донецька область
4748,140400,1356,17,828,777,51,140400,Донецька область
4749,140401,417,2,248,225,23,140401,Донецька область
4750,140402,655,7,477,365,112,140402,Донецька область
4751,140403,642,6,497,418,79,140403,Донецька область
4752,140404,484,2,308,277,31,140404,Донецька область
4753,140405,375,3,243,219,24,140405,Донецька область
4754,140406,654,2,394,357,37,140406,Донецька область
4755,140407,685,13,464,380,84,140407,Донецька область
4756,140408,511,7,302,284,18,140408,Донецька область
4757,140409,870,10,526,494,32,140409,Донецька область
4758,140410,605,9,431,339,92,140410,Донецька область
4759,140411,1004,9,658,616,42,140411,Донецька область
4760,140433,857,8,500,464,36,140433,Донецька область
4761,140434,429,4,239,224,15,140434,Донецька область
4762,140435,524,10,252,232,20,140435,Донецька область
4763,140436,1531,16,879,825,54,140436,Донецька область
4764,140437,985,14,521,480,41,140437,Донецька область
4765,140438,652,7,385,349,36,140438,Донецька область
4766,140439,515,11,349,330,19,140439,Донецька область
4767,140440,1166,8,584,540,44,140440,Донецька область
4768,140441,1613,10,734,656,78,140441,Донецька область
4769,140442,1405,14,784,722,62,140442,Донецька область
4770,140443,1433,12,797,740,57,140443,Донецька область
4771,140444,1197,15,729,651,78,140444,Донецька область
4772,140445,831,4,515,407,108,140445,Донецька область
4773,140446,466,7,236,214,22,140446,Донецька область
4774,140447,361,0,214,193,21,140447,Донецька область
4775,140448,838,6,376,354,22,140448,Донецька область
4776,140449,1508,15,762,698,64,140449,Донецька область
4777,140450,1108,16,706,661,45,140450,Донецька область
4778,140451,469,12,313,265,48,140451,Донецька область
4779,140452,414,7,229,209,20,140452,Донецька область
4780,140453,823,9,416,382,34,140453,Донецька область
4781,140454,392,3,241,217,24,140454,Донецька область
4782,140455,367,2,210,182,28,140455,Донецька область
4783,140456,523,5,241,218,23,140456,Донецька область
4784,140457,622,18,319,271,48,140457,Донецька область
4785,140458,786,9,309,289,20,140458,Донецька область
4786,140459,422,8,232,213,19,140459,Донецька область
4787,140460,637,4,380,357,23,140460,Донецька область
4788,140461,504,8,275,257,18,140461,Донецька область
4789,140462,1040,19,539,502,37,140462,Донецька область
4790,141184,1519,14,690,634,56,141184,Донецька область
4791,141185,1824,25,844,783,61,141185,Донецька область
4792,141186,1643,28,875,782,93,141186,Донецька область
4793,141187,1809,21,949,821,128,141187,Донецька область
4794,141188,1162,12,614,557,57,141188,Донецька область
4795,141189,1968,33,1124,988,136,141189,Донецька область
4796,141190,1700,28,940,837,103,141190,Донецька область
4797,141191,1696,31,842,759,83,141191,Донецька область
4798,141192,1636,24,864,782,82,141192,Донецька область
4799,141193,1861,36,991,890,101,141193,Донецька область
4800,141194,1297,25,654,594,60,141194,Донецька область
4801,141195,1663,26,908,806,102,141195,Донецька область
4802,141196,1865,33,1065,946,119,141196,Донецька область
4803,141197,2030,29,1156,1030,126,141197,Донецька область
4804,141198,1710,36,1033,880,153,141198,Донецька область
4805,141199,1260,23,742,645,97,141199,Донецька область
4806,141200,2003,34,1193,1050,143,141200,Донецька область
4807,141201,2170,28,1225,1077,148,141201,Донецька область
4808,141202,1518,15,778,681,97,141202,Донецька область
4809,141203,1496,16,696,598,98,141203,Донецька область
4810,141204,1868,29,901,829,72,141204,Донецька область
4811,141205,1925,27,1081,997,84,141205,Донецька область
4812,141206,1771,28,959,860,99,141206,Донецька область
4813,141207,1766,27,961,863,98,141207,Донецька область
4814,141208,998,15,498,446,52,141208,Донецька область
4815,141209,1399,14,828,727,101,141209,Донецька область
4816,141210,2029,26,1224,1090,134,141210,Донецька область
4817,141211,2146,32,1268,1133,135,141211,Донецька область
4818,141212,2280,28,1321,1183,138,141212,Донецька область
4819,141213,2149,33,1208,1078,130,141213,Донецька область
4820,141214,2297,29,1249,1153,96,141214,Донецька область
4821,141215,445,7,223,210,13,141215,Донецька область
4822,141216,2081,29,1163,1018,145,141216,Донецька область
4823,141217,1825,27,885,775,110,141217,Донецька область
4824,141218,1971,32,1112,970,142,141218,Донецька область
4825,141219,1723,28,914,825,89,141219,Донецька область
4826,141220,1340,21,713,635,78,141220,Донецька область
4827,141221,1704,26,1061,932,129,141221,Донецька область
4828,141222,1466,24,794,738,56,141222,Донецька область
4829,141223,1567,10,621,571,50,141223,Донецька область
4830,141224,1155,15,596,555,41,141224,Донецька область
4831,141225,1624,23,917,828,89,141225,Донецька область
4832,141226,2096,30,979,906,73,141226,Донецька область
4833,141227,1287,15,716,649,67,141227,Донецька область
4834,141228,1508,12,799,711,88,141228,Донецька область
4835,141229,815,19,469,392,77,141229,Донецька область
4836,141230,1167,11,623,576,47,141230,Донецька область
4837,141231,1443,7,635,570,65,141231,Донецька область
4838,141232,1861,25,913,835,78,141232,Донецька область
4839,141233,1940,30,1025,937,88,141233,Донецька область
4840,141234,1944,39,876,812,64,141234,Донецька область
4841,141235,2020,24,1036,961,75,141235,Донецька область
4842,141236,1832,32,909,844,65,141236,Донецька область
4843,141237,1864,18,1104,999,105,141237,Донецька область
4844,141238,1490,63,786,687,99,141238,Донецька область
4845,141239,1273,24,762,661,101,141239,Донецька область
4846,141240,18,0,18,13,5,141240,Донецька область
4847,141241,14,0,14,8,6,141241,Донецька область
4848,141243,12,0,12,6,6,141243,Донецька область
4849,141244,125,15,102,76,26,141244,Донецька область
4850,141245,25,0,18,12,6,141245,Донецька область
4851,141246,39,0,38,30,8,141246,Донецька область
4852,141247,57,0,49,36,13,141247,Донецька область
4853,141248,132,3,118,104,14,141248,Донецька область
4854,2,833,22,767,387,380,2,Донецька область
4855,3,1923,53,1683,735,948,3,Донецька область
4856,140970,1625,27,1024,907,117,140970,Донецька область
4857,140971,1546,28,953,826,127,140971,Донецька область
4858,140972,1678,21,1024,908,116,140972,Донецька область
4859,140973,2004,41,1273,1121,152,140973,Донецька область
4860,140974,1763,25,1067,953,114,140974,Донецька область
4861,140975,1819,16,1070,958,112,140975,Донецька область
4862,140976,2225,32,1229,1042,187,140976,Донецька область
4863,140977,2220,32,1216,1042,174,140977,Донецька область
4864,140978,1998,30,1235,1089,146,140978,Донецька область
4865,140979,1800,24,1084,961,123,140979,Донецька область
4866,140980,1829,29,1030,944,86,140980,Донецька область
4867,140981,2037,21,1161,1036,125,140981,Донецька область
4868,140982,1636,20,877,802,75,140982,Донецька область
4869,140983,1962,24,1143,1059,84,140983,Донецька область
4870,140984,2128,19,1187,1076,111,140984,Донецька область
4871,140985,517,2,303,262,41,140985,Донецька область
4872,140986,1708,26,771,689,82,140986,Донецька область
4873,140987,1612,15,788,691,97,140987,Донецька область
4874,140988,1596,18,795,713,82,140988,Донецька область
4875,140989,1256,14,598,560,38,140989,Донецька область
4876,140990,1348,24,761,703,58,140990,Донецька область
4877,140991,2104,17,1049,932,117,140991,Донецька область
4878,140992,1221,16,659,602,57,140992,Донецька область
4879,140993,1387,19,804,746,58,140993,Донецька область
4880,140994,1432,19,729,662,67,140994,Донецька область
4881,140995,2070,18,1055,937,118,140995,Донецька область
4882,140996,1714,21,864,783,81,140996,Донецька область
4883,140997,1907,34,1112,995,117,140997,Донецька область
4884,140998,2025,31,1079,948,131,140998,Донецька область
4885,140999,1518,15,896,772,124,140999,Донецька область
4886,141000,1460,14,835,718,117,141000,Донецька область
4887,141001,2031,28,1103,994,109,141001,Донецька область
4888,141002,1671,20,834,770,64,141002,Донецька область
4889,141003,1484,27,748,681,67,141003,Донецька область
4890,141004,1070,11,543,486,57,141004,Донецька область
4891,141005,1152,10,552,483,69,141005,Донецька область
4892,141006,2033,24,1164,1016,148,141006,Донецька область
4893,141007,1643,23,809,731,78,141007,Донецька область
4894,141008,1881,20,961,861,100,141008,Донецька область
4895,141009,1649,16,894,793,101,141009,Донецька область
4896,141010,1843,22,970,849,121,141010,Донецька область
4897,141011,2006,24,1160,1014,146,141011,Донецька область
4898,141012,1899,25,1063,921,142,141012,Донецька область
4899,141013,1119,16,617,548,69,141013,Донецька область
4900,141014,1123,11,557,488,69,141014,Донецька область
4901,141015,1955,28,1127,958,169,141015,Донецька область
4902,141016,1527,28,989,818,171,141016,Донецька область
4903,141017,1630,20,944,829,115,141017,Донецька область
4904,141018,1929,36,1131,965,166,141018,Донецька область
4905,141019,1965,43,1112,962,150,141019,Донецька область
4906,141020,1786,14,1023,885,138,141020,Донецька область
4907,141021,1669,18,901,728,173,141021,Донецька область
4908,141022,1928,32,1146,972,174,141022,Донецька область
4909,141023,1814,25,1129,968,161,141023,Донецька область
4910,141024,1953,21,1215,1038,177,141024,Донецька область
4911,141025,1943,33,1247,1069,178,141025,Донецька область
4912,141026,1818,33,1184,995,189,141026,Донецька область
4913,141027,2050,32,1298,1111,187,141027,Донецька область
4914,141028,2093,32,1241,1095,146,141028,Донецька область
4915,141029,2164,36,1266,1091,175,141029,Донецька область
4916,141030,1954,28,1215,1038,177,141030,Донецька область
4917,141031,2091,41,1251,1087,164,141031,Донецька область
4918,141032,1977,37,1199,1025,174,141032,Донецька область
4919,141033,2111,20,1265,1112,153,141033,Донецька область
4920,141034,1592,18,977,822,155,141034,Донецька область
4921,141035,1907,22,1180,1014,166,141035,Донецька область
4922,141036,1781,34,1110,927,183,141036,Донецька область
4923,141037,1535,24,922,805,117,141037,Донецька область
4924,141038,1636,29,1034,893,141,141038,Донецька область
4925,141039,1340,14,818,689,129,141039,Донецька область
4926,141040,1845,29,1127,928,199,141040,Донецька область
4927,141041,1624,23,956,831,125,141041,Донецька область
4928,141042,1507,38,861,705,156,141042,Донецька область
4929,141043,1692,26,988,876,112,141043,Донецька область
4930,141044,1536,33,924,802,122,141044,Донецька область
4931,141045,2047,33,1138,962,176,141045,Донецька область
4932,141046,1288,24,751,644,107,141046,Донецька область
4933,141047,1408,18,816,698,118,141047,Донецька область
4934,141048,1524,24,951,770,181,141048,Донецька область
4935,141049,1370,37,859,728,131,141049,Донецька область
4936,141050,1477,26,881,734,147,141050,Донецька область
4937,141051,2033,35,1239,1017,222,141051,Донецька область
4938,141052,1959,32,1214,988,226,141052,Донецька область
4939,141053,121,7,81,73,8,141053,Донецька область
4940,141054,111,12,97,84,13,141054,Донецька область
4941,141055,52,0,44,36,8,141055,Донецька область
4942,141056,35,1,33,26,7,141056,Донецька область
4943,141057,34,1,33,28,5,141057,Донецька область
4944,141058,36,0,33,29,4,141058,Донецька область
4945,142444,18,1,13,9,4,142444,Донецька область
4946,1,1195,27,963,469,494,1,Донецька область
4947,2,136,0,129,38,91,2,Донецька область
4948,3,381,5,372,224,148,3,Донецька область
4949,4,294,10,259,138,121,4,Донецька область
4950,140246,668,25,452,416,36,140246,Донецька область
4951,140247,381,2,207,196,11,140247,Донецька область
4952,140248,421,5,265,203,62,140248,Донецька область
4953,140249,315,6,193,160,33,140249,Донецька область
4954,140250,576,6,336,285,51,140250,Донецька область
4955,140251,1160,12,826,673,153,140251,Донецька область
4956,140252,437,6,393,263,130,140252,Донецька область
4957,140255,1425,21,797,745,52,140255,Донецька область
4958,140256,239,6,233,210,23,140256,Донецька область
4959,140257,156,3,99,65,34,140257,Донецька область
4960,140258,386,10,210,193,17,140258,Донецька область
4961,140259,297,0,190,156,34,140259,Донецька область
4962,140260,358,3,292,248,44,140260,Донецька область
4963,140261,726,6,462,401,61,140261,Донецька область
4964,140262,181,8,105,94,11,140262,Донецька область
4965,140263,179,2,102,89,13,140263,Донецька область
4966,140264,335,5,211,197,14,140264,Донецька область
4967,140265,278,1,190,164,26,140265,Донецька область
4968,140266,303,2,177,153,24,140266,Донецька область
4969,140267,281,2,185,152,33,140267,Донецька область
4970,140268,676,0,308,253,55,140268,Донецька область
4971,140271,290,3,177,143,34,140271,Донецька область
4972,140272,505,9,370,337,33,140272,Донецька область
4973,140273,509,2,279,259,20,140273,Донецька область
4974,140274,426,2,246,199,47,140274,Донецька область
4975,140275,281,2,155,120,35,140275,Донецька область
4976,140276,435,8,233,215,18,140276,Донецька область
4977,140277,313,7,153,135,18,140277,Донецька область
4978,140278,363,3,185,156,29,140278,Донецька область
4979,140279,121,0,61,44,17,140279,Донецька область
4980,140280,394,4,256,239,17,140280,Донецька область
4981,140281,2140,23,1179,1090,89,140281,Донецька область
4982,140283,1431,23,824,791,33,140283,Донецька область
4983,140284,1175,15,721,694,27,140284,Донецька область
4984,140285,1625,7,980,918,62,140285,Донецька область
4985,140287,1555,10,925,872,53,140287,Донецька область
4986,140288,922,10,466,417,49,140288,Донецька область
4987,140289,411,3,408,369,39,140289,Донецька область
4988,140290,1736,19,1072,933,139,140290,Донецька область
4989,140291,1292,22,626,558,68,140291,Донецька область
4990,140293,437,3,268,223,45,140293,Донецька область
4991,140294,987,6,669,511,158,140294,Донецька область
4992,140295,656,10,344,319,25,140295,Донецька область
4993,140296,606,19,298,266,32,140296,Донецька область
4994,140297,1138,3,628,573,55,140297,Донецька область
4995,140298,949,11,512,475,37,140298,Донецька область
4996,140299,454,7,261,231,30,140299,Донецька область
4997,140300,1021,6,632,594,38,140300,Донецька область
4998,140301,921,11,442,408,34,140301,Донецька область
4999,140303,1222,7,661,575,86,140303,Донецька область
5000,140304,1074,7,580,539,41,140304,Донецька область
5001,140305,484,4,315,276,39,140305,Донецька область
5002,140804,1620,16,855,806,49,140804,Донецька область
5003,140805,2076,18,994,934,60,140805,Донецька область
5004,140806,1459,22,649,600,49,140806,Донецька область
5005,140807,1408,15,642,613,29,140807,Донецька область
5006,140808,2191,25,1044,974,70,140808,Донецька область
5007,140809,2215,39,1131,1046,85,140809,Донецька область
5008,140810,2220,27,1160,1067,93,140810,Донецька область
5009,140811,936,14,512,479,33,140811,Донецька область
5010,140812,1269,16,714,672,42,140812,Донецька область
5011,140813,1365,15,723,659,64,140813,Донецька область
5012,140814,1270,11,730,690,40,140814,Донецька область
5013,140815,1957,19,988,934,54,140815,Донецька область
5014,140816,1641,23,902,837,65,140816,Донецька область
5015,140817,1394,18,814,763,51,140817,Донецька область
5016,140818,2228,32,1199,1108,91,140818,Донецька область
5017,140819,2032,16,1095,1024,71,140819,Донецька область
5018,140820,2271,24,1206,1113,93,140820,Донецька область
5019,140821,2256,28,1204,1123,81,140821,Донецька область
5020,140822,2246,27,1228,1133,95,140822,Донецька область
5021,140823,2079,33,1160,1072,88,140823,Донецька область
5022,140824,1743,10,910,856,54,140824,Донецька область
5023,140825,1560,16,907,842,65,140825,Донецька область
5024,140826,1414,26,796,766,30,140826,Донецька область
5025,140827,1270,15,703,584,119,140827,Донецька область
5026,140828,1292,7,598,562,36,140828,Донецька область
5027,140829,1498,20,721,702,19,140829,Донецька область
5028,140830,1687,14,889,822,67,140830,Донецька область
5029,140831,1252,7,701,644,57,140831,Донецька область
5030,140832,113,2,109,85,24,140832,Донецька область
5031,140833,61,2,56,21,35,140833,Донецька область
5032,140834,48,0,46,31,15,140834,Донецька область
5033,140930,1423,21,762,708,54,140930,Донецька область
5034,140931,1328,10,635,610,25,140931,Донецька область
5035,140932,1763,30,825,756,69,140932,Донецька область
5036,140933,1878,20,961,909,52,140933,Донецька область
5037,140935,1678,29,844,774,70,140935,Донецька область
5038,140936,1824,30,837,785,52,140936,Донецька область
5039,140937,1830,20,829,783,46,140937,Донецька область
5040,140938,1612,23,748,709,39,140938,Донецька область
5041,140939,1677,15,744,694,50,140939,Донецька область
5042,140940,1569,12,620,579,41,140940,Донецька область
5043,140941,1634,23,719,677,42,140941,Донецька область
5044,140942,1194,20,555,518,37,140942,Донецька область
5045,140943,1739,29,842,810,32,140943,Донецька область
5046,140944,1717,18,722,676,46,140944,Донецька область
5047,140945,1926,24,855,793,62,140945,Донецька область
5048,140946,1657,19,765,719,46,140946,Донецька область
5049,140947,1838,33,890,833,57,140947,Донецька область
5050,140948,1075,8,549,508,41,140948,Донецька область
5051,140949,1385,29,718,651,67,140949,Донецька область
5052,140950,1445,22,814,777,37,140950,Донецька область
5053,140951,1188,16,639,590,49,140951,Донецька область
5054,140952,1275,18,635,587,48,140952,Донецька область
5055,140953,1652,17,1067,889,178,140953,Донецька область
5056,140954,1732,26,947,885,62,140954,Донецька область
5057,140955,1681,21,893,844,49,140955,Донецька область
5058,140956,1553,19,817,774,43,140956,Донецька область
5059,140957,1442,16,715,680,35,140957,Донецька область
5060,140958,1556,16,819,761,58,140958,Донецька область
5061,140959,1803,26,855,808,47,140959,Донецька область
5062,140960,1529,18,804,751,53,140960,Донецька область
5063,140961,1141,20,565,518,47,140961,Донецька область
5064,140962,1299,19,654,591,63,140962,Донецька область
5065,140963,1651,22,787,736,51,140963,Донецька область
5066,140964,1585,15,784,741,43,140964,Донецька область
5067,140965,1197,11,577,555,22,140965,Донецька область
5068,140966,1281,22,669,634,35,140966,Донецька область
5069,140967,1436,12,739,687,52,140967,Донецька область
5070,140968,67,0,67,59,8,140968,Донецька область
5071,140969,90,4,82,74,8,140969,Донецька область
5072,1,101,3,98,51,47,1,Донецька область
5073,2,700,20,655,387,268,2,Донецька область
5074,140220,1440,17,931,858,73,140220,Донецька область
5075,140221,412,3,260,244,16,140221,Донецька область
5076,140222,394,2,292,266,26,140222,Донецька область
5077,140223,1280,16,719,689,30,140223,Донецька область
5078,140224,257,3,151,148,3,140224,Донецька область
5079,140225,323,6,180,163,17,140225,Донецька область
5080,140226,802,8,444,385,59,140226,Донецька область
5081,140227,377,4,235,212,23,140227,Донецька область
5082,140228,373,2,230,213,17,140228,Донецька область
5083,140229,447,6,270,239,31,140229,Донецька область
5084,140230,244,1,117,105,12,140230,Донецька область
5085,140231,147,0,68,64,4,140231,Донецька область
5086,140232,215,2,149,117,32,140232,Донецька область
5087,140233,1060,17,675,605,70,140233,Донецька область
5088,140234,857,14,530,489,41,140234,Донецька область
5089,140235,288,5,159,151,8,140235,Донецька область
5090,140236,443,3,308,270,38,140236,Донецька область
5091,140237,576,5,387,361,26,140237,Донецька область
5092,140238,208,0,126,121,5,140238,Донецька область
5093,140239,669,0,372,328,44,140239,Донецька область
5094,140240,575,5,295,240,55,140240,Донецька область
5095,140243,135,1,78,73,5,140243,Донецька область
5096,140244,350,6,220,200,20,140244,Донецька область
5097,140245,304,2,211,205,6,140245,Донецька область
5098,140738,1722,25,746,689,57,140738,Донецька область
5099,140739,1819,18,1037,972,65,140739,Донецька область
5100,140740,1629,21,880,836,44,140740,Донецька область
5101,140741,1447,22,752,705,47,140741,Донецька область
5102,140742,1931,37,1019,965,54,140742,Донецька область
5103,140743,1591,18,886,808,78,140743,Донецька область
5104,140744,1377,13,749,693,56,140744,Донецька область
5105,140745,1765,28,986,931,55,140745,Донецька область
5106,140746,1998,21,1388,1017,371,140746,Донецька область
5107,140747,1887,20,1078,1006,72,140747,Донецька область
5108,140748,1953,28,1122,1027,95,140748,Донецька область
5109,140749,2140,12,1147,1091,56,140749,Донецька область
5110,140750,2097,24,1237,1135,102,140750,Донецька область
5111,140751,1900,18,1070,1003,67,140751,Донецька область
5112,140752,1556,21,807,755,52,140752,Донецька область
5113,140753,2013,29,1128,1037,91,140753,Донецька область
5114,140754,1971,23,1066,998,68,140754,Донецька область
5115,140755,2025,19,1039,990,49,140755,Донецька область
5116,140756,1846,31,968,883,85,140756,Донецька область
5117,140757,1655,27,912,852,60,140757,Донецька область
5118,140758,92,2,85,84,1,140758,Донецька область
5119,140759,34,2,32,30,2,140759,Донецька область
5120,140760,1834,25,1156,1074,82,140760,Донецька область
5121,140761,720,14,416,383,33,140761,Донецька область
5122,140762,2289,21,1339,1223,116,140762,Донецька область
5123,140763,2226,32,1358,1265,93,140763,Донецька область
5124,140764,1924,33,1183,1064,119,140764,Донецька область
5125,140765,1594,26,948,878,70,140765,Донецька область
5126,140766,1661,24,973,909,64,140766,Донецька область
5127,140767,1559,25,981,897,84,140767,Донецька область
5128,140768,1684,21,1080,992,88,140768,Донецька область
5129,140769,1954,27,1250,1152,98,140769,Донецька область
5130,140770,1352,25,838,775,63,140770,Донецька область
5131,140771,1954,36,1145,1074,71,140771,Донецька область
5132,140772,2026,36,1152,1078,74,140772,Донецька область
5133,140773,1722,24,965,899,66,140773,Донецька область
5134,140774,1337,13,820,752,68,140774,Донецька область
5135,140775,1139,24,646,588,58,140775,Донецька область
5136,140776,1156,18,643,578,65,140776,Донецька область
5137,140777,1457,15,779,739,40,140777,Донецька область
5138,140778,1602,14,1007,952,55,140778,Донецька область
5139,140779,1060,22,631,588,43,140779,Донецька область
5140,140780,1609,21,894,851,43,140780,Донецька область
5141,140781,1553,15,969,902,67,140781,Донецька область
5142,140782,1708,16,1013,971,42,140782,Донецька область
5143,140783,1567,11,903,868,35,140783,Донецька область
5144,140784,1455,15,823,777,46,140784,Донецька область
5145,140785,1165,11,658,619,39,140785,Донецька область
5146,140786,1296,20,789,740,49,140786,Донецька область
5147,140787,1832,24,1095,1053,42,140787,Донецька область
5148,140788,1913,27,1092,1056,36,140788,Донецька область
5149,140789,126,2,119,107,12,140789,Донецька область
5150,141059,1521,18,962,922,40,141059,Донецька область
5151,141060,1559,25,935,894,41,141060,Донецька область
5152,141061,1464,25,862,823,39,141061,Донецька область
5153,141062,1831,14,1104,1047,57,141062,Донецька область
5154,141063,1392,26,777,734,43,141063,Донецька область
5155,141064,1283,14,687,645,42,141064,Донецька область
5156,141065,713,10,455,425,30,141065,Донецька область
5157,141066,1450,34,793,748,45,141066,Донецька область
5158,141067,1291,15,761,712,49,141067,Донецька область
5159,141068,2132,21,1133,1050,83,141068,Донецька область
5160,141069,2192,21,1209,1129,80,141069,Донецька область
5161,141070,1272,8,621,592,29,141070,Донецька область
5162,141071,2027,29,1232,1162,70,141071,Донецька область
5163,141072,1409,18,633,589,44,141072,Донецька область
5164,141073,2031,29,1086,1007,79,141073,Донецька область
5165,141074,1316,27,765,672,93,141074,Донецька область
5166,141075,1368,22,780,709,71,141075,Донецька область
5167,141076,1366,20,799,696,103,141076,Донецька область
5168,141077,2099,26,1156,1069,87,141077,Донецька область
5169,141079,2155,18,1025,953,72,141079,Донецька область
5170,141080,1522,14,808,760,48,141080,Донецька область
5171,141082,1385,20,850,742,108,141082,Донецька область
5172,141083,1546,21,913,845,68,141083,Донецька область
5173,141084,1320,13,757,689,68,141084,Донецька область
5174,141085,2019,25,1111,1015,96,141085,Донецька область
5175,141086,2020,26,1266,1161,105,141086,Донецька область
5176,141087,1977,35,1174,1077,97,141087,Донецька область
5177,141088,1960,33,1188,1102,86,141088,Донецька область
5178,141089,2070,29,1221,1138,83,141089,Донецька область
5179,141090,2066,20,1292,1199,93,141090,Донецька область
5180,141091,1905,28,1093,1017,76,141091,Донецька область
5181,141092,1999,13,1220,1142,78,141092,Донецька область
5182,141093,1972,24,1262,1168,94,141093,Донецька область
5183,141094,707,16,405,374,31,141094,Донецька область
5184,141095,68,0,59,55,4,141095,Донецька область
5185,141096,31,0,28,27,1,141096,Донецька область
5186,141097,22,0,22,21,1,141097,Донецька область
5187,141523,471,8,214,137,77,141523,Донецька область
5188,141527,2210,1,288,196,92,141527,Донецька область
5189,1,610,22,539,152,387,1,Донецька область
5190,2,254,40,211,63,148,2,Донецька область
5191,3,198,3,192,79,113,3,Донецька область
5192,140681,1818,23,722,684,38,140681,Донецька область
5193,140682,1907,39,757,715,42,140682,Донецька область
5194,140683,1577,26,698,648,50,140683,Донецька область
5195,140684,2102,29,1013,963,50,140684,Донецька область
5196,140685,2016,30,906,874,32,140685,Донецька область
5197,140686,1915,33,928,887,41,140686,Донецька область
5198,140687,2267,47,1035,982,53,140687,Донецька область
5199,140690,53,2,43,41,2,140690,Донецька область
5200,140691,1073,20,475,376,99,140691,Донецька область
5201,140692,1008,23,514,474,40,140692,Донецька область
5202,140693,807,14,408,391,17,140693,Донецька область
5203,140694,1266,9,603,559,44,140694,Донецька область
5204,140695,1188,21,505,461,44,140695,Донецька область
5205,140696,1479,28,691,652,39,140696,Донецька область
5206,140697,1615,18,864,804,60,140697,Донецька область
5207,140698,1606,29,786,731,55,140698,Донецька область
5208,140699,1094,27,544,498,46,140699,Донецька область
5209,140700,1046,13,491,468,23,140700,Донецька область
5210,140701,1300,17,561,511,50,140701,Донецька область
5211,140702,1588,33,775,725,50,140702,Донецька область
5212,140703,1258,25,640,543,97,140703,Донецька область
5213,140704,761,7,252,236,16,140704,Донецька область
5214,140705,829,11,334,323,11,140705,Донецька область
5215,140706,827,11,300,277,23,140706,Донецька область
5216,140707,965,14,351,310,41,140707,Донецька область
5217,140708,452,5,176,158,18,140708,Донецька область
5218,140709,1582,24,693,572,121,140709,Донецька область
5219,140710,1769,40,821,769,52,140710,Донецька область
5220,140711,1659,27,727,674,53,140711,Донецька область
5221,140712,597,6,193,183,10,140712,Донецька область
5222,140713,981,12,394,374,20,140713,Донецька область
5223,140714,1093,11,423,394,29,140714,Донецька область
5224,140717,785,8,233,204,29,140717,Донецька область
5225,140718,1518,17,539,517,22,140718,Донецька область
5226,140719,876,7,299,274,25,140719,Донецька область
5227,140720,1908,26,882,829,53,140720,Донецька область
5228,140721,1743,26,768,740,28,140721,Донецька область
5229,140722,1163,25,535,487,48,140722,Донецька область
5230,140723,800,14,416,389,27,140723,Донецька область
5231,140724,1341,26,841,733,108,140724,Донецька область
5232,140725,1331,21,661,603,58,140725,Донецька область
5233,140726,601,8,287,269,18,140726,Донецька область
5234,140727,1292,16,527,493,34,140727,Донецька область
5235,140728,1522,29,661,616,45,140728,Донецька область
5236,140729,624,14,318,294,24,140729,Донецька область
5237,140730,656,6,289,256,33,140730,Донецька область
5238,140731,449,3,256,218,38,140731,Донецька область
5239,140732,422,6,223,197,26,140732,Донецька область
5240,140733,1145,0,687,631,56,140733,Донецька область
5241,140734,1024,11,510,466,44,140734,Донецька область
5242,140735,656,7,368,340,28,140735,Донецька область
5243,140736,68,3,64,53,11,140736,Донецька область
5244,140737,544,38,493,475,18,140737,Донецька область
5245,1,432,39,393,380,13,1,Донецька область
5246,2,903,23,681,521,160,2,Донецька область
5247,3,607,19,581,262,319,3,Донецька область
5248,4,1942,32,1291,754,537,4,Донецька область
5249,5,897,21,833,521,312,5,Донецька область
5250,142297,1750,15,1020,983,37,142297,Донецька область
5251,142298,1531,7,817,794,23,142298,Донецька область
5252,142299,1382,18,808,754,54,142299,Донецька область
5253,142300,1361,8,756,726,30,142300,Донецька область
5254,142301,572,1,273,265,8,142301,Донецька область
5255,142302,1333,5,847,798,49,142302,Донецька область
5256,142303,1584,21,1026,954,72,142303,Донецька область
5257,142304,1923,17,1169,1084,85,142304,Донецька область
5258,142305,1919,14,1211,1125,86,142305,Донецька область
5259,142306,1748,17,1023,959,64,142306,Донецька область
5260,142307,1950,13,1229,1135,94,142307,Донецька область
5261,142308,1781,38,1010,940,70,142308,Донецька область
5262,142309,1791,18,1058,1007,51,142309,Донецька область
5263,142310,1263,12,502,483,19,142310,Донецька область
5264,142311,1266,20,573,535,38,142311,Донецька область
5265,142312,1714,21,1084,1000,84,142312,Донецька область
5266,142313,1602,21,966,899,67,142313,Донецька область
5267,142314,1827,28,992,945,47,142314,Донецька область
5268,142315,1742,26,896,835,61,142315,Донецька область
5269,142316,1121,20,641,608,33,142316,Донецька область
5270,142317,1253,11,674,625,49,142317,Донецька область
5271,142318,907,13,466,441,25,142318,Донецька область
5272,142319,1607,14,783,759,24,142319,Донецька область
5273,142320,922,6,434,397,37,142320,Донецька область
5274,142321,936,15,485,461,24,142321,Донецька область
5275,142322,1101,13,532,507,25,142322,Донецька область
5276,142323,1629,29,894,829,65,142323,Донецька область
5277,142324,987,21,529,511,18,142324,Донецька область
5278,142325,1262,9,687,670,17,142325,Донецька область
5279,142326,1688,30,840,789,51,142326,Донецька область
5280,142327,2003,22,917,879,38,142327,Донецька область
5281,142328,618,6,331,315,16,142328,Донецька область
5282,142329,1134,17,608,587,21,142329,Донецька область
5283,142330,1152,11,645,622,23,142330,Донецька область
5284,142331,1183,13,686,668,18,142331,Донецька область
5285,142332,835,12,525,507,18,142332,Донецька область
5286,142333,1507,18,926,889,37,142333,Донецька область
5287,142334,1403,18,826,776,50,142334,Донецька область
5288,142335,1589,27,874,838,36,142335,Донецька область
5289,142337,1643,19,985,926,59,142337,Донецька область
5290,142338,1313,20,713,674,39,142338,Донецька область
5291,142339,1075,13,564,517,47,142339,Донецька область
5292,142340,1368,10,696,649,47,142340,Донецька область
5293,142341,2015,29,1173,1114,59,142341,Донецька область
5294,142342,1192,19,685,641,44,142342,Донецька область
5295,142343,1462,20,821,789,32,142343,Донецька область
5296,142344,2220,18,1241,1204,37,142344,Донецька область
5297,142345,2305,15,1270,1228,42,142345,Донецька область
5298,142346,2122,16,1165,1136,29,142346,Донецька область
5299,142347,1172,13,623,602,21,142347,Донецька область
5300,142348,1555,16,860,843,17,142348,Донецька область
5301,142349,372,3,202,197,5,142349,Донецька область
5302,142351,27,0,27,21,6,142351,Донецька область
5303,142352,141,9,129,122,7,142352,Донецька область
5304,142353,30,0,28,28,0,142353,Донецька область
5305,142355,71,2,69,67,2,142355,Донецька область
5306,142356,569,3,308,283,25,142356,Донецька область
5307,142357,1473,18,859,785,74,142357,Донецька область
5308,142358,1564,23,901,833,68,142358,Донецька область
5309,142359,2010,33,1216,1142,74,142359,Донецька область
5310,142360,1776,24,1077,990,87,142360,Донецька область
5311,142361,1061,13,597,549,48,142361,Донецька область
5312,142362,1008,17,593,554,39,142362,Донецька область
5313,142363,1468,22,936,863,73,142363,Донецька область
5314,142364,1434,16,851,780,71,142364,Донецька область
5315,142365,1548,31,871,812,59,142365,Донецька область
5316,142366,1642,21,933,856,77,142366,Донецька область
5317,142367,1681,10,1069,990,79,142367,Донецька область
5318,142368,1718,23,1023,939,84,142368,Донецька область
5319,142369,1837,8,709,667,42,142369,Донецька область
5320,142370,1784,22,1008,936,72,142370,Донецька область
5321,142371,1036,12,618,582,36,142371,Донецька область
5322,142372,1256,19,755,703,52,142372,Донецька область
5323,142373,1192,25,725,656,69,142373,Донецька область
5324,142374,1099,17,649,608,41,142374,Донецька область
5325,142375,1248,12,743,681,62,142375,Донецька область
5326,142376,1124,14,668,612,56,142376,Донецька область
5327,142377,1632,11,770,728,42,142377,Донецька область
5328,142378,1329,17,737,691,46,142378,Донецька область
5329,142379,1337,17,808,751,57,142379,Донецька область
5330,142380,1365,11,838,793,45,142380,Донецька область
5331,142381,1718,21,1022,965,57,142381,Донецька область
5332,142382,1694,22,1009,935,74,142382,Донецька область
5333,142383,1449,22,753,705,48,142383,Донецька область
5334,142384,1535,25,922,847,75,142384,Донецька область
5335,142385,1747,14,957,898,59,142385,Донецька область
5336,142386,1651,20,883,832,51,142386,Донецька область
5337,142387,2080,31,1187,1090,97,142387,Донецька область
5338,142388,1776,24,1097,1022,75,142388,Донецька область
5339,142389,1784,17,1078,1003,75,142389,Донецька область
5340,142390,1056,16,637,597,40,142390,Донецька область
5341,142391,1165,15,690,640,50,142391,Донецька область
5342,142392,1286,23,751,697,54,142392,Донецька область
5343,142393,1623,20,897,839,58,142393,Донецька область
5344,142394,1825,26,1028,957,71,142394,Донецька область
5345,142395,1914,24,1104,1039,65,142395,Донецька область
5346,142396,1685,20,984,912,72,142396,Донецька область
5347,142397,1579,18,984,935,49,142397,Донецька область
5348,142398,1485,15,910,862,48,142398,Донецька область
5349,142399,2005,32,1121,1050,71,142399,Донецька область
5350,142400,1148,14,715,677,38,142400,Донецька область
5351,142401,1446,16,861,810,51,142401,Донецька область
5352,142402,2149,29,1230,1170,60,142402,Донецька область
5353,142403,2380,31,1370,1299,71,142403,Донецька область
5354,142404,1409,19,803,745,58,142404,Донецька область
5355,142405,2129,26,1218,1142,76,142405,Донецька область
5356,142406,1436,21,872,812,60,142406,Донецька область
5357,142407,2119,26,1237,1172,65,142407,Донецька область
5358,142408,118,1,106,96,10,142408,Донецька область
5359,142409,60,1,58,54,4,142409,Донецька область
5360,142410,126,0,93,85,8,142410,Донецька область
5361,142411,177,10,164,145,19,142411,Донецька область
5362,142227,1048,16,541,519,22,142227,Донецька область
5363,142228,1180,8,560,552,8,142228,Донецька область
5364,142229,1459,15,891,819,72,142229,Донецька область
5365,142230,1462,19,908,861,47,142230,Донецька область
5366,142231,1173,11,608,576,32,142231,Донецька область
5367,142232,1917,19,1212,1130,82,142232,Донецька область
5368,142233,1894,29,1006,928,78,142233,Донецька область
5369,142234,1214,16,785,736,49,142234,Донецька область
5370,142235,2028,29,1282,1164,118,142235,Донецька область
5371,142236,2273,16,1140,1040,100,142236,Донецька область
5372,142237,1103,20,645,583,62,142237,Донецька область
5373,142238,1071,19,629,524,105,142238,Донецька область
5374,142239,2213,48,1326,1174,152,142239,Донецька область
5375,142240,1591,14,855,764,91,142240,Донецька область
5376,142241,682,8,385,331,54,142241,Донецька область
5377,142242,1982,25,1122,1015,107,142242,Донецька область
5378,142243,1279,20,725,623,102,142243,Донецька область
5379,142244,1792,33,1073,925,148,142244,Донецька область
5380,142245,1462,31,855,786,69,142245,Донецька область
5381,142246,1549,22,890,799,91,142246,Донецька область
5382,142247,1257,18,773,688,85,142247,Донецька область
5383,142248,1682,22,1032,927,105,142248,Донецька область
5384,142249,2039,26,1175,1079,96,142249,Донецька область
5385,142250,1455,27,849,780,69,142250,Донецька область
5386,142251,1152,16,719,669,50,142251,Донецька область
5387,142252,1995,29,1358,1243,115,142252,Донецька область
5388,142253,2119,29,1266,1150,116,142253,Донецька область
5389,142254,1846,35,1153,1062,91,142254,Донецька область
5390,142255,1852,22,1083,977,106,142255,Донецька область
5391,142256,1869,26,1100,1012,88,142256,Донецька область
5392,142257,1924,21,1198,1093,105,142257,Донецька область
5393,142258,968,22,567,512,55,142258,Донецька область
5394,142259,2192,28,1335,1221,114,142259,Донецька область
5395,142260,2061,25,1219,1108,111,142260,Донецька область
5396,142261,2011,13,1218,1128,90,142261,Донецька область
5397,142262,2002,24,1220,1125,95,142262,Донецька область
5398,142263,2032,27,1275,1158,117,142263,Донецька область
5399,142264,1973,29,1208,1107,101,142264,Донецька область
5400,142265,939,9,595,548,47,142265,Донецька область
5401,142266,1905,29,1222,1133,89,142266,Донецька область
5402,142267,1562,23,944,873,71,142267,Донецька область
5403,142268,2044,26,1307,1198,109,142268,Донецька область
5404,142269,2100,36,1207,1130,77,142269,Донецька область
5405,142270,2193,24,1323,1213,110,142270,Донецька область
5406,142271,1176,7,652,614,38,142271,Донецька область
5407,142272,1754,22,1111,1017,94,142272,Донецька область
5408,142273,1987,33,1304,1218,86,142273,Донецька область
5409,142274,1930,22,1156,1070,86,142274,Донецька область
5410,142275,1797,23,1113,1029,84,142275,Донецька область
5411,142276,1817,21,1109,1026,83,142276,Донецька область
5412,142277,1851,11,1182,1102,80,142277,Донецька область
5413,142278,2044,27,1197,1112,85,142278,Донецька область
5414,142279,1442,13,874,792,82,142279,Донецька область
5415,142280,1953,26,1208,1116,92,142280,Донецька область
5416,142281,2173,40,1338,1249,89,142281,Донецька область
5417,142282,2198,26,1335,1236,99,142282,Донецька область
5418,142283,2035,30,1209,1116,93,142283,Донецька область
5419,142284,1817,20,1090,1039,51,142284,Донецька область
5420,142285,2073,31,1306,1225,81,142285,Донецька область
5421,142286,2080,29,1366,1278,88,142286,Донецька область
5422,142287,1381,20,809,763,46,142287,Донецька область
5423,142288,1216,12,677,645,32,142288,Донецька область
5424,142289,2053,22,1128,1036,92,142289,Донецька область
5425,142290,1272,7,681,642,39,142290,Донецька область
5426,142291,1328,8,721,675,46,142291,Донецька область
5427,142292,1955,23,1121,1066,55,142292,Донецька область
5428,142293,144,3,95,87,8,142293,Донецька область
5429,142294,16,0,16,14,2,142294,Донецька область
5430,142295,32,1,30,27,3,142295,Донецька область
5431,142296,90,0,77,70,7,142296,Донецька область
5432,142412,1658,19,899,824,75,142412,Донецька область
5433,142413,932,9,564,503,61,142413,Донецька область
5434,142414,1415,13,868,788,80,142414,Донецька область
5435,142415,1717,34,939,845,94,142415,Донецька область
5436,142416,1765,26,1021,907,114,142416,Донецька область
5437,142417,1591,20,935,861,74,142417,Донецька область
5438,142418,1303,29,712,653,59,142418,Донецька область
5439,142419,1857,38,1026,954,72,142419,Донецька область
5440,142420,1528,26,948,868,80,142420,Донецька область
5441,142421,1618,36,928,824,104,142421,Донецька область
5442,142422,1593,35,887,802,85,142422,Донецька область
5443,142423,1616,10,877,784,93,142423,Донецька область
5444,142424,1351,9,775,715,60,142424,Донецька область
5445,142425,1931,23,1167,1079,88,142425,Донецька область
5446,142426,2000,21,1217,1125,92,142426,Донецька область
5447,142427,1231,18,680,626,54,142427,Донецька область
5448,142428,2114,29,1268,1141,127,142428,Донецька область
5449,142429,2069,28,1263,1141,122,142429,Донецька область
5450,142430,1243,17,688,614,74,142430,Донецька область
5451,142431,1671,24,930,862,68,142431,Донецька область
5452,142432,1497,17,818,750,68,142432,Донецька область
5453,142433,1681,10,907,798,109,142433,Донецька область
5454,142434,1185,17,606,571,35,142434,Донецька область
5455,142435,1877,28,1183,1072,111,142435,Донецька область
5456,142436,1723,13,902,852,50,142436,Донецька область
5457,142437,1763,28,861,785,76,142437,Донецька область
5458,142438,30,0,27,15,12,142438,Донецька область
5459,142439,134,1,115,103,12,142439,Донецька область
5460,1,137,7,121,87,34,1,Донецька область
5461,2,167,1,166,44,122,2,Донецька область
5462,3,260,21,233,33,200,3,Донецька область
5463,4,163,1,162,31,131,4,Донецька область
5464,5,228,10,216,25,191,5,Донецька область
5465,6,266,5,260,15,245,6,Донецька область
5466,7,83,0,83,23,60,7,Донецька область
5467,8,325,6,307,126,181,8,Донецька область
5468,9,875,101,767,363,404,9,Донецька область
5469,10,346,22,316,82,234,10,Донецька область
5470,11,294,10,283,135,148,11,Донецька область
5471,12,251,23,227,92,135,12,Донецька область
5472,13,380,14,360,125,235,13,Донецька область
5473,14,100,4,96,37,59,14,Донецька область
5474,15,604,17,587,280,307,15,Донецька область
5475,140087,868,13,446,386,60,140087,Донецька область
5476,140088,1388,17,934,743,191,140088,Донецька область
5477,140089,1959,21,1063,938,125,140089,Донецька область
5478,140090,1417,26,778,714,64,140090,Донецька область
5479,140091,879,17,546,460,86,140091,Донецька область
5480,140093,491,8,300,231,69,140093,Донецька область
5481,140094,477,4,321,257,64,140094,Донецька область
5482,140095,875,9,459,430,29,140095,Донецька область
5483,140096,309,5,155,140,15,140096,Донецька область
5484,140097,1117,27,696,633,63,140097,Донецька область
5485,140098,650,12,482,400,82,140098,Донецька область
5486,140099,328,10,215,199,16,140099,Донецька область
5487,140100,511,3,345,280,65,140100,Донецька область
5488,140102,489,5,370,293,77,140102,Донецька область
5489,140103,561,12,389,291,98,140103,Донецька область
5490,140104,1299,27,683,633,50,140104,Донецька область
5491,140105,560,5,320,267,53,140105,Донецька область
5492,140107,763,7,463,432,31,140107,Донецька область
5493,140108,561,7,361,318,43,140108,Донецька область
5494,140109,586,13,422,344,78,140109,Донецька область
5495,140110,1478,30,796,709,87,140110,Донецька область
5496,140111,994,7,488,427,61,140111,Донецька область
5497,140112,376,3,245,203,42,140112,Донецька область
5498,140113,441,4,307,276,31,140113,Донецька область
5499,140114,556,5,426,389,37,140114,Донецька область
5500,140115,462,5,304,297,7,140115,Донецька область
5501,140116,397,6,249,221,28,140116,Донецька область
5502,140117,738,8,534,445,89,140117,Донецька область
5503,140118,203,2,153,116,37,140118,Донецька область
5504,140119,284,0,152,124,28,140119,Донецька область
5505,140120,645,13,397,359,38,140120,Донецька область
5506,140121,457,6,310,263,47,140121,Донецька область
5507,140122,693,9,401,367,34,140122,Донецька область
5508,140123,221,4,126,118,8,140123,Донецька область
5509,140124,506,11,316,268,48,140124,Донецька область
5510,140125,176,6,121,100,21,140125,Донецька область
5511,140126,683,10,445,352,93,140126,Донецька область
5512,140127,1229,17,638,521,117,140127,Донецька область
5513,140128,1074,12,594,530,64,140128,Донецька область
5514,140130,393,1,238,190,48,140130,Донецька область
5515,140131,202,3,147,115,32,140131,Донецька область
5516,140132,731,11,402,376,26,140132,Донецька область
5517,140133,262,3,208,170,38,140133,Донецька область
5518,140134,273,3,206,159,47,140134,Донецька область
5519,140135,385,9,301,254,47,140135,Донецька область
5520,140136,885,9,625,478,147,140136,Донецька область
5521,140306,1802,66,720,567,153,140306,Донецька область
5522,140307,1532,35,710,533,177,140307,Донецька область
5523,140308,1144,5,472,223,249,140308,Донецька область
5524,140309,1328,16,692,418,274,140309,Донецька область
5525,140310,1312,53,369,339,30,140310,Донецька область
5526,140311,1075,0,563,384,179,140311,Донецька область
5527,140312,832,4,668,381,287,140312,Донецька область
5528,140313,1222,7,543,260,283,140313,Донецька область
5529,140314,1064,7,737,230,507,140314,Донецька область
5530,140315,1348,25,570,386,184,140315,Донецька область
5531,140316,1353,21,723,259,464,140316,Донецька область
5532,140317,1477,25,716,258,458,140317,Донецька область
5533,140318,1128,6,548,162,386,140318,Донецька область
5534,140319,947,9,362,236,126,140319,Донецька область
5535,140320,953,8,380,219,161,140320,Донецька область
5536,140321,1557,29,859,809,50,140321,Донецька область
5537,140322,1937,37,1087,1009,78,140322,Донецька область
5538,140323,1788,26,938,866,72,140323,Донецька область
5539,140324,1591,23,919,824,95,140324,Донецька область
5540,140325,1374,17,650,598,52,140325,Донецька область
5541,140326,1648,32,861,803,58,140326,Донецька область
5542,140327,1918,20,1051,965,86,140327,Донецька область
5543,140328,1561,31,785,704,81,140328,Донецька область
5544,140329,611,5,239,223,16,140329,Донецька область
5545,140330,867,4,392,361,31,140330,Донецька область
5546,140331,465,3,204,190,14,140331,Донецька область
5547,140332,282,4,190,124,66,140332,Донецька область
5548,140338,1057,13,522,482,40,140338,Донецька область
5549,140339,1151,21,640,424,216,140339,Донецька область
5550,140340,1277,21,606,570,36,140340,Донецька область
5551,140341,384,10,166,141,25,140341,Донецька область
5552,140342,286,0,256,174,82,140342,Донецька область
5553,140343,286,6,220,141,79,140343,Донецька область
5554,140344,1402,36,698,624,74,140344,Донецька область
5555,140345,997,15,463,383,80,140345,Донецька область
5556,140346,851,10,487,418,69,140346,Донецька область
5557,140347,995,14,600,430,170,140347,Донецька область
5558,140350,1567,27,757,670,87,140350,Донецька область
5559,140351,790,27,346,304,42,140351,Донецька область
5560,140352,1154,22,472,418,54,140352,Донецька область
5561,140353,959,12,494,469,25,140353,Донецька область
5562,140354,1069,5,602,519,83,140354,Донецька область
5563,140355,468,4,322,267,55,140355,Донецька область
5564,140356,465,8,330,250,80,140356,Донецька область
5565,140357,1709,28,959,870,89,140357,Донецька область
5566,140358,1008,31,538,434,104,140358,Донецька область
5567,140359,344,8,204,154,50,140359,Донецька область
5568,140360,240,5,151,133,18,140360,Донецька область
5569,140361,389,8,242,193,49,140361,Донецька область
5570,140362,665,6,410,309,101,140362,Донецька область
5571,140364,30,0,29,23,6,140364,Донецька область
5572,140365,101,1,85,75,10,140365,Донецька область
5573,140662,2259,37,1242,1151,91,140662,Донецька область
5574,140663,1647,20,957,884,73,140663,Донецька область
5575,140664,1689,23,976,907,69,140664,Донецька область
5576,140665,1697,23,1025,938,87,140665,Донецька область
5577,140666,1683,18,1018,952,66,140666,Донецька область
5578,140667,1640,29,945,863,82,140667,Донецька область
5579,140668,1634,17,935,863,72,140668,Донецька область
5580,141145,905,14,504,458,46,141145,Донецька область
5581,141146,1102,15,592,568,24,141146,Донецька область
5582,141147,856,3,482,436,46,141147,Донецька область
5583,141148,1785,25,917,858,59,141148,Донецька область
5584,141149,2133,29,1112,1063,49,141149,Донецька область
5585,141150,1824,19,904,839,65,141150,Донецька область
5586,141151,1320,28,768,637,131,141151,Донецька область
5587,141152,1221,22,634,579,55,141152,Донецька область
5588,141153,1409,16,782,707,75,141153,Донецька область
5589,141154,1453,22,805,630,175,141154,Донецька область
5590,141155,1714,25,933,873,60,141155,Донецька область
5591,141156,1058,12,517,482,35,141156,Донецька область
5592,141157,1826,20,958,879,79,141157,Донецька область
5593,141158,1568,21,819,744,75,141158,Донецька область
5594,141159,1916,30,1099,980,119,141159,Донецька область
5595,141160,1252,22,656,592,64,141160,Донецька область
5596,141161,1640,20,833,718,115,141161,Донецька область
5597,141162,1682,9,913,840,73,141162,Донецька область
5598,141163,1515,20,834,794,40,141163,Донецька область
5599,141164,1516,16,761,728,33,141164,Донецька область
5600,141165,203,3,121,106,15,141165,Донецька область
5601,141166,264,9,204,120,84,141166,Донецька область
5602,141167,1706,20,830,786,44,141167,Донецька область
5603,141168,1603,32,666,633,33,141168,Донецька область
5604,141169,1454,28,695,628,67,141169,Донецька область
5605,141170,1134,74,707,645,62,141170,Донецька область
5606,141171,1462,8,687,645,42,141171,Донецька область
5607,141172,1421,22,517,477,40,141172,Донецька область
5608,141173,2148,32,912,853,59,141173,Донецька область
5609,141174,1454,25,685,647,38,141174,Донецька область
5610,141175,1454,11,585,567,18,141175,Донецька область
5611,141176,1777,30,816,736,80,141176,Донецька область
5612,141177,662,4,300,279,21,141177,Донецька область
5613,141178,1533,18,633,591,42,141178,Донецька область
5614,141179,1100,13,447,410,37,141179,Донецька область
5615,141180,546,3,266,252,14,141180,Донецька область
5616,141181,938,15,630,598,32,141181,Донецька область
5617,141182,542,4,268,248,20,141182,Донецька область
5618,141183,706,43,638,607,31,141183,Донецька область
5619,1,541,28,500,227,273,1,Донецька область
5620,2,767,25,669,382,287,2,Донецька область
5621,3,341,18,319,122,197,3,Донецька область
5622,4,307,28,231,133,98,4,Донецька область
5623,5,272,26,245,118,127,5,Донецька область
5624,6,94,3,82,31,51,6,Донецька область
5625,7,773,76,634,402,232,7,Донецька область
5626,8,318,25,293,102,191,8,Донецька область
5627,9,489,36,437,209,228,9,Донецька область
5628,10,194,3,183,74,109,10,Донецька область
5629,11,106,4,100,42,58,11,Донецька область
5630,12,318,15,285,209,76,12,Донецька область
5631,13,224,5,214,132,82,13,Донецька область
5632,14,122,6,112,94,18,14,Донецька область
5633,15,492,23,263,154,109,15,Донецька область
5634,16,319,12,272,47,225,16,Донецька область
5635,140137,1396,17,745,703,42,140137,Донецька область
5636,140138,1475,11,827,772,55,140138,Донецька область
5637,140139,1146,27,667,628,39,140139,Донецька область
5638,140140,1236,17,680,653,27,140140,Донецька область
5639,140141,1492,19,885,809,76,140141,Донецька область
5640,140142,1918,27,1098,984,114,140142,Донецька область
5641,140143,2229,40,1261,1093,168,140143,Донецька область
5642,140144,1238,21,667,598,69,140144,Донецька область
5643,140145,1233,15,671,600,71,140145,Донецька область
5644,140146,1627,23,891,819,72,140146,Донецька область
5645,140147,2279,32,1364,1232,132,140147,Донецька область
5646,140148,1070,25,502,468,34,140148,Донецька область
5647,140149,1966,23,953,902,51,140149,Донецька область
5648,140150,1772,27,757,704,53,140150,Донецька область
5649,140151,1301,16,640,554,86,140151,Донецька область
5650,140152,1921,24,1135,1089,46,140152,Донецька область
5651,140153,1930,17,1139,1070,69,140153,Донецька область
5652,140154,1682,31,833,740,93,140154,Донецька область
5653,140155,1763,35,679,627,52,140155,Донецька область
5654,140156,1941,27,946,866,80,140156,Донецька область
5655,140159,1769,56,641,565,76,140159,Донецька область
5656,140160,871,8,390,318,72,140160,Донецька область
5657,140161,558,11,409,348,61,140161,Донецька область
5658,140164,969,8,507,485,22,140164,Донецька область
5659,140165,922,20,521,452,69,140165,Донецька область
5660,140166,758,9,528,482,46,140166,Донецька область
5661,140167,918,12,461,452,9,140167,Донецька область
5662,140168,630,12,409,388,21,140168,Донецька область
5663,140169,421,3,251,227,24,140169,Донецька область
5664,140170,374,6,198,186,12,140170,Донецька область
5665,140171,2289,29,1033,988,45,140171,Донецька область
5666,140172,690,5,358,324,34,140172,Донецька область
5667,140173,433,1,253,238,15,140173,Донецька область
5668,140174,692,4,385,366,19,140174,Донецька область
5669,140175,580,7,424,322,102,140175,Донецька область
5670,140177,1450,16,763,704,59,140177,Донецька область
5671,140178,994,20,523,491,32,140178,Донецька область
5672,140179,537,6,256,238,18,140179,Донецька область
5673,140180,453,4,257,251,6,140180,Донецька область
5674,140181,554,8,310,292,18,140181,Донецька область
5675,140182,447,8,227,201,26,140182,Донецька область
5676,140183,651,11,407,360,47,140183,Донецька область
5677,140184,715,9,427,383,44,140184,Донецька область
5678,140185,597,7,334,302,32,140185,Донецька область
5679,140186,519,4,276,254,22,140186,Донецька область
5680,140187,1074,16,586,546,40,140187,Донецька область
5681,140188,950,21,514,498,16,140188,Донецька область
5682,140189,487,6,193,183,10,140189,Донецька область
5683,140190,645,13,390,335,55,140190,Донецька область
5684,140191,1248,18,827,792,35,140191,Донецька область
5685,140192,758,16,515,465,50,140192,Донецька область
5686,140193,920,10,555,509,46,140193,Донецька область
5687,140194,119,2,114,104,10,140194,Донецька область
5688,140196,1542,21,941,891,50,140196,Донецька область
5689,140197,1725,27,1059,1002,57,140197,Донецька область
5690,140198,1696,18,998,958,40,140198,Донецька область
5691,140199,1530,19,1083,1014,69,140199,Донецька область
5692,140200,358,2,241,238,3,140200,Донецька область
5693,140201,726,3,483,454,29,140201,Донецька область
5694,140202,771,11,477,450,27,140202,Донецька область
5695,140203,330,3,224,173,51,140203,Донецька область
5696,140204,508,3,392,369,23,140204,Донецька область
5697,140205,372,2,233,216,17,140205,Донецька область
5698,140206,1884,20,1174,1106,68,140206,Донецька область
5699,140207,1055,11,639,620,19,140207,Донецька область
5700,140208,398,3,233,219,14,140208,Донецька область
5701,140209,712,3,506,485,21,140209,Донецька область
5702,140210,843,8,631,608,23,140210,Донецька область
5703,140211,886,4,575,555,20,140211,Донецька область
5704,140212,1494,7,899,876,23,140212,Донецька область
5705,140213,389,5,215,206,9,140213,Донецька область
5706,140214,850,7,563,529,34,140214,Донецька область
5707,140215,823,4,518,465,53,140215,Донецька область
5708,140216,1331,18,927,904,23,140216,Донецька область
5709,140218,1241,15,687,644,43,140218,Донецька область
5710,140376,938,1,554,520,34,140376,Донецька область
5711,140377,847,10,482,466,16,140377,Донецька область
5712,140379,192,0,1,1,0,140379,Донецька область
5713,140382,731,5,381,368,13,140382,Донецька область
5714,140383,610,4,377,361,16,140383,Донецька область
5715,140384,493,2,284,257,27,140384,Донецька область
5716,140392,1024,5,249,212,37,140392,Донецька область
5717,140412,1059,8,704,649,55,140412,Донецька область
5718,140413,1032,9,621,578,43,140413,Донецька область
5719,140414,1171,7,768,710,58,140414,Донецька область
5720,140415,1140,6,737,680,57,140415,Донецька область
5721,140416,1066,12,686,636,50,140416,Донецька область
5722,140417,1205,12,728,718,10,140417,Донецька область
5723,140418,1791,21,1140,1092,48,140418,Донецька область
5724,140419,941,10,603,577,26,140419,Донецька область
5725,140420,266,8,177,164,13,140420,Донецька область
5726,140421,286,4,175,162,13,140421,Донецька область
5727,140422,1257,11,756,701,55,140422,Донецька область
5728,140423,638,7,374,340,34,140423,Донецька область
5729,140424,1335,10,785,732,53,140424,Донецька область
5730,140425,685,9,410,379,31,140425,Донецька область
5731,140426,568,2,357,317,40,140426,Донецька область
5732,140427,987,10,569,534,35,140427,Донецька область
5733,140428,613,3,372,339,33,140428,Донецька область
5734,140429,597,10,327,310,17,140429,Донецька область
5735,140430,522,4,315,299,16,140430,Донецька область
5736,140431,430,2,265,232,33,140431,Донецька область
5737,140432,1997,20,1234,1147,87,140432,Донецька область
5738,140520,1432,17,561,506,55,140520,Донецька область
5739,140521,1211,11,496,481,15,140521,Донецька область
5740,140527,1366,13,692,586,106,140527,Донецька область
5741,140528,654,5,448,436,12,140528,Донецька область
5742,140529,263,2,201,194,7,140529,Донецька область
5743,140530,291,3,223,180,43,140530,Донецька область
5744,140531,669,11,406,377,29,140531,Донецька область
5745,140532,1127,16,498,471,27,140532,Донецька область
5746,140533,1260,12,763,742,21,140533,Донецька область
5747,140534,190,2,124,117,7,140534,Донецька область
5748,140535,2038,12,1035,991,44,140535,Донецька область
5749,140537,432,2,205,185,20,140537,Донецька область
5750,1,459,42,417,396,21,1,Житомирська область
5751,2,5,1,4,3,1,2,Житомирська область
5752,181338,2364,30,1475,1127,348,181338,Житомирська область
5753,181339,2178,42,1331,1021,310,181339,Житомирська область
5754,181340,1335,15,914,702,212,181340,Житомирська область
5755,181341,2302,37,1437,1112,325,181341,Житомирська область
5756,181342,2025,44,1259,968,291,181342,Житомирська область
5757,181343,1825,33,1158,862,296,181343,Житомирська область
5758,181344,1133,11,688,553,135,181344,Житомирська область
5759,181345,1480,25,992,764,228,181345,Житомирська область
5760,181346,1932,38,1218,987,231,181346,Житомирська область
5761,181347,1922,33,1209,905,304,181347,Житомирська область
5762,181348,2014,35,1202,950,252,181348,Житомирська область
5763,181349,1329,11,876,640,236,181349,Житомирська область
5764,181350,1337,17,888,694,194,181350,Житомирська область
5765,181351,981,19,640,473,167,181351,Житомирська область
5766,181352,1343,14,860,654,206,181352,Житомирська область
5767,181353,1412,26,845,647,198,181353,Житомирська область
5768,181354,837,21,544,399,145,181354,Житомирська область
5769,181355,1272,15,732,584,148,181355,Житомирська область
5770,181356,2019,38,1273,981,292,181356,Житомирська область
5771,181357,1225,17,745,562,183,181357,Житомирська область
5772,181358,1755,34,1151,871,280,181358,Житомирська область
5773,181359,1808,35,1170,887,283,181359,Житомирська область
5774,181360,1385,26,854,668,186,181360,Житомирська область
5775,181361,1690,21,1023,829,194,181361,Житомирська область
5776,181362,1313,21,857,653,204,181362,Житомирська область
5777,181363,2043,36,1224,925,299,181363,Житомирська область
5778,181364,2183,35,1456,1102,354,181364,Житомирська область
5779,181365,2078,24,1282,967,315,181365,Житомирська область
5780,181366,2284,32,1404,1045,359,181366,Житомирська область
5781,181367,2277,20,1474,1116,358,181367,Житомирська область
5782,181368,2165,23,1459,1126,333,181368,Житомирська область
5783,181369,1663,40,1136,843,293,181369,Житомирська область
5784,181370,2036,37,1313,982,331,181370,Житомирська область
5785,181371,2277,39,1491,1108,383,181371,Житомирська область
5786,181372,2098,41,1234,924,310,181372,Житомирська область
5787,181382,2185,45,1431,1050,381,181382,Житомирська область
5788,181383,2272,33,1312,1078,234,181383,Житомирська область
5789,181384,1614,24,964,760,204,181384,Житомирська область
5790,181385,1867,47,1205,892,313,181385,Житомирська область
5791,181386,2112,43,1386,1114,272,181386,Житомирська область
5792,181388,1959,32,1161,745,416,181388,Житомирська область
5793,181389,1234,27,801,440,361,181389,Житомирська область
5794,181399,102,3,97,74,23,181399,Житомирська область
5795,181400,56,0,56,48,8,181400,Житомирська область
5796,181401,23,0,23,17,6,181401,Житомирська область
5797,181402,748,32,706,646,60,181402,Житомирська область
5798,181403,369,27,332,302,30,181403,Житомирська область
5799,181404,1487,22,861,669,192,181404,Житомирська область
5800,181405,1619,34,1021,753,268,181405,Житомирська область
5801,181406,1954,30,1201,972,229,181406,Житомирська область
5802,181407,2016,27,1278,983,295,181407,Житомирська область
5803,181408,2017,30,1263,970,293,181408,Житомирська область
5804,181409,2211,34,1335,1036,299,181409,Житомирська область
5805,181410,2119,32,1379,1071,308,181410,Житомирська область
5806,181411,1232,22,762,585,177,181411,Житомирська область
5807,181412,2029,36,1252,986,266,181412,Житомирська область
5808,181413,1838,32,1146,859,287,181413,Житомирська область
5809,181414,1614,36,1020,765,255,181414,Житомирська область
5810,181415,1915,25,1173,899,274,181415,Житомирська область
5811,181416,1059,24,664,496,168,181416,Житомирська область
5812,181417,704,16,467,324,143,181417,Житомирська область
5813,181418,1568,44,1032,776,256,181418,Житомирська область
5814,181419,1006,17,629,434,195,181419,Житомирська область
5815,181420,1175,31,712,566,146,181420,Житомирська область
5816,181421,841,12,443,299,144,181421,Житомирська область
5817,181422,1214,35,791,555,236,181422,Житомирська область
5818,181423,1363,29,850,646,204,181423,Житомирська область
5819,181424,1660,24,1113,866,247,181424,Житомирська область
5820,181425,2122,39,1381,1036,345,181425,Житомирська область
5821,181426,1622,32,1068,784,284,181426,Житомирська область
5822,181427,2049,37,1296,982,314,181427,Житомирська область
5823,181428,1982,21,1320,957,363,181428,Житомирська область
5824,181429,2166,52,1434,1051,383,181429,Житомирська область
5825,181430,2061,35,1320,1007,313,181430,Житомирська область
5826,181431,1968,30,1211,899,312,181431,Житомирська область
5827,181432,948,15,641,474,167,181432,Житомирська область
5828,181433,1051,11,505,410,95,181433,Житомирська область
5829,181434,1270,27,721,563,158,181434,Житомирська область
5830,181435,1786,49,1202,900,302,181435,Житомирська область
5831,181436,754,10,467,330,137,181436,Житомирська область
5832,181437,1855,26,1265,929,336,181437,Житомирська область
5833,181438,1984,44,1338,979,359,181438,Житомирська область
5834,181439,1436,20,853,656,197,181439,Житомирська область
5835,181440,2201,35,1304,1038,266,181440,Житомирська область
5836,181441,1138,16,658,531,127,181441,Житомирська область
5837,181442,2044,37,1261,980,281,181442,Житомирська область
5838,181443,1952,32,1215,974,241,181443,Житомирська область
5839,181444,2203,28,1417,1154,263,181444,Житомирська область
5840,181445,2159,35,1247,936,311,181445,Житомирська область
5841,181446,2137,34,1172,895,277,181446,Житомирська область
5842,181447,1549,29,879,707,172,181447,Житомирська область
5843,181448,2165,32,1308,975,333,181448,Житомирська область
5844,181449,2125,50,1330,1064,266,181449,Житомирська область
5845,181450,2254,42,1399,1110,289,181450,Житомирська область
5846,181451,2123,34,1331,1045,286,181451,Житомирська область
5847,181452,2139,39,1387,1064,323,181452,Житомирська область
5848,181453,2039,27,1217,956,261,181453,Житомирська область
5849,181454,1715,23,976,753,223,181454,Житомирська область
5850,181455,77,6,65,49,16,181455,Житомирська область
5851,181456,231,1,192,154,38,181456,Житомирська область
5852,181457,25,0,24,18,6,181457,Житомирська область
5853,181458,78,1,74,57,17,181458,Житомирська область
5854,181459,32,2,30,24,6,181459,Житомирська область
5855,181460,15,0,14,12,2,181460,Житомирська область
5856,180001,1121,16,653,480,173,180001,Житомирська область
5857,180002,972,8,586,478,108,180002,Житомирська область
5858,180003,696,4,396,313,83,180003,Житомирська область
5859,180004,1088,18,616,461,155,180004,Житомирська область
5860,180005,984,13,587,409,178,180005,Житомирська область
5861,180006,677,0,431,334,97,180006,Житомирська область
5862,180007,671,9,370,273,97,180007,Житомирська область
5863,180008,860,9,535,416,119,180008,Житомирська область
5864,180009,1112,16,617,442,175,180009,Житомирська область
5865,180010,973,15,510,320,190,180010,Житомирська область
5866,180011,300,5,164,114,50,180011,Житомирська область
5867,180012,580,13,330,239,91,180012,Житомирська область
5868,180013,309,2,184,147,37,180013,Житомирська область
5869,180014,300,1,180,117,63,180014,Житомирська область
5870,180015,573,9,351,271,80,180015,Житомирська область
5871,180016,336,3,212,158,54,180016,Житомирська область
5872,180017,1772,27,1078,851,227,180017,Житомирська область
5873,180018,415,5,278,181,97,180018,Житомирська область
5874,180019,652,6,352,249,103,180019,Житомирська область
5875,180020,251,1,149,100,49,180020,Житомирська область
5876,180021,153,0,110,84,26,180021,Житомирська область
5877,180022,580,13,371,280,91,180022,Житомирська область
5878,180023,577,4,402,314,88,180023,Житомирська область
5879,180024,534,12,350,235,115,180024,Житомирська область
5880,180025,996,14,493,353,140,180025,Житомирська область
5881,180026,272,4,169,114,55,180026,Житомирська область
5882,180027,629,7,408,317,91,180027,Житомирська область
5883,180028,232,3,135,87,48,180028,Житомирська область
5884,180029,257,5,146,110,36,180029,Житомирська область
5885,180030,232,4,151,101,50,180030,Житомирська область
5886,180031,469,7,271,193,78,180031,Житомирська область
5887,180032,370,4,207,143,64,180032,Житомирська область
5888,180033,383,3,232,171,61,180033,Житомирська область
5889,180034,105,3,78,42,36,180034,Житомирська область
5890,180035,869,14,451,357,94,180035,Житомирська область
5891,180036,1562,32,812,652,160,180036,Житомирська область
5892,180037,279,6,178,136,42,180037,Житомирська область
5893,180038,421,5,280,204,76,180038,Житомирська область
5894,180039,169,2,139,103,36,180039,Житомирська область
5895,180040,914,11,505,305,200,180040,Житомирська область
5896,180041,272,4,143,83,60,180041,Житомирська область
5897,180042,406,7,263,171,92,180042,Житомирська область
5898,180043,151,3,111,69,42,180043,Житомирська область
5899,180044,641,11,341,242,99,180044,Житомирська область
5900,180045,45,0,35,26,9,180045,Житомирська область
5901,180102,2148,18,1371,1072,299,180102,Житомирська область
5902,180103,1372,17,866,677,189,180103,Житомирська область
5903,180104,438,3,257,175,82,180104,Житомирська область
5904,180105,825,6,436,359,77,180105,Житомирська область
5905,180106,301,2,213,100,113,180106,Житомирська область
5906,180107,605,7,325,232,93,180107,Житомирська область
5907,180108,611,15,422,291,131,180108,Житомирська область
5908,180109,232,0,138,107,31,180109,Житомирська область
5909,180110,365,3,216,154,62,180110,Житомирська область
5910,180111,477,3,269,185,84,180111,Житомирська область
5911,180112,118,1,83,67,16,180112,Житомирська область
5912,180113,240,3,134,98,36,180113,Житомирська область
5913,180114,139,0,85,69,16,180114,Житомирська область
5914,180115,53,0,40,31,9,180115,Житомирська область
5915,180116,537,4,317,249,68,180116,Житомирська область
5916,180117,691,12,433,314,119,180117,Житомирська область
5917,180118,225,5,153,107,46,180118,Житомирська область
5918,180119,176,0,108,79,29,180119,Житомирська область
5919,180120,505,5,305,207,98,180120,Житомирська область
5920,180121,418,6,284,177,107,180121,Житомирська область
5921,180122,189,0,115,91,24,180122,Житомирська область
5922,180123,706,9,462,304,158,180123,Житомирська область
5923,180124,196,3,130,80,50,180124,Житомирська область
5924,180125,364,2,229,182,47,180125,Житомирська область
5925,180126,203,4,118,86,32,180126,Житомирська область
5926,180127,738,6,446,379,67,180127,Житомирська область
5927,180128,159,1,103,69,34,180128,Житомирська область
5928,180129,670,10,395,327,68,180129,Житомирська область
5929,180130,99,0,66,45,21,180130,Житомирська область
5930,180131,558,12,409,334,75,180131,Житомирська область
5931,180132,199,3,152,114,38,180132,Житомирська область
5932,180133,770,13,432,331,101,180133,Житомирська область
5933,180134,767,8,453,332,121,180134,Житомирська область
5934,180135,172,0,114,81,33,180135,Житомирська область
5935,180136,831,10,561,399,162,180136,Житомирська область
5936,180137,748,8,440,307,133,180137,Житомирська область
5937,180138,142,0,83,60,23,180138,Житомирська область
5938,180139,306,2,180,147,33,180139,Житомирська область
5939,180140,197,3,107,67,40,180140,Житомирська область
5940,180141,272,3,161,93,68,180141,Житомирська область
5941,180142,179,1,111,73,38,180142,Житомирська область
5942,180143,147,1,82,64,18,180143,Житомирська область
5943,180144,1044,6,598,400,198,180144,Житомирська область
5944,180145,80,1,44,35,9,180145,Житомирська область
5945,180146,602,2,350,262,88,180146,Житомирська область
5946,180147,731,8,399,293,106,180147,Житомирська область
5947,180148,134,0,90,69,21,180148,Житомирська область
5948,180149,340,3,189,123,66,180149,Житомирська область
5949,180150,161,2,80,51,29,180150,Житомирська область
5950,180151,782,6,476,338,138,180151,Житомирська область
5951,180152,629,2,363,248,115,180152,Житомирська область
5952,180153,111,1,75,54,21,180153,Житомирська область
5953,180154,584,21,544,519,25,180154,Житомирська область
5954,180869,964,10,541,438,103,180869,Житомирська область
5955,180870,835,8,424,301,123,180870,Житомирська область
5956,180871,1014,14,553,405,148,180871,Житомирська область
5957,180872,53,1,31,23,8,180872,Житомирська область
5958,180873,1842,36,1153,907,246,180873,Житомирська область
5959,180874,1644,22,925,720,205,180874,Житомирська область
5960,180875,1238,12,788,618,170,180875,Житомирська область
5961,180876,1476,27,801,646,155,180876,Житомирська область
5962,180877,247,2,147,81,66,180877,Житомирська область
5963,180878,272,0,181,141,40,180878,Житомирська область
5964,180879,324,5,207,161,46,180879,Житомирська область
5965,180880,260,3,159,122,37,180880,Житомирська область
5966,180881,335,2,199,147,52,180881,Житомирська область
5967,180882,387,4,251,182,69,180882,Житомирська область
5968,180883,179,3,114,75,39,180883,Житомирська область
5969,180884,1397,8,791,621,170,180884,Житомирська область
5970,180885,590,9,378,288,90,180885,Житомирська область
5971,180886,320,5,236,184,52,180886,Житомирська область
5972,180887,234,7,136,82,54,180887,Житомирська область
5973,180888,355,4,241,164,77,180888,Житомирська область
5974,180889,374,9,227,167,60,180889,Житомирська область
5975,180890,459,9,268,203,65,180890,Житомирська область
5976,180891,192,0,130,86,44,180891,Житомирська область
5977,180892,685,5,455,354,101,180892,Житомирська область
5978,180893,283,10,178,150,28,180893,Житомирська область
5979,180894,295,8,196,145,51,180894,Житомирська область
5980,180895,447,6,289,228,61,180895,Житомирська область
5981,180896,828,12,478,379,99,180896,Житомирська область
5982,180897,105,0,66,42,24,180897,Житомирська область
5983,180898,757,4,500,365,135,180898,Житомирська область
5984,180899,1505,12,934,718,216,180899,Житомирська область
5985,180900,571,8,378,280,98,180900,Житомирська область
5986,180901,461,10,291,200,91,180901,Житомирська область
5987,180902,189,3,108,82,26,180902,Житомирська область
5988,180903,575,12,452,385,67,180903,Житомирська область
5989,180904,585,4,380,250,130,180904,Житомирська область
5990,180905,268,3,160,126,34,180905,Житомирська область
5991,180906,417,9,251,175,76,180906,Житомирська область
5992,180907,207,0,131,88,43,180907,Житомирська область
5993,180908,265,2,163,139,24,180908,Житомирська область
5994,180909,392,2,251,188,63,180909,Житомирська область
5995,180910,932,32,494,338,156,180910,Житомирська область
5996,180912,32,0,28,20,8,180912,Житомирська область
5997,181022,505,4,298,217,81,181022,Житомирська область
5998,181023,991,9,630,431,199,181023,Житомирська область
5999,181024,352,4,238,208,30,181024,Житомирська область
6000,181025,1455,10,736,554,182,181025,Житомирська область
6001,181026,113,0,80,61,19,181026,Житомирська область
6002,181027,340,1,207,140,67,181027,Житомирська область
6003,181028,123,2,62,36,26,181028,Житомирська область
6004,181029,581,3,369,285,84,181029,Житомирська область
6005,181030,141,2,92,63,29,181030,Житомирська область
6006,181031,121,0,85,51,34,181031,Житомирська область
6007,181032,443,3,250,166,84,181032,Житомирська область
6008,181033,803,12,423,285,138,181033,Житомирська область
6009,181034,479,2,338,241,97,181034,Житомирська область
6010,181035,75,0,51,32,19,181035,Житомирська область
6011,181036,320,7,215,114,101,181036,Житомирська область
6012,181037,452,7,240,142,98,181037,Житомирська область
6013,181038,117,2,88,57,31,181038,Житомирська область
6014,181039,384,4,225,185,40,181039,Житомирська область
6015,181040,112,3,69,50,19,181040,Житомирська область
6016,181041,611,3,374,270,104,181041,Житомирська область
6017,181042,234,6,133,86,47,181042,Житомирська область
6018,181043,447,2,363,250,113,181043,Житомирська область
6019,181044,226,4,144,103,41,181044,Житомирська область
6020,181045,84,1,62,50,12,181045,Житомирська область
6021,181046,292,4,189,142,47,181046,Житомирська область
6022,181047,145,2,100,65,35,181047,Житомирська область
6023,181048,246,3,168,118,50,181048,Житомирська область
6024,181049,343,3,207,147,60,181049,Житомирська область
6025,181050,106,1,69,47,22,181050,Житомирська область
6026,181051,771,2,498,350,148,181051,Житомирська область
6027,181052,541,6,328,238,90,181052,Житомирська область
6028,181053,356,3,243,126,117,181053,Житомирська область
6029,181054,315,1,233,188,45,181054,Житомирська область
6030,181055,379,1,303,219,84,181055,Житомирська область
6031,181056,202,2,151,123,28,181056,Житомирська область
6032,181057,628,11,343,264,79,181057,Житомирська область
6033,181058,1799,29,1127,746,381,181058,Житомирська область
6034,181059,2080,27,1247,881,366,181059,Житомирська область
6035,181060,1534,19,937,708,229,181060,Житомирська область
6036,181061,630,2,388,293,95,181061,Житомирська область
6037,181062,627,8,332,274,58,181062,Житомирська область
6038,181063,342,1,219,169,50,181063,Житомирська область
6039,181064,803,14,518,411,107,181064,Житомирська область
6040,181065,17,0,17,15,2,181065,Житомирська область
6041,181225,2299,32,1390,1101,289,181225,Житомирська область
6042,181226,1574,25,949,718,231,181226,Житомирська область
6043,181227,1707,21,1003,810,193,181227,Житомирська область
6044,181228,1345,24,844,646,198,181228,Житомирська область
6045,181229,1236,18,746,565,181,181229,Житомирська область
6046,181230,2336,42,1370,1083,287,181230,Житомирська область
6047,181231,2047,18,1254,921,333,181231,Житомирська область
6048,181232,1897,15,1135,867,268,181232,Житомирська область
6049,181233,2284,51,1358,1011,347,181233,Житомирська область
6050,181234,1126,13,643,529,114,181234,Житомирська область
6051,181235,1727,14,1051,793,258,181235,Житомирська область
6052,181236,1283,11,739,569,170,181236,Житомирська область
6053,181237,2089,21,1280,915,365,181237,Житомирська область
6054,181238,1842,27,1104,886,218,181238,Житомирська область
6055,181239,1770,23,989,816,173,181239,Житомирська область
6056,181240,1901,33,1092,843,249,181240,Житомирська область
6057,181241,1889,26,1114,884,230,181241,Житомирська область
6058,181242,1332,14,793,628,165,181242,Житомирська область
6059,181243,1562,17,993,788,205,181243,Житомирська область
6060,181244,1356,32,831,609,222,181244,Житомирська область
6061,181245,2071,24,1270,932,338,181245,Житомирська область
6062,181246,2076,27,1258,933,325,181246,Житомирська область
6063,181247,2229,37,1345,1062,283,181247,Житомирська область
6064,181248,2104,34,1235,892,343,181248,Житомирська область
6065,181249,2217,32,1339,1014,325,181249,Житомирська область
6066,181250,1970,26,1152,867,285,181250,Житомирська область
6067,181251,2141,36,1335,1016,319,181251,Житомирська область
6068,181252,990,18,586,451,135,181252,Житомирська область
6069,181253,1503,22,869,667,202,181253,Житомирська область
6070,181254,1703,29,963,725,238,181254,Житомирська область
6071,181255,1721,22,1036,802,234,181255,Житомирська область
6072,181256,1854,28,1143,834,309,181256,Житомирська область
6073,181257,1388,27,804,582,222,181257,Житомирська область
6074,181258,1753,30,1049,767,282,181258,Житомирська область
6075,181259,177,5,133,97,36,181259,Житомирська область
6076,181260,197,7,173,134,39,181260,Житомирська область
6077,181261,63,0,59,46,13,181261,Житомирська область
6078,181262,41,1,40,35,5,181262,Житомирська область
6079,181263,179,12,163,152,11,181263,Житомирська область
6080,181264,226,7,218,209,9,181264,Житомирська область
6081,180363,134,3,82,70,12,180363,Житомирська область
6082,180364,381,3,201,159,42,180364,Житомирська область
6083,180365,116,1,75,54,21,180365,Житомирська область
6084,180366,171,1,96,86,10,180366,Житомирська область
6085,180367,372,6,224,165,59,180367,Житомирська область
6086,180368,237,1,158,87,71,180368,Житомирська область
6087,180369,510,5,285,203,82,180369,Житомирська область
6088,180370,565,4,356,272,84,180370,Житомирська область
6089,180371,153,2,101,67,34,180371,Житомирська область
6090,180372,103,0,61,43,18,180372,Житомирська область
6091,180373,727,3,397,346,51,180373,Житомирська область
6092,180374,409,7,258,212,46,180374,Житомирська область
6093,180375,154,1,89,74,15,180375,Житомирська область
6094,180376,183,1,102,51,51,180376,Житомирська область
6095,180377,324,4,198,172,26,180377,Житомирська область
6096,180378,91,2,48,34,14,180378,Житомирська область
6097,180379,590,1,313,268,45,180379,Житомирська область
6098,180380,1012,7,576,473,103,180380,Житомирська область
6099,180381,143,0,98,78,20,180381,Житомирська область
6100,180382,261,0,154,90,64,180382,Житомирська область
6101,180383,239,1,123,90,33,180383,Житомирська область
6102,180384,310,1,199,152,47,180384,Житомирська область
6103,180385,94,0,58,34,24,180385,Житомирська область
6104,180386,79,2,61,35,26,180386,Житомирська область
6105,180387,220,0,131,96,35,180387,Житомирська область
6106,180388,227,3,138,121,17,180388,Житомирська область
6107,180389,107,1,59,46,13,180389,Житомирська область
6108,180390,191,0,113,93,20,180390,Житомирська область
6109,180391,330,4,199,181,18,180391,Житомирська область
6110,180392,568,5,331,259,72,180392,Житомирська область
6111,180393,408,4,234,176,58,180393,Житомирська область
6112,180394,119,1,61,40,21,180394,Житомирська область
6113,180395,118,3,56,35,21,180395,Житомирська область
6114,180396,110,0,63,46,17,180396,Житомирська область
6115,180397,574,5,385,281,104,180397,Житомирська область
6116,180398,103,0,64,45,19,180398,Житомирська область
6117,180399,62,1,48,29,19,180399,Житомирська область
6118,180400,793,7,351,274,77,180400,Житомирська область
6119,180401,436,4,218,164,54,180401,Житомирська область
6120,180402,50,0,32,22,10,180402,Житомирська область
6121,180403,870,13,553,453,100,180403,Житомирська область
6122,180404,248,4,126,100,26,180404,Житомирська область
6123,180405,199,2,118,88,30,180405,Житомирська область
6124,180406,214,3,146,75,71,180406,Житомирська область
6125,180407,323,1,186,133,53,180407,Житомирська область
6126,180408,43,1,30,18,12,180408,Житомирська область
6127,180409,194,2,120,93,27,180409,Житомирська область
6128,180410,401,1,215,170,45,180410,Житомирська область
6129,180411,828,5,497,379,118,180411,Житомирська область
6130,180412,135,0,116,95,21,180412,Житомирська область
6131,180413,317,3,190,162,28,180413,Житомирська область
6132,180414,90,2,48,27,21,180414,Житомирська область
6133,180415,291,2,170,130,40,180415,Житомирська область
6134,180416,106,0,60,41,19,180416,Житомирська область
6135,180417,80,0,53,32,21,180417,Житомирська область
6136,180418,985,10,612,484,128,180418,Житомирська область
6137,180419,122,0,84,69,15,180419,Житомирська область
6138,180420,143,4,104,80,24,180420,Житомирська область
6139,180421,241,2,175,145,30,180421,Житомирська область
6140,180422,153,3,86,66,20,180422,Житомирська область
6141,180423,144,2,78,51,27,180423,Житомирська область
6142,180424,313,4,188,131,57,180424,Житомирська область
6143,180425,181,1,111,78,33,180425,Житомирська область
6144,180426,64,1,34,21,13,180426,Житомирська область
6145,180427,186,2,100,89,11,180427,Житомирська область
6146,180428,38,0,30,23,7,180428,Житомирська область
6147,180429,340,9,211,177,34,180429,Житомирська область
6148,180430,82,0,49,29,20,180430,Житомирська область
6149,180431,185,0,111,84,27,180431,Житомирська область
6150,180432,72,0,50,40,10,180432,Житомирська область
6151,180433,103,2,64,45,19,180433,Житомирська область
6152,180434,203,3,121,89,32,180434,Житомирська область
6153,180435,46,1,25,17,8,180435,Житомирська область
6154,180436,317,1,207,152,55,180436,Житомирська область
6155,180437,522,5,279,244,35,180437,Житомирська область
6156,180438,14,0,14,11,3,180438,Житомирська область
6157,180439,15,1,13,8,5,180439,Житомирська область
6158,180487,1654,14,857,676,181,180487,Житомирська область
6159,180488,1485,13,805,624,181,180488,Житомирська область
6160,180489,372,2,211,159,52,180489,Житомирська область
6161,180490,308,1,152,107,45,180490,Житомирська область
6162,180491,281,0,130,110,20,180491,Житомирська область
6163,180492,1095,7,608,446,162,180492,Житомирська область
6164,180493,80,1,53,30,23,180493,Житомирська область
6165,180494,101,0,74,51,23,180494,Житомирська область
6166,180495,195,3,124,83,41,180495,Житомирська область
6167,180496,266,2,127,107,20,180496,Житомирська область
6168,180497,534,5,298,224,74,180497,Житомирська область
6169,180498,252,2,127,92,35,180498,Житомирська область
6170,180499,525,0,258,211,47,180499,Житомирська область
6171,180500,102,0,52,42,10,180500,Житомирська область
6172,180501,72,1,47,26,21,180501,Житомирська область
6173,180502,243,9,159,94,65,180502,Житомирська область
6174,180503,132,0,73,51,22,180503,Житомирська область
6175,180504,286,0,148,112,36,180504,Житомирська область
6176,180505,632,11,347,300,47,180505,Житомирська область
6177,180506,111,0,40,29,11,180506,Житомирська область
6178,180507,256,2,159,120,39,180507,Житомирська область
6179,180508,297,3,142,97,45,180508,Житомирська область
6180,180509,423,3,209,157,52,180509,Житомирська область
6181,180510,714,9,363,271,92,180510,Житомирська область
6182,180511,487,1,241,169,72,180511,Житомирська область
6183,180512,389,4,161,109,52,180512,Житомирська область
6184,180513,671,6,331,212,119,180513,Житомирська область
6185,180514,284,1,141,98,43,180514,Житомирська область
6186,180515,226,4,125,83,42,180515,Житомирська область
6187,180516,216,0,111,82,29,180516,Житомирська область
6188,180517,21,0,19,16,3,180517,Житомирська область
6189,180707,1714,13,1024,817,207,180707,Житомирська область
6190,180708,1766,20,1074,876,198,180708,Житомирська область
6191,180709,2145,23,1255,1017,238,180709,Житомирська область
6192,180710,2231,29,1369,1129,240,180710,Житомирська область
6193,180711,1085,16,634,539,95,180711,Житомирська область
6194,180712,1235,9,718,591,127,180712,Житомирська область
6195,180713,2256,30,1354,1148,206,180713,Житомирська область
6196,180714,546,4,348,289,59,180714,Житомирська область
6197,180715,294,2,197,144,53,180715,Житомирська область
6198,180716,419,6,257,212,45,180716,Житомирська область
6199,180717,258,6,209,113,96,180717,Житомирська область
6200,180718,436,5,302,190,112,180718,Житомирська область
6201,180719,1245,16,680,568,112,180719,Житомирська область
6202,180720,113,1,55,30,25,180720,Житомирська область
6203,180721,134,1,80,66,14,180721,Житомирська область
6204,180722,588,5,307,267,40,180722,Житомирська область
6205,180723,281,0,133,115,18,180723,Житомирська область
6206,180724,125,2,77,52,25,180724,Житомирська область
6207,180725,86,1,55,48,7,180725,Житомирська область
6208,180726,548,3,370,305,65,180726,Житомирська область
6209,180727,255,5,175,139,36,180727,Житомирська область
6210,180728,431,5,240,209,31,180728,Житомирська область
6211,180729,29,0,18,12,6,180729,Житомирська область
6212,180730,326,1,199,174,25,180730,Житомирська область
6213,180731,554,13,351,265,86,180731,Житомирська область
6214,180732,168,2,134,114,20,180732,Житомирська область
6215,180733,989,16,547,378,169,180733,Житомирська область
6216,180734,140,1,90,75,15,180734,Житомирська область
6217,180735,275,3,175,129,46,180735,Житомирська область
6218,180736,123,3,65,46,19,180736,Житомирська область
6219,180737,443,4,272,179,93,180737,Житомирська область
6220,180738,207,4,155,54,101,180738,Житомирська область
6221,180739,34,0,30,17,13,180739,Житомирська область
6222,180740,123,0,104,77,27,180740,Житомирська область
6223,180741,245,3,137,105,32,180741,Житомирська область
6224,180742,383,4,233,189,44,180742,Житомирська область
6225,180743,1112,18,588,462,126,180743,Житомирська область
6226,180744,784,10,491,347,144,180744,Житомирська область
6227,180745,385,4,245,203,42,180745,Житомирська область
6228,180746,171,3,126,92,34,180746,Житомирська область
6229,180747,263,3,171,135,36,180747,Житомирська область
6230,180748,138,0,85,61,24,180748,Житомирська область
6231,180749,170,1,110,81,29,180749,Житомирська область
6232,180750,159,3,89,62,27,180750,Житомирська область
6233,180751,971,13,650,456,194,180751,Житомирська область
6234,180752,25,0,23,11,12,180752,Житомирська область
6235,180753,1025,8,562,496,66,180753,Житомирська область
6236,180754,346,0,182,168,14,180754,Житомирська область
6237,180755,227,3,162,122,40,180755,Житомирська область
6238,180756,55,0,32,21,11,180756,Житомирська область
6239,180757,123,1,88,69,19,180757,Житомирська область
6240,180758,206,4,145,94,51,180758,Житомирська область
6241,180759,218,0,162,134,28,180759,Житомирська область
6242,180760,553,12,337,245,92,180760,Житомирська область
6243,180761,55,1,43,26,17,180761,Житомирська область
6244,180762,980,3,536,430,106,180762,Житомирська область
6245,180763,85,1,67,32,35,180763,Житомирська область
6246,180764,56,0,36,26,10,180764,Житомирська область
6247,180765,128,0,92,59,33,180765,Житомирська область
6248,180766,629,12,398,340,58,180766,Житомирська область
6249,180767,126,2,81,75,6,180767,Житомирська область
6250,180768,80,2,53,44,9,180768,Житомирська область
6251,180769,522,5,340,277,63,180769,Житомирська область
6252,180770,564,5,414,333,81,180770,Житомирська область
6253,180771,332,3,245,155,90,180771,Житомирська область
6254,180772,252,1,189,143,46,180772,Житомирська область
6255,180773,149,5,101,78,23,180773,Житомирська область
6256,180774,68,1,59,37,22,180774,Житомирська область
6257,180775,75,3,51,35,16,180775,Житомирська область
6258,180776,105,0,95,68,27,180776,Житомирська область
6259,180777,241,1,166,112,54,180777,Житомирська область
6260,180778,279,0,179,144,35,180778,Житомирська область
6261,180779,729,7,412,361,51,180779,Житомирська область
6262,180780,513,2,279,224,55,180780,Житомирська область
6263,180781,636,14,327,272,55,180781,Житомирська область
6264,180783,588,7,348,229,119,180783,Житомирська область
6265,180784,286,2,160,115,45,180784,Житомирська область
6266,180785,215,2,140,103,37,180785,Житомирська область
6267,180786,146,2,90,66,24,180786,Житомирська область
6268,180787,101,1,65,41,24,180787,Житомирська область
6269,180788,40,0,21,13,8,180788,Житомирська область
6270,180789,794,6,461,324,137,180789,Житомирська область
6271,180790,69,1,29,24,5,180790,Житомирська область
6272,180791,217,2,138,107,31,180791,Житомирська область
6273,180792,191,0,132,97,35,180792,Житомирська область
6274,180793,117,2,89,45,44,180793,Житомирська область
6275,180794,254,5,169,122,47,180794,Житомирська область
6276,180795,247,0,183,145,38,180795,Житомирська область
6277,180796,471,3,275,213,62,180796,Житомирська область
6278,180797,183,1,112,66,46,180797,Житомирська область
6279,180799,1925,18,1006,827,179,180799,Житомирська область
6280,180800,627,2,278,204,74,180800,Житомирська область
6281,180801,257,0,152,136,16,180801,Житомирська область
6282,180802,119,1,70,57,13,180802,Житомирська область
6283,180803,47,1,41,30,11,180803,Житомирська область
6284,180804,20,0,19,11,8,180804,Житомирська область
6285,180805,76,1,43,29,14,180805,Житомирська область
6286,180806,591,3,315,226,89,180806,Житомирська область
6287,180807,473,1,246,180,66,180807,Житомирська область
6288,180809,421,0,213,142,71,180809,Житомирська область
6289,180810,177,1,111,72,39,180810,Житомирська область
6290,180811,132,2,96,75,21,180811,Житомирська область
6291,180812,1036,5,440,364,76,180812,Житомирська область
6292,180813,1287,10,600,491,109,180813,Житомирська область
6293,180814,488,14,236,166,70,180814,Житомирська область
6294,180816,1087,14,500,375,125,180816,Житомирська область
6295,180817,553,4,280,175,105,180817,Житомирська область
6296,180818,43,0,29,13,16,180818,Житомирська область
6297,180819,71,2,45,14,31,180819,Житомирська область
6298,180820,40,0,28,12,16,180820,Житомирська область
6299,180821,1055,12,684,540,144,180821,Житомирська область
6300,180823,386,2,197,166,31,180823,Житомирська область
6301,180824,170,0,110,86,24,180824,Житомирська область
6302,180825,274,4,177,133,44,180825,Житомирська область
6303,180827,733,4,431,353,78,180827,Житомирська область
6304,180828,137,1,86,73,13,180828,Житомирська область
6305,180829,1177,11,605,505,100,180829,Житомирська область
6306,180830,207,7,160,133,27,180830,Житомирська область
6307,180831,107,2,90,62,28,180831,Житомирська область
6308,180832,242,2,159,100,59,180832,Житомирська область
6309,180833,495,6,281,242,39,180833,Житомирська область
6310,180834,775,6,496,396,100,180834,Житомирська область
6311,180835,641,3,381,269,112,180835,Житомирська область
6312,180836,255,0,161,121,40,180836,Житомирська область
6313,180837,484,4,286,231,55,180837,Житомирська область
6314,180838,179,4,124,107,17,180838,Житомирська область
6315,180839,165,3,108,91,17,180839,Житомирська область
6316,180840,74,0,39,26,13,180840,Житомирська область
6317,180841,759,5,427,351,76,180841,Житомирська область
6318,180842,286,6,148,127,21,180842,Житомирська область
6319,180843,167,0,115,101,14,180843,Житомирська область
6320,180844,255,1,156,127,29,180844,Житомирська область
6321,180845,149,0,102,69,33,180845,Житомирська область
6322,180846,310,4,196,131,65,180846,Житомирська область
6323,180847,136,0,84,54,30,180847,Житомирська область
6324,180848,105,0,75,62,13,180848,Житомирська область
6325,180849,316,5,207,139,68,180849,Житомирська область
6326,180850,114,1,81,63,18,180850,Житомирська область
6327,180851,242,4,156,117,39,180851,Житомирська область
6328,180852,909,4,541,417,124,180852,Житомирська область
6329,180853,274,3,139,105,34,180853,Житомирська область
6330,180854,1755,8,854,712,142,180854,Житомирська область
6331,180855,206,3,134,89,45,180855,Житомирська область
6332,180856,81,1,51,22,29,180856,Житомирська область
6333,180857,1198,13,639,475,164,180857,Житомирська область
6334,180858,444,5,288,220,68,180858,Житомирська область
6335,180859,71,0,64,49,15,180859,Житомирська область
6336,180860,42,0,24,14,10,180860,Житомирська область
6337,180861,460,5,225,177,48,180861,Житомирська область
6338,180862,1632,11,702,527,175,180862,Житомирська область
6339,180863,1709,14,1017,804,213,180863,Житомирська область
6340,180864,1471,18,848,682,166,180864,Житомирська область
6341,180865,1736,13,972,837,135,180865,Житомирська область
6342,180866,1633,18,916,751,165,180866,Житомирська область
6343,180867,1891,9,970,784,186,180867,Житомирська область
6344,180868,21,0,17,12,5,180868,Житомирська область
6345,181265,613,4,342,295,47,181265,Житомирська область
6346,181266,720,14,390,324,66,181266,Житомирська область
6347,181267,2218,37,1324,1061,263,181267,Житомирська область
6348,181268,1848,27,1084,915,169,181268,Житомирська область
6349,181269,1401,25,870,692,178,181269,Житомирська область
6350,181270,1926,28,1223,1036,187,181270,Житомирська область
6351,181271,2224,31,1417,1172,245,181271,Житомирська область
6352,181272,2284,40,1292,1096,196,181272,Житомирська область
6353,181273,1558,22,947,777,170,181273,Житомирська область
6354,181274,2102,22,1292,1060,232,181274,Житомирська область
6355,181275,713,10,457,373,84,181275,Житомирська область
6356,181276,1376,34,854,689,165,181276,Житомирська область
6357,181277,1926,15,1211,1007,204,181277,Житомирська область
6358,181278,1396,19,825,691,134,181278,Житомирська область
6359,181279,1748,30,1056,864,192,181279,Житомирська область
6360,181280,1551,29,957,736,221,181280,Житомирська область
6361,181281,1995,32,1255,1026,229,181281,Житомирська область
6362,181282,1929,28,1246,1025,221,181282,Житомирська область
6363,181283,1515,40,918,774,144,181283,Житомирська область
6364,181284,1996,31,1179,993,186,181284,Житомирська область
6365,181285,2072,37,1152,1003,149,181285,Житомирська область
6366,181287,2182,22,1228,1022,206,181287,Житомирська область
6367,181288,1348,12,767,637,130,181288,Житомирська область
6368,181289,1337,26,783,663,120,181289,Житомирська область
6369,181290,1559,20,928,775,153,181290,Житомирська область
6370,181291,1379,10,743,627,116,181291,Житомирська область
6371,181292,1476,13,815,680,135,181292,Житомирська область
6372,181293,877,11,498,423,75,181293,Житомирська область
6373,181294,1076,18,625,544,81,181294,Житомирська область
6374,181295,381,4,211,174,37,181295,Житомирська область
6375,181296,777,1,403,358,45,181296,Житомирська область
6376,181297,62,2,54,47,7,181297,Житомирська область
6377,181298,35,0,32,23,9,181298,Житомирська область
6378,181299,779,28,651,617,34,181299,Житомирська область
6379,181464,73,0,45,27,18,181464,Житомирська область
6380,180048,2102,23,1262,949,313,180048,Житомирська область
6381,180049,1924,17,1119,911,208,180049,Житомирська область
6382,180050,1818,20,1037,827,210,180050,Житомирська область
6383,180051,2266,21,1323,1066,257,180051,Житомирська область
6384,180052,1066,16,629,507,122,180052,Житомирська область
6385,180053,1772,20,896,709,187,180053,Житомирська область
6386,180054,1641,20,847,680,167,180054,Житомирська область
6387,180055,354,6,207,169,38,180055,Житомирська область
6388,180056,1839,13,978,807,171,180056,Житомирська область
6389,180057,120,2,67,39,28,180057,Житомирська область
6390,180058,169,0,95,69,26,180058,Житомирська область
6391,180059,1065,15,668,574,94,180059,Житомирська область
6392,180060,1291,22,709,603,106,180060,Житомирська область
6393,180061,1264,21,711,575,136,180061,Житомирська область
6394,180062,1179,9,663,490,173,180062,Житомирська область
6395,180063,346,3,227,130,97,180063,Житомирська область
6396,180064,321,1,195,111,84,180064,Житомирська область
6397,180065,532,4,382,284,98,180065,Житомирська область
6398,180066,436,2,285,195,90,180066,Житомирська область
6399,180067,1638,20,880,633,247,180067,Житомирська область
6400,180068,108,2,64,49,15,180068,Житомирська область
6401,180069,63,0,50,35,15,180069,Житомирська область
6402,180070,40,0,29,24,5,180070,Житомирська область
6403,180071,211,1,145,93,52,180071,Житомирська область
6404,180072,432,1,265,222,43,180072,Житомирська область
6405,180073,62,2,36,32,4,180073,Житомирська область
6406,180074,222,2,111,89,22,180074,Житомирська область
6407,180075,301,2,190,152,38,180075,Житомирська область
6408,180076,602,1,313,246,67,180076,Житомирська область
6409,180077,191,0,118,83,35,180077,Житомирська область
6410,180078,101,0,65,42,23,180078,Житомирська область
6411,180079,277,2,189,162,27,180079,Житомирська область
6412,180080,655,9,367,316,51,180080,Житомирська область
6413,180081,467,4,272,202,70,180081,Житомирська область
6414,180082,284,3,179,123,56,180082,Житомирська область
6415,180083,88,1,68,38,30,180083,Житомирська область
6416,180084,169,0,130,67,63,180084,Житомирська область
6417,180085,106,3,68,52,16,180085,Житомирська область
6418,180086,242,2,150,98,52,180086,Житомирська область
6419,180087,84,1,50,33,17,180087,Житомирська область
6420,180088,619,4,317,205,112,180088,Житомирська область
6421,180089,411,2,231,163,68,180089,Житомирська область
6422,180090,476,3,341,246,95,180090,Житомирська область
6423,180091,76,0,57,29,28,180091,Житомирська область
6424,180092,101,5,56,36,20,180092,Житомирська область
6425,180093,513,9,346,229,117,180093,Житомирська область
6426,180094,46,0,43,18,25,180094,Житомирська область
6427,180095,283,0,207,162,45,180095,Житомирська область
6428,180096,83,0,33,12,21,180096,Житомирська область
6429,180097,110,1,63,45,18,180097,Житомирська область
6430,180098,75,0,62,43,19,180098,Житомирська область
6431,180099,151,0,106,94,12,180099,Житомирська область
6432,180100,33,0,26,20,6,180100,Житомирська область
6433,180226,433,3,254,196,58,180226,Житомирська область
6434,180227,1193,15,561,400,161,180227,Житомирська область
6435,180228,292,2,227,71,156,180228,Житомирська область
6436,180229,392,2,231,157,74,180229,Житомирська область
6437,180230,229,3,135,109,26,180230,Житомирська область
6438,180231,256,0,180,100,80,180231,Житомирська область
6439,180232,348,2,171,91,80,180232,Житомирська область
6440,180233,78,0,56,46,10,180233,Житомирська область
6441,180234,170,1,100,76,24,180234,Житомирська область
6442,180235,320,2,202,155,47,180235,Житомирська область
6443,180236,546,5,300,216,84,180236,Житомирська область
6444,180237,90,0,42,24,18,180237,Житомирська область
6445,180238,84,1,67,39,28,180238,Житомирська область
6446,180239,346,3,209,163,46,180239,Житомирська область
6447,180240,106,2,80,53,27,180240,Житомирська область
6448,180241,175,0,106,83,23,180241,Житомирська область
6449,180242,76,0,47,38,9,180242,Житомирська область
6450,180243,180,0,106,77,29,180243,Житомирська область
6451,180244,2004,24,1160,874,286,180244,Житомирська область
6452,180245,1389,18,734,580,154,180245,Житомирська область
6453,180246,1862,38,966,760,206,180246,Житомирська область
6454,180247,471,10,233,185,48,180247,Житомирська область
6455,180248,340,4,199,138,61,180248,Житомирська область
6456,180249,80,1,63,34,29,180249,Житомирська область
6457,180250,206,3,112,89,23,180250,Житомирська область
6458,180251,329,6,152,122,30,180251,Житомирська область
6459,180252,200,2,131,75,56,180252,Житомирська область
6460,180253,268,4,136,94,42,180253,Житомирська область
6461,180254,675,6,342,255,87,180254,Житомирська область
6462,180255,200,2,120,87,33,180255,Житомирська область
6463,180256,286,5,170,119,51,180256,Житомирська область
6464,180257,447,2,316,232,84,180257,Житомирська область
6465,180258,174,1,105,74,31,180258,Житомирська область
6466,180259,195,1,164,100,64,180259,Житомирська область
6467,180260,75,2,62,34,28,180260,Житомирська область
6468,180261,632,4,350,232,118,180261,Житомирська область
6469,180262,338,3,193,145,48,180262,Житомирська область
6470,180263,76,0,52,37,15,180263,Житомирська область
6471,180264,439,3,233,166,67,180264,Житомирська область
6472,180265,256,3,135,116,19,180265,Житомирська область
6473,180266,303,2,141,95,46,180266,Житомирська область
6474,180267,156,2,93,57,36,180267,Житомирська область
6475,180268,994,11,714,507,207,180268,Житомирська область
6476,180269,74,0,42,26,16,180269,Житомирська область
6477,180270,995,13,518,403,115,180270,Житомирська область
6478,180271,739,0,425,255,170,180271,Житомирська область
6479,180272,231,3,133,101,32,180272,Житомирська область
6480,180273,239,1,172,134,38,180273,Житомирська область
6481,180274,425,4,225,145,80,180274,Житомирська область
6482,180275,339,12,243,188,55,180275,Житомирська область
6483,180276,268,1,194,134,60,180276,Житомирська область
6484,180277,174,5,92,54,38,180277,Житомирська область
6485,180278,119,1,79,53,26,180278,Житомирська область
6486,180279,602,9,320,247,73,180279,Житомирська область
6487,180280,147,3,84,62,22,180280,Житомирська область
6488,180281,72,0,58,36,22,180281,Житомирська область
6489,180282,458,3,290,217,73,180282,Житомирська область
6490,180283,392,1,247,195,52,180283,Житомирська область
6491,180284,56,0,42,34,8,180284,Житомирська область
6492,180285,695,3,431,304,127,180285,Житомирська область
6493,180286,133,0,101,84,17,180286,Житомирська область
6494,180287,315,1,202,142,60,180287,Житомирська область
6495,180288,105,0,71,34,37,180288,Житомирська область
6496,180289,255,2,132,99,33,180289,Житомирська область
6497,180290,868,13,431,304,127,180290,Житомирська область
6498,180291,56,0,52,43,9,180291,Житомирська область
6499,180628,343,4,218,105,113,180628,Житомирська область
6500,180629,250,0,146,106,40,180629,Житомирська область
6501,180630,310,2,182,159,23,180630,Житомирська область
6502,180631,213,0,133,95,38,180631,Житомирська область
6503,180632,133,2,78,55,23,180632,Житомирська область
6504,180633,471,11,294,198,96,180633,Житомирська область
6505,180634,274,2,214,147,67,180634,Житомирська область
6506,180635,318,2,219,176,43,180635,Житомирська область
6507,180636,555,2,333,228,105,180636,Житомирська область
6508,180637,348,3,219,141,78,180637,Житомирська область
6509,180638,955,8,551,385,166,180638,Житомирська область
6510,180639,383,5,236,162,74,180639,Житомирська область
6511,180640,259,0,165,111,54,180640,Житомирська область
6512,180641,363,3,233,166,67,180641,Житомирська область
6513,180642,247,0,151,93,58,180642,Житомирська область
6514,180643,140,2,73,52,21,180643,Житомирська область
6515,180644,163,1,85,68,17,180644,Житомирська область
6516,180645,236,0,147,115,32,180645,Житомирська область
6517,180646,807,4,405,301,104,180646,Житомирська область
6518,180647,267,3,160,102,58,180647,Житомирська область
6519,180648,400,4,243,132,111,180648,Житомирська область
6520,180649,349,1,201,117,84,180649,Житомирська область
6521,180650,88,1,71,40,31,180650,Житомирська область
6522,180651,200,1,130,105,25,180651,Житомирська область
6523,180652,52,0,46,21,25,180652,Житомирська область
6524,180653,528,4,312,199,113,180653,Житомирська область
6525,180654,179,0,109,87,22,180654,Житомирська область
6526,180655,303,5,184,103,81,180655,Житомирська область
6527,180656,194,0,104,64,40,180656,Житомирська область
6528,180657,474,6,251,157,94,180657,Житомирська область
6529,180658,431,5,235,145,90,180658,Житомирська область
6530,180659,283,6,146,106,40,180659,Житомирська область
6531,180660,122,0,92,58,34,180660,Житомирська область
6532,180661,119,2,71,48,23,180661,Житомирська область
6533,180662,165,0,103,65,38,180662,Житомирська область
6534,180663,238,4,162,90,72,180663,Житомирська область
6535,180664,245,9,135,77,58,180664,Житомирська область
6536,180665,406,3,215,175,40,180665,Житомирська область
6537,180666,194,0,160,76,84,180666,Житомирська область
6538,180667,375,6,224,173,51,180667,Житомирська область
6539,180668,273,4,168,128,40,180668,Житомирська область
6540,180669,206,0,124,93,31,180669,Житомирська область
6541,180670,168,4,126,102,24,180670,Житомирська область
6542,180671,363,0,201,153,48,180671,Житомирська область
6543,180672,1318,14,765,620,145,180672,Житомирська область
6544,180673,404,8,236,146,90,180673,Житомирська область
6545,180674,246,0,116,99,17,180674,Житомирська область
6546,180675,607,5,382,301,81,180675,Житомирська область
6547,180676,343,1,167,111,56,180676,Житомирська область
6548,180677,420,3,274,181,93,180677,Житомирська область
6549,180678,674,1,398,304,94,180678,Житомирська область
6550,180679,1130,12,684,511,173,180679,Житомирська область
6551,180680,137,2,92,55,37,180680,Житомирська область
6552,180681,501,4,273,179,94,180681,Житомирська область
6553,180682,194,0,111,78,33,180682,Житомирська область
6554,180683,238,2,178,116,62,180683,Житомирська область
6555,180684,391,8,245,159,86,180684,Житомирська область
6556,180685,293,5,186,111,75,180685,Житомирська область
6557,180686,341,2,192,160,32,180686,Житомирська область
6558,180687,221,2,124,97,27,180687,Житомирська область
6559,180688,229,4,116,81,35,180688,Житомирська область
6560,180689,561,6,308,197,111,180689,Житомирська область
6561,180690,790,6,503,390,113,180690,Житомирська область
6562,180691,328,1,211,176,35,180691,Житомирська область
6563,180692,442,3,228,131,97,180692,Житомирська область
6564,180693,251,10,142,101,41,180693,Житомирська область
6565,180694,798,5,432,258,174,180694,Житомирська область
6566,180695,497,5,255,162,93,180695,Житомирська область
6567,180696,344,3,217,158,59,180696,Житомирська область
6568,180697,244,5,205,106,99,180697,Житомирська область
6569,180698,28,0,24,12,12,180698,Житомирська область
6570,180699,1259,14,681,509,172,180699,Житомирська область
6571,180700,131,2,101,71,30,180700,Житомирська область
6572,180701,1644,14,841,669,172,180701,Житомирська область
6573,180702,289,5,218,145,73,180702,Житомирська область
6574,180703,445,5,240,186,54,180703,Житомирська область
6575,180704,614,11,365,241,124,180704,Житомирська область
6576,180705,2128,17,1116,873,243,180705,Житомирська область
6577,180706,1728,24,855,657,198,180706,Житомирська область
6578,181066,267,1,139,84,55,181066,Житомирська область
6579,181067,71,1,48,29,19,181067,Житомирська область
6580,181068,126,2,73,54,19,181068,Житомирська область
6581,181069,165,4,97,78,19,181069,Житомирська область
6582,181070,162,0,104,60,44,181070,Житомирська область
6583,181071,424,3,222,147,75,181071,Житомирська область
6584,181072,128,1,72,45,27,181072,Житомирська область
6585,181073,70,0,34,23,11,181073,Житомирська область
6586,181074,143,0,85,49,36,181074,Житомирська область
6587,181075,101,0,55,35,20,181075,Житомирська область
6588,181076,193,2,113,76,37,181076,Житомирська область
6589,181077,737,4,391,306,85,181077,Житомирська область
6590,181078,156,2,77,58,19,181078,Житомирська область
6591,181079,371,5,236,186,50,181079,Житомирська область
6592,181080,73,0,46,34,12,181080,Житомирська область
6593,181081,216,3,113,57,56,181081,Житомирська область
6594,181082,670,5,297,203,94,181082,Житомирська область
6595,181083,526,5,243,170,73,181083,Житомирська область
6596,181084,195,2,108,74,34,181084,Житомирська область
6597,181085,237,2,137,105,32,181085,Житомирська область
6598,181086,405,2,241,218,23,181086,Житомирська область
6599,181087,55,0,51,39,12,181087,Житомирська область
6600,181088,154,3,99,68,31,181088,Житомирська область
6601,181089,463,2,240,165,75,181089,Житомирська область
6602,181090,81,2,53,35,18,181090,Житомирська область
6603,181091,475,6,257,193,64,181091,Житомирська область
6604,181092,465,5,253,188,65,181092,Житомирська область
6605,181093,221,0,125,75,50,181093,Житомирська область
6606,181094,173,2,108,82,26,181094,Житомирська область
6607,181095,259,2,174,141,33,181095,Житомирська область
6608,181096,144,3,108,68,40,181096,Житомирська область
6609,181097,183,2,101,60,41,181097,Житомирська область
6610,181098,289,5,196,168,28,181098,Житомирська область
6611,181099,508,4,277,226,51,181099,Житомирська область
6612,181100,75,0,44,26,18,181100,Житомирська область
6613,181101,352,3,198,135,63,181101,Житомирська область
6614,181102,780,6,396,307,89,181102,Житомирська область
6615,181103,178,1,95,84,11,181103,Житомирська область
6616,181104,187,2,105,78,27,181104,Житомирська область
6617,181105,403,8,229,140,89,181105,Житомирська область
6618,181106,181,2,102,54,48,181106,Житомирська область
6619,181107,155,1,110,72,38,181107,Житомирська область
6620,181108,288,3,190,151,39,181108,Житомирська область
6621,181109,132,0,74,47,27,181109,Житомирська область
6622,181110,199,0,130,91,39,181110,Житомирська область
6623,181111,175,1,96,56,40,181111,Житомирська область
6624,181112,1192,17,624,462,162,181112,Житомирська область
6625,181113,1179,4,676,499,177,181113,Житомирська область
6626,181114,987,9,547,407,140,181114,Житомирська область
6627,181115,467,5,254,181,73,181115,Житомирська область
6628,181116,264,0,167,134,33,181116,Житомирська область
6629,181117,108,2,69,46,23,181117,Житомирська область
6630,181118,20,0,20,13,7,181118,Житомирська область
6631,181311,2021,27,1088,795,293,181311,Житомирська область
6632,181312,1046,12,565,442,123,181312,Житомирська область
6633,181313,993,15,611,477,134,181313,Житомирська область
6634,181314,1818,26,1057,842,215,181314,Житомирська область
6635,181315,2055,29,1321,1013,308,181315,Житомирська область
6636,181316,1698,30,1055,847,208,181316,Житомирська область
6637,181317,1639,19,962,730,232,181317,Житомирська область
6638,181318,1697,33,993,762,231,181318,Житомирська область
6639,181319,1313,16,740,565,175,181319,Житомирська область
6640,181320,2217,35,1322,1027,295,181320,Житомирська область
6641,181321,872,10,466,367,99,181321,Житомирська область
6642,181322,1871,30,1092,839,253,181322,Житомирська область
6643,181323,1851,25,1066,800,266,181323,Житомирська область
6644,181324,1651,28,979,730,249,181324,Житомирська область
6645,181325,1876,21,1003,764,239,181325,Житомирська область
6646,181326,1088,16,605,456,149,181326,Житомирська область
6647,181327,1340,18,784,641,143,181327,Житомирська область
6648,181328,2245,21,1272,970,302,181328,Житомирська область
6649,181329,1848,18,1112,877,235,181329,Житомирська область
6650,181330,1530,25,893,676,217,181330,Житомирська область
6651,181331,1739,21,1038,819,219,181331,Житомирська область
6652,181332,1456,30,850,642,208,181332,Житомирська область
6653,181333,2013,30,1192,870,322,181333,Житомирська область
6654,181334,1825,24,1160,797,363,181334,Житомирська область
6655,181335,1029,15,637,456,181,181335,Житомирська область
6656,181336,821,15,443,340,103,181336,Житомирська область
6657,181337,237,4,192,143,49,181337,Житомирська область
6658,180155,704,11,403,318,85,180155,Житомирська область
6659,180156,1162,14,688,547,141,180156,Житомирська область
6660,180157,1110,15,522,336,186,180157,Житомирська область
6661,180158,1133,18,624,492,132,180158,Житомирська область
6662,180159,323,1,199,137,62,180159,Житомирська область
6663,180160,84,1,46,30,16,180160,Житомирська область
6664,180161,204,4,137,99,38,180161,Житомирська область
6665,180162,191,1,136,98,38,180162,Житомирська область
6666,180163,447,5,284,230,54,180163,Житомирська область
6667,180164,194,5,105,80,25,180164,Житомирська область
6668,180165,861,23,447,344,103,180165,Житомирська область
6669,180166,359,2,211,144,67,180166,Житомирська область
6670,180167,220,1,129,77,52,180167,Житомирська область
6671,180168,195,1,152,78,74,180168,Житомирська область
6672,180169,457,7,288,191,97,180169,Житомирська область
6673,180170,285,0,181,119,62,180170,Житомирська область
6674,180171,535,9,302,223,79,180171,Житомирська область
6675,180172,155,3,100,58,42,180172,Житомирська область
6676,180173,185,0,107,84,23,180173,Житомирська область
6677,180174,304,1,179,121,58,180174,Житомирська область
6678,180175,204,0,119,86,33,180175,Житомирська область
6679,180176,270,2,187,127,60,180176,Житомирська область
6680,180177,555,4,292,221,71,180177,Житомирська область
6681,180178,394,10,233,175,58,180178,Житомирська область
6682,180179,145,3,102,84,18,180179,Житомирська область
6683,180180,276,4,173,120,53,180180,Житомирська область
6684,180181,69,2,51,36,15,180181,Житомирська область
6685,180182,950,5,559,419,140,180182,Житомирська область
6686,180183,114,0,75,41,34,180183,Житомирська область
6687,180184,238,2,157,117,40,180184,Житомирська область
6688,180185,30,4,26,20,6,180185,Житомирська область
6689,180186,1494,11,838,565,273,180186,Житомирська область
6690,180187,2024,21,1087,750,337,180187,Житомирська область
6691,180188,1544,11,855,593,262,180188,Житомирська область
6692,180189,1103,8,532,356,176,180189,Житомирська область
6693,180190,1210,16,690,519,171,180190,Житомирська область
6694,180191,1885,24,1120,901,219,180191,Житомирська область
6695,180192,1777,25,1013,801,212,180192,Житомирська область
6696,180193,1988,29,1066,820,246,180193,Житомирська область
6697,180194,2035,17,1213,912,301,180194,Житомирська область
6698,180195,299,2,188,116,72,180195,Житомирська область
6699,180196,372,4,232,180,52,180196,Житомирська область
6700,180197,403,4,238,149,89,180197,Житомирська область
6701,180198,511,2,278,169,109,180198,Житомирська область
6702,180199,431,0,294,187,107,180199,Житомирська область
6703,180200,273,0,167,82,85,180200,Житомирська область
6704,180201,518,5,256,204,52,180201,Житомирська область
6705,180202,508,7,351,236,115,180202,Житомирська область
6706,180203,265,0,150,85,65,180203,Житомирська область
6707,180204,420,4,202,119,83,180204,Житомирська область
6708,180205,497,10,240,170,70,180205,Житомирська область
6709,180206,123,1,65,33,32,180206,Житомирська область
6710,180207,315,1,190,126,64,180207,Житомирська область
6711,180208,665,7,386,252,134,180208,Житомирська область
6712,180209,307,3,180,110,70,180209,Житомирська область
6713,180210,191,0,134,101,33,180210,Житомирська область
6714,180211,944,4,459,294,165,180211,Житомирська область
6715,180212,250,1,133,100,33,180212,Житомирська область
6716,180213,384,5,202,153,49,180213,Житомирська область
6717,180214,411,6,222,136,86,180214,Житомирська область
6718,180215,320,2,167,95,72,180215,Житомирська область
6719,180216,497,6,296,232,64,180216,Житомирська область
6720,180217,183,1,117,97,20,180217,Житомирська область
6721,180218,203,3,118,98,20,180218,Житомирська область
6722,180219,395,1,223,182,41,180219,Житомирська область
6723,180220,286,4,159,116,43,180220,Житомирська область
6724,180221,148,1,82,60,22,180221,Житомирська область
6725,180222,302,1,166,118,48,180222,Житомирська область
6726,180223,311,3,178,156,22,180223,Житомирська область
6727,180224,252,3,145,98,47,180224,Житомирська область
6728,180225,41,0,39,20,19,180225,Житомирська область
6729,180440,2014,44,1301,953,348,180440,Житомирська область
6730,180441,1617,26,967,769,198,180441,Житомирська область
6731,180442,503,5,285,221,64,180442,Житомирська область
6732,180443,604,10,348,272,76,180443,Житомирська область
6733,180444,2242,29,1376,1049,327,180444,Житомирська область
6734,180446,2019,26,1225,868,357,180446,Житомирська область
6735,180447,2053,22,1312,981,331,180447,Житомирська область
6736,180448,1938,22,1179,918,261,180448,Житомирська область
6737,180449,2029,27,1342,1032,310,180449,Житомирська область
6738,180450,2155,32,1324,1034,290,180450,Житомирська область
6739,180451,2035,23,1186,903,283,180451,Житомирська область
6740,180452,252,2,146,98,48,180452,Житомирська область
6741,180453,706,6,355,268,87,180453,Житомирська область
6742,180454,104,1,65,53,12,180454,Житомирська область
6743,180455,126,2,82,62,20,180455,Житомирська область
6744,180456,182,2,114,80,34,180456,Житомирська область
6745,180457,187,1,133,87,46,180457,Житомирська область
6746,180458,405,10,248,169,79,180458,Житомирська область
6747,180459,358,2,223,180,43,180459,Житомирська область
6748,180460,157,2,105,80,25,180460,Житомирська область
6749,180461,517,4,326,187,139,180461,Житомирська область
6750,180462,244,1,134,80,54,180462,Житомирська область
6751,180463,117,0,80,60,20,180463,Житомирська область
6752,180464,63,0,39,10,29,180464,Житомирська область
6753,180465,398,1,241,178,63,180465,Житомирська область
6754,180466,479,6,302,275,27,180466,Житомирська область
6755,180467,374,11,219,169,50,180467,Житомирська область
6756,180468,355,8,227,179,48,180468,Житомирська область
6757,180469,115,2,74,51,23,180469,Житомирська область
6758,180470,270,2,216,159,57,180470,Житомирська область
6759,180471,287,1,200,118,82,180471,Житомирська область
6760,180472,133,1,82,50,32,180472,Житомирська область
6761,180473,396,6,251,165,86,180473,Житомирська область
6762,180474,562,4,338,242,96,180474,Житомирська область
6763,180475,109,1,74,54,20,180475,Житомирська область
6764,180476,1132,13,701,537,164,180476,Житомирська область
6765,180477,987,17,494,355,139,180477,Житомирська область
6766,180478,505,2,327,209,118,180478,Житомирська область
6767,180479,232,1,144,110,34,180479,Житомирська область
6768,180480,143,0,86,59,27,180480,Житомирська область
6769,180481,229,3,134,102,32,180481,Житомирська область
6770,180482,187,1,132,93,39,180482,Житомирська область
6771,180483,176,0,128,82,46,180483,Житомирська область
6772,180484,934,5,611,493,118,180484,Житомирська область
6773,180485,205,2,131,110,21,180485,Житомирська область
6774,180486,32,0,24,17,7,180486,Житомирська область
6775,180563,1141,15,701,513,188,180563,Житомирська область
6776,180564,1518,13,738,496,242,180564,Житомирська область
6777,180565,390,2,188,114,74,180565,Житомирська область
6778,180566,534,7,278,188,90,180566,Житомирська область
6779,180567,411,3,232,173,59,180567,Житомирська область
6780,180568,227,1,149,101,48,180568,Житомирська область
6781,180569,178,0,98,61,37,180569,Житомирська область
6782,180570,240,0,115,79,36,180570,Житомирська область
6783,180571,435,2,259,181,78,180571,Житомирська область
6784,180572,478,4,254,191,63,180572,Житомирська область
6785,180573,300,2,173,128,45,180573,Житомирська область
6786,180574,95,0,69,36,33,180574,Житомирська область
6787,180575,322,7,223,155,68,180575,Житомирська область
6788,180576,130,1,89,69,20,180576,Житомирська область
6789,180577,224,1,148,108,40,180577,Житомирська область
6790,180578,90,0,54,29,25,180578,Житомирська область
6791,180579,315,5,174,128,46,180579,Житомирська область
6792,180580,135,3,76,46,30,180580,Житомирська область
6793,180581,82,3,42,27,15,180581,Житомирська область
6794,180582,283,4,178,128,50,180582,Житомирська область
6795,180583,101,0,78,67,11,180583,Житомирська область
6796,180584,534,1,304,243,61,180584,Житомирська область
6797,180585,310,1,213,146,67,180585,Житомирська область
6798,180586,224,0,128,77,51,180586,Житомирська область
6799,180587,713,6,442,311,131,180587,Житомирська область
6800,180588,195,1,115,80,35,180588,Житомирська область
6801,180589,172,0,105,81,24,180589,Житомирська область
6802,180590,159,0,82,53,29,180590,Житомирська область
6803,180591,160,2,72,45,27,180591,Житомирська область
6804,180592,408,3,256,187,69,180592,Житомирська область
6805,180593,355,2,250,157,93,180593,Житомирська область
6806,180594,510,3,309,196,113,180594,Житомирська область
6807,180595,135,0,96,76,20,180595,Житомирська область
6808,180596,375,5,202,155,47,180596,Житомирська область
6809,180597,415,6,265,203,62,180597,Житомирська область
6810,180598,223,4,136,98,38,180598,Житомирська область
6811,180599,281,4,198,145,53,180599,Житомирська область
6812,180600,144,1,91,57,34,180600,Житомирська область
6813,180601,630,8,373,252,121,180601,Житомирська область
6814,180602,207,4,133,81,52,180602,Житомирська область
6815,180603,480,6,277,199,78,180603,Житомирська область
6816,180604,334,3,186,129,57,180604,Житомирська область
6817,180605,14,1,13,7,6,180605,Житомирська область
6818,180606,1934,28,1029,894,135,180606,Житомирська область
6819,180607,378,2,212,151,61,180607,Житомирська область
6820,180608,162,0,97,76,21,180608,Житомирська область
6821,180609,338,11,170,129,41,180609,Житомирська область
6822,180610,94,0,46,33,13,180610,Житомирська область
6823,180611,89,0,52,40,12,180611,Житомирська область
6824,180612,152,1,93,62,31,180612,Житомирська область
6825,180613,259,2,112,72,40,180613,Житомирська область
6826,180614,273,0,177,138,39,180614,Житомирська область
6827,180615,168,0,119,73,46,180615,Житомирська область
6828,180616,402,6,242,202,40,180616,Житомирська область
6829,180617,219,5,123,91,32,180617,Житомирська область
6830,180618,144,3,76,44,32,180618,Житомирська область
6831,180619,193,2,131,82,49,180619,Житомирська область
6832,180620,209,4,139,111,28,180620,Житомирська область
6833,180621,326,5,219,141,78,180621,Житомирська область
6834,180622,307,3,186,141,45,180622,Житомирська область
6835,180623,342,1,186,157,29,180623,Житомирська область
6836,180624,215,2,139,88,51,180624,Житомирська область
6837,180625,183,1,119,97,22,180625,Житомирська область
6838,180626,182,2,121,99,22,180626,Житомирська область
6839,180627,21,0,19,16,3,180627,Житомирська область
6840,180913,752,5,436,300,136,180913,Житомирська область
6841,180914,1041,17,571,391,180,180914,Житомирська область
6842,180915,1383,20,770,568,202,180915,Житомирська область
6843,180916,1204,18,635,442,193,180916,Житомирська область
6844,180917,1214,18,674,523,151,180917,Житомирська область
6845,180918,1820,20,1038,677,361,180918,Житомирська область
6846,180919,1283,14,711,533,178,180919,Житомирська область
6847,180920,1628,29,917,662,255,180920,Житомирська область
6848,180921,458,5,265,173,92,180921,Житомирська область
6849,180922,151,5,102,68,34,180922,Житомирська область
6850,180923,696,11,350,277,73,180923,Житомирська область
6851,180924,555,6,365,164,201,180924,Житомирська область
6852,180925,521,6,331,191,140,180925,Житомирська область
6853,180926,589,8,388,248,140,180926,Житомирська область
6854,180927,182,0,103,60,43,180927,Житомирська область
6855,180928,456,8,242,167,75,180928,Житомирська область
6856,180929,422,8,270,179,91,180929,Житомирська область
6857,180930,1023,11,556,369,187,180930,Житомирська область
6858,180931,148,0,109,80,29,180931,Житомирська область
6859,180932,66,2,44,28,16,180932,Житомирська область
6860,180933,61,1,39,20,19,180933,Житомирська область
6861,180934,372,3,207,127,80,180934,Житомирська область
6862,180936,380,7,215,129,86,180936,Житомирська область
6863,180937,340,3,173,105,68,180937,Житомирська область
6864,180938,452,5,248,165,83,180938,Житомирська область
6865,180939,315,2,217,97,120,180939,Житомирська область
6866,180940,62,0,48,15,33,180940,Житомирська область
6867,180941,100,0,78,28,50,180941,Житомирська область
6868,180942,365,3,234,119,115,180942,Житомирська область
6869,180943,499,5,274,174,100,180943,Житомирська область
6870,180944,120,0,85,40,45,180944,Житомирська область
6871,180945,671,8,407,310,97,180945,Житомирська область
6872,180946,198,1,144,76,68,180946,Житомирська область
6873,180947,141,5,97,55,42,180947,Житомирська область
6874,180948,805,11,649,414,235,180948,Житомирська область
6875,180949,1005,17,506,369,137,180949,Житомирська область
6876,180951,271,2,172,126,46,180951,Житомирська область
6877,180952,198,6,113,75,38,180952,Житомирська область
6878,180953,167,1,120,83,37,180953,Житомирська область
6879,180954,495,6,266,193,73,180954,Житомирська область
6880,180955,144,1,70,45,25,180955,Житомирська область
6881,180956,64,0,38,20,18,180956,Житомирська область
6882,180957,158,3,89,43,46,180957,Житомирська область
6883,180958,77,1,56,23,33,180958,Житомирська область
6884,180959,268,3,156,110,46,180959,Житомирська область
6885,180960,67,0,42,29,13,180960,Житомирська область
6886,180961,349,4,216,107,109,180961,Житомирська область
6887,180962,129,2,98,62,36,180962,Житомирська область
6888,180963,392,7,223,104,119,180963,Житомирська область
6889,180964,1351,20,757,537,220,180964,Житомирська область
6890,180965,197,1,122,62,60,180965,Житомирська область
6891,180966,189,1,125,81,44,180966,Житомирська область
6892,180967,417,5,283,145,138,180967,Житомирська область
6893,180968,17,0,17,11,6,180968,Житомирська область
6894,181119,1750,26,997,800,197,181119,Житомирська область
6895,181120,2144,29,1252,925,327,181120,Житомирська область
6896,181121,1868,14,1086,878,208,181121,Житомирська область
6897,181122,2115,27,1210,914,296,181122,Житомирська область
6898,181123,415,5,226,174,52,181123,Житомирська область
6899,181124,905,7,548,389,159,181124,Житомирська область
6900,181125,318,5,192,115,77,181125,Житомирська область
6901,181126,402,3,225,182,43,181126,Житомирська область
6902,181127,374,4,271,121,150,181127,Житомирська область
6903,181128,543,3,303,208,95,181128,Житомирська область
6904,181129,95,0,53,41,12,181129,Житомирська область
6905,181130,491,7,260,190,70,181130,Житомирська область
6906,181131,150,1,99,64,35,181131,Житомирська область
6907,181132,205,2,126,76,50,181132,Житомирська область
6908,181133,766,8,376,246,130,181133,Житомирська область
6909,181134,299,1,137,96,41,181134,Житомирська область
6910,181135,474,8,322,249,73,181135,Житомирська область
6911,181136,172,1,113,89,24,181136,Житомирська область
6912,181137,485,6,272,181,91,181137,Житомирська область
6913,181138,307,3,199,137,62,181138,Житомирська область
6914,181139,529,2,320,247,73,181139,Житомирська область
6915,181140,472,1,217,140,77,181140,Житомирська область
6916,181141,380,2,247,179,68,181141,Житомирська область
6917,181142,178,7,113,86,27,181142,Житомирська область
6918,181143,243,4,148,88,60,181143,Житомирська область
6919,181144,309,3,196,130,66,181144,Житомирська область
6920,181145,167,2,104,62,42,181145,Житомирська область
6921,181146,269,1,130,84,46,181146,Житомирська область
6922,181147,282,3,165,117,48,181147,Житомирська область
6923,181148,124,0,78,52,26,181148,Житомирська область
6924,181149,478,9,270,199,71,181149,Житомирська область
6925,181150,284,0,144,107,37,181150,Житомирська область
6926,181151,251,1,164,113,51,181151,Житомирська область
6927,181152,271,3,166,110,56,181152,Житомирська область
6928,181153,226,0,141,85,56,181153,Житомирська область
6929,181154,159,0,117,92,25,181154,Житомирська область
6930,181155,292,5,178,110,68,181155,Житомирська область
6931,181156,144,0,83,59,24,181156,Житомирська область
6932,181157,503,8,331,217,114,181157,Житомирська область
6933,181158,100,0,56,37,19,181158,Житомирська область
6934,181159,249,2,119,94,25,181159,Житомирська область
6935,181160,151,3,92,69,23,181160,Житомирська область
6936,181161,217,2,115,84,31,181161,Житомирська область
6937,181162,172,2,95,68,27,181162,Житомирська область
6938,181163,1216,14,614,452,162,181163,Житомирська область
6939,181164,395,5,225,158,67,181164,Житомирська область
6940,181165,35,1,25,16,9,181165,Житомирська область
6941,181300,2170,30,1294,895,399,181300,Житомирська область
6942,181301,2371,38,1440,1106,334,181301,Житомирська область
6943,181302,2172,32,1276,916,360,181302,Житомирська область
6944,181303,1496,15,865,615,250,181303,Житомирська область
6945,181304,2042,31,1259,829,430,181304,Житомирська область
6946,181305,2251,19,1355,971,384,181305,Житомирська область
6947,181306,2349,28,1442,1007,435,181306,Житомирська область
6948,181307,1784,20,1063,718,345,181307,Житомирська область
6949,181308,2355,39,1445,1001,444,181308,Житомирська область
6950,181309,2334,32,1389,1018,371,181309,Житомирська область
6951,181310,19,0,18,9,9,181310,Житомирська область
6952,181463,2324,24,1298,1031,267,181463,Житомирська область
6953,1,113,2,95,78,17,1,Житомирська область
6954,180292,922,10,514,388,126,180292,Житомирська область
6955,180293,504,4,341,277,64,180293,Житомирська область
6956,180294,313,0,175,140,35,180294,Житомирська область
6957,180295,313,8,168,120,48,180295,Житомирська область
6958,180296,347,1,204,157,47,180296,Житомирська область
6959,180297,274,6,166,124,42,180297,Житомирська область
6960,180298,206,4,126,92,34,180298,Житомирська область
6961,180299,626,6,317,238,79,180299,Житомирська область
6962,180300,1670,22,1009,783,226,180300,Житомирська область
6963,180301,588,9,395,71,324,180301,Житомирська область
6964,180302,116,2,58,41,17,180302,Житомирська область
6965,180303,333,5,196,138,58,180303,Житомирська область
6966,180304,366,1,192,140,52,180304,Житомирська область
6967,180305,1278,14,706,572,134,180305,Житомирська область
6968,180306,297,3,159,112,47,180306,Житомирська область
6969,180307,114,0,82,72,10,180307,Житомирська область
6970,180308,594,7,254,175,79,180308,Житомирська область
6971,180309,375,2,227,157,70,180309,Житомирська область
6972,180310,2291,29,1377,968,409,180310,Житомирська область
6973,180311,462,7,275,226,49,180311,Житомирська область
6974,180312,472,6,299,195,104,180312,Житомирська область
6975,180313,967,20,575,443,132,180313,Житомирська область
6976,180314,195,2,99,84,15,180314,Житомирська область
6977,180315,2076,32,1273,983,290,180315,Житомирська область
6978,180316,186,3,95,59,36,180316,Житомирська область
6979,180317,1796,20,1017,799,218,180317,Житомирська область
6980,180318,185,16,159,87,72,180318,Житомирська область
6981,180319,894,11,509,376,133,180319,Житомирська область
6982,180320,317,2,186,151,35,180320,Житомирська область
6983,180321,594,7,336,276,60,180321,Житомирська область
6984,180322,1083,13,713,540,173,180322,Житомирська область
6985,180323,516,9,313,267,46,180323,Житомирська область
6986,180324,1499,16,831,660,171,180324,Житомирська область
6987,180325,366,0,235,181,54,180325,Житомирська область
6988,180326,180,1,123,79,44,180326,Житомирська область
6989,180327,2328,27,1265,956,309,180327,Житомирська область
6990,180328,523,9,368,284,84,180328,Житомирська область
6991,180329,501,1,307,209,98,180329,Житомирська область
6992,180330,1083,19,632,443,189,180330,Житомирська область
6993,180331,1045,22,713,530,183,180331,Житомирська область
6994,180332,377,4,299,221,78,180332,Житомирська область
6995,180333,542,5,318,199,119,180333,Житомирська область
6996,180334,975,22,584,441,143,180334,Житомирська область
6997,180335,1890,32,1185,990,195,180335,Житомирська область
6998,180336,1917,35,1273,987,286,180336,Житомирська область
6999,180337,1631,28,1120,895,225,180337,Житомирська область
7000,180338,1129,15,776,605,171,180338,Житомирська область
7001,180339,1755,13,1109,888,221,180339,Житомирська область
7002,180340,566,10,302,231,71,180340,Житомирська область
7003,180341,1455,10,939,691,248,180341,Житомирська область
7004,180342,304,3,165,126,39,180342,Житомирська область
7005,180343,1063,22,803,655,148,180343,Житомирська область
7006,180344,528,4,327,278,49,180344,Житомирська область
7007,180345,266,3,172,107,65,180345,Житомирська область
7008,180346,127,0,95,63,32,180346,Житомирська область
7009,180347,141,1,108,67,41,180347,Житомирська область
7010,180348,825,5,442,324,118,180348,Житомирська область
7011,180349,1509,33,882,692,190,180349,Житомирська область
7012,180350,1050,11,639,507,132,180350,Житомирська область
7013,180351,413,8,217,173,44,180351,Житомирська область
7014,180352,297,3,188,134,54,180352,Житомирська область
7015,180353,1712,13,996,752,244,180353,Житомирська область
7016,180354,635,14,392,331,61,180354,Житомирська область
7017,180355,2280,28,1327,1020,307,180355,Житомирська область
7018,180356,1337,17,630,468,162,180356,Житомирська область
7019,180357,243,4,135,113,22,180357,Житомирська область
7020,180358,59,0,36,28,8,180358,Житомирська область
7021,180359,324,18,254,181,73,180359,Житомирська область
7022,180360,78,2,71,49,22,180360,Житомирська область
7023,180361,48,0,33,23,10,180361,Житомирська область
7024,180362,81,5,72,57,15,180362,Житомирська область
7025,180519,1664,27,986,789,197,180519,Житомирська область
7026,180520,636,8,372,249,123,180520,Житомирська область
7027,180521,283,1,250,165,85,180521,Житомирська область
7028,180522,434,1,321,237,84,180522,Житомирська область
7029,180523,404,10,300,233,67,180523,Житомирська область
7030,180524,155,2,99,83,16,180524,Житомирська область
7031,180525,588,11,320,199,121,180525,Житомирська область
7032,180526,173,1,122,92,30,180526,Житомирська область
7033,180527,532,9,339,258,81,180527,Житомирська область
7034,180528,451,2,253,185,68,180528,Житомирська область
7035,180529,137,1,93,49,44,180529,Житомирська область
7036,180530,109,4,69,48,21,180530,Житомирська область
7037,180531,219,1,129,87,42,180531,Житомирська область
7038,180532,342,4,231,184,47,180532,Житомирська область
7039,180533,331,4,226,153,73,180533,Житомирська область
7040,180534,113,1,67,51,16,180534,Житомирська область
7041,180535,222,0,161,135,26,180535,Житомирська область
7042,180536,173,2,106,85,21,180536,Житомирська область
7043,180537,199,5,112,89,23,180537,Житомирська область
7044,180538,365,1,215,137,78,180538,Житомирська область
7045,180539,1240,12,762,579,183,180539,Житомирська область
7046,180540,709,9,395,325,70,180540,Житомирська область
7047,180541,191,1,119,94,25,180541,Житомирська область
7048,180542,610,18,491,307,184,180542,Житомирська область
7049,180543,342,1,210,163,47,180543,Житомирська область
7050,180544,597,4,412,289,123,180544,Житомирська область
7051,180545,162,4,115,68,47,180545,Житомирська область
7052,180546,235,2,130,103,27,180546,Житомирська область
7053,180547,94,1,56,32,24,180547,Житомирська область
7054,180548,942,11,616,511,105,180548,Житомирська область
7055,180549,1015,10,625,466,159,180549,Житомирська область
7056,180550,454,7,281,181,100,180550,Житомирська область
7057,180551,1138,8,660,516,144,180551,Житомирська область
7058,180552,347,5,229,191,38,180552,Житомирська область
7059,180553,1181,12,627,507,120,180553,Житомирська область
7060,180554,429,3,287,206,81,180554,Житомирська область
7061,180555,272,1,189,124,65,180555,Житомирська область
7062,180556,770,8,416,309,107,180556,Житомирська область
7063,180557,237,5,156,104,52,180557,Житомирська область
7064,180558,204,1,130,100,30,180558,Житомирська область
7065,180559,424,2,248,190,58,180559,Житомирська область
7066,180560,888,10,552,446,106,180560,Житомирська область
7067,180561,677,7,414,336,78,180561,Житомирська область
7068,180562,29,0,27,18,9,180562,Житомирська область
7069,180970,1412,11,858,657,201,180970,Житомирська область
7070,180971,219,2,153,114,39,180971,Житомирська область
7071,180972,1573,17,883,648,235,180972,Житомирська область
7072,180973,1554,20,796,605,191,180973,Житомирська область
7073,180974,1727,20,1019,781,238,180974,Житомирська область
7074,180975,1019,9,618,451,167,180975,Житомирська область
7075,180976,793,7,395,306,89,180976,Житомирська область
7076,180977,1203,13,723,492,231,180977,Житомирська область
7077,180978,600,5,348,251,97,180978,Житомирська область
7078,180979,1043,10,532,372,160,180979,Житомирська область
7079,180980,229,1,135,105,30,180980,Житомирська область
7080,180981,297,4,163,105,58,180981,Житомирська область
7081,180982,294,2,188,159,29,180982,Житомирська область
7082,180983,517,4,350,262,88,180983,Житомирська область
7083,180984,725,6,415,265,150,180984,Житомирська область
7084,180985,167,1,166,126,40,180985,Житомирська область
7085,180986,238,4,167,104,63,180986,Житомирська область
7086,180987,132,0,88,56,32,180987,Житомирська область
7087,180988,437,5,258,169,89,180988,Житомирська область
7088,180989,537,13,325,216,109,180989,Житомирська область
7089,180990,146,1,86,65,21,180990,Житомирська область
7090,180991,624,4,333,228,105,180991,Житомирська область
7091,180992,83,1,56,45,11,180992,Житомирська область
7092,180993,182,6,116,85,31,180993,Житомирська область
7093,180994,125,1,95,48,47,180994,Житомирська область
7094,180995,394,3,255,202,53,180995,Житомирська область
7095,180996,171,3,85,56,29,180996,Житомирська область
7096,180997,187,1,121,100,21,180997,Житомирська область
7097,180998,127,0,85,57,28,180998,Житомирська область
7098,180999,78,1,55,47,8,180999,Житомирська область
7099,181000,228,2,170,134,36,181000,Житомирська область
7100,181001,829,9,460,376,84,181001,Житомирська область
7101,181002,238,2,152,124,28,181002,Житомирська область
7102,181003,170,4,101,69,32,181003,Житомирська область
7103,181004,233,2,140,100,40,181004,Житомирська область
7104,181005,380,1,238,157,81,181005,Житомирська область
7105,181006,350,5,221,150,71,181006,Житомирська область
7106,181007,149,4,101,79,22,181007,Житомирська область
7107,181008,268,3,207,130,77,181008,Житомирська область
7108,181009,128,1,75,54,21,181009,Житомирська область
7109,181010,112,0,63,45,18,181010,Житомирська область
7110,181011,223,5,158,120,38,181011,Житомирська область
7111,181012,120,2,74,54,20,181012,Житомирська область
7112,181013,370,4,209,149,60,181013,Житомирська область
7113,181014,275,2,188,126,62,181014,Житомирська область
7114,181015,231,1,153,108,45,181015,Житомирська область
7115,181016,57,0,41,19,22,181016,Житомирська область
7116,181017,291,2,163,97,66,181017,Житомирська область
7117,181018,69,0,39,24,15,181018,Житомирська область
7118,181019,117,0,62,29,33,181019,Житомирська область
7119,181020,265,2,168,129,39,181020,Житомирська область
7120,181021,26,1,21,16,5,181021,Житомирська область
7121,181166,1129,18,649,491,158,181166,Житомирська область
7122,181167,1163,18,686,491,195,181167,Житомирська область
7123,181168,1154,17,707,506,201,181168,Житомирська область
7124,181169,1299,15,797,565,232,181169,Житомирська область
7125,181170,1405,6,820,662,158,181170,Житомирська область
7126,181171,937,25,579,421,158,181171,Житомирська область
7127,181172,839,13,431,328,103,181172,Житомирська область
7128,181173,215,4,132,101,31,181173,Житомирська область
7129,181174,865,16,444,372,72,181174,Житомирська область
7130,181175,964,13,458,357,101,181175,Житомирська область
7131,181176,864,10,430,351,79,181176,Житомирська область
7132,181177,51,1,33,17,16,181177,Житомирська область
7133,181178,416,7,245,180,65,181178,Житомирська область
7134,181179,65,1,44,26,18,181179,Житомирська область
7135,181180,249,2,221,152,69,181180,Житомирська область
7136,181181,421,4,266,194,72,181181,Житомирська область
7137,181182,675,7,483,391,92,181182,Житомирська область
7138,181183,336,4,199,127,72,181183,Житомирська область
7139,181184,143,1,78,46,32,181184,Житомирська область
7140,181185,1275,14,765,546,219,181185,Житомирська область
7141,181186,442,9,285,222,63,181186,Житомирська область
7142,181187,240,4,174,128,46,181187,Житомирська область
7143,181188,119,1,84,55,29,181188,Житомирська область
7144,181189,74,0,38,18,20,181189,Житомирська область
7145,181190,815,11,451,362,89,181190,Житомирська область
7146,181191,321,2,179,120,59,181191,Житомирська область
7147,181192,346,3,207,118,89,181192,Житомирська область
7148,181193,123,2,106,65,41,181193,Житомирська область
7149,181194,1267,11,635,510,125,181194,Житомирська область
7150,181195,134,0,105,65,40,181195,Житомирська область
7151,181196,339,4,193,128,65,181196,Житомирська область
7152,181197,420,4,272,205,67,181197,Житомирська область
7153,181198,277,0,183,121,62,181198,Житомирська область
7154,181199,156,2,121,88,33,181199,Житомирська область
7155,181200,253,3,197,161,36,181200,Житомирська область
7156,181201,741,10,448,338,110,181201,Житомирська область
7157,181202,577,7,351,278,73,181202,Житомирська область
7158,181203,227,1,150,98,52,181203,Житомирська область
7159,181204,132,0,88,69,19,181204,Житомирська область
7160,181205,420,8,257,190,67,181205,Житомирська область
7161,181206,68,0,49,26,23,181206,Житомирська область
7162,181207,479,7,292,230,62,181207,Житомирська область
7163,181208,128,2,74,46,28,181208,Житомирська область
7164,181209,598,4,311,135,176,181209,Житомирська область
7165,181210,179,0,111,44,67,181210,Житомирська область
7166,181211,102,0,60,36,24,181211,Житомирська область
7167,181212,326,2,173,107,66,181212,Житомирська область
7168,181213,481,4,311,215,96,181213,Житомирська область
7169,181214,559,10,325,255,70,181214,Житомирська область
7170,181215,54,0,45,36,9,181215,Житомирська область
7171,181216,606,3,317,240,77,181216,Житомирська область
7172,181217,303,3,166,103,63,181217,Житомирська область
7173,181218,200,1,122,74,48,181218,Житомирська область
7174,181219,638,10,413,338,75,181219,Житомирська область
7175,181220,160,6,118,90,28,181220,Житомирська область
7176,181221,380,5,329,235,94,181221,Житомирська область
7177,181222,299,2,188,136,52,181222,Житомирська область
7178,181223,116,2,77,70,7,181223,Житомирська область
7179,181224,62,2,28,19,9,181224,Житомирська область
7180,181373,2025,55,1309,1017,292,181373,Житомирська область
7181,181374,1944,29,1099,860,239,181374,Житомирська область
7182,181375,2410,49,1566,1092,474,181375,Житомирська область
7183,181376,2087,35,1365,1002,363,181376,Житомирська область
7184,181377,1716,31,1105,886,219,181377,Житомирська область
7185,181378,1868,41,1145,897,248,181378,Житомирська область
7186,181379,2055,38,1185,936,249,181379,Житомирська область
7187,181380,1673,19,1010,767,243,181380,Житомирська область
7188,181381,1717,19,1055,801,254,181381,Житомирська область
7189,181387,2374,40,1482,1166,316,181387,Житомирська область
7190,181390,1410,23,870,668,202,181390,Житомирська область
7191,181391,2286,44,1387,1064,323,181391,Житомирська область
7192,181392,2012,31,1158,897,261,181392,Житомирська область
7193,181393,2382,45,1422,1131,291,181393,Житомирська область
7194,181394,2427,52,1382,1116,266,181394,Житомирська область
7195,181395,1674,30,1101,799,302,181395,Житомирська область
7196,181396,2408,43,1545,1145,400,181396,Житомирська область
7197,181397,2316,37,1472,1106,366,181397,Житомирська область
7198,181398,2404,44,1435,1114,321,181398,Житомирська область
7199,181461,283,2,197,165,32,181461,Житомирська область
7200,181462,144,2,95,84,11,181462,Житомирська область
7201,1,320,41,277,254,23,1,Закарпатська область
7202,210548,485,6,171,160,11,210548,Закарпатська область
7203,210549,1261,21,681,571,110,210549,Закарпатська область
7204,210550,1119,27,621,530,91,210550,Закарпатська область
7205,210551,400,6,226,191,35,210551,Закарпатська область
7206,210552,1735,30,986,717,269,210552,Закарпатська область
7207,210553,459,8,309,245,64,210553,Закарпатська область
7208,210554,465,5,324,258,66,210554,Закарпатська область
7209,210555,349,2,234,190,44,210555,Закарпатська область
7210,210556,628,7,368,318,50,210556,Закарпатська область
7211,210557,181,0,120,82,38,210557,Закарпатська область
7212,210558,203,4,102,67,35,210558,Закарпатська область
7213,210559,340,3,221,157,64,210559,Закарпатська область
7214,210560,590,8,363,275,88,210560,Закарпатська область
7215,210561,611,18,378,315,63,210561,Закарпатська область
7216,210562,313,2,199,171,28,210562,Закарпатська область
7217,210563,731,16,445,363,82,210563,Закарпатська область
7218,210564,1132,15,625,532,93,210564,Закарпатська область
7219,210565,744,6,374,295,79,210565,Закарпатська область
7220,210566,205,1,136,116,20,210566,Закарпатська область
7221,210567,321,3,190,157,33,210567,Закарпатська область
7222,210568,391,9,221,187,34,210568,Закарпатська область
7223,210569,1514,33,903,758,145,210569,Закарпатська область
7224,210570,233,2,161,125,36,210570,Закарпатська область
7225,210571,823,15,505,386,119,210571,Закарпатська область
7226,210572,2111,41,1299,950,349,210572,Закарпатська область
7227,210573,533,6,344,266,78,210573,Закарпатська область
7228,210574,478,7,297,212,85,210574,Закарпатська область
7229,210575,344,1,190,153,37,210575,Закарпатська область
7230,210576,793,4,285,270,15,210576,Закарпатська область
7231,210577,559,3,264,253,11,210577,Закарпатська область
7232,210578,87,1,45,32,13,210578,Закарпатська область
7233,210579,1255,17,728,596,132,210579,Закарпатська область
7234,210580,309,6,178,123,55,210580,Закарпатська область
7235,210581,1345,16,784,641,143,210581,Закарпатська область
7236,210582,364,5,217,153,64,210582,Закарпатська область
7237,210583,588,8,342,290,52,210583,Закарпатська область
7238,210584,1192,13,542,418,124,210584,Закарпатська область
7239,210585,451,4,214,178,36,210585,Закарпатська область
7240,210586,656,15,355,279,76,210586,Закарпатська область
7241,210587,733,5,311,269,42,210587,Закарпатська область
7242,210588,1073,22,515,432,83,210588,Закарпатська область
7243,210589,1115,13,616,466,150,210589,Закарпатська область
7244,210590,1918,52,1225,819,406,210590,Закарпатська область
7245,210591,1591,33,918,700,218,210591,Закарпатська область
7246,210592,1308,20,702,556,146,210592,Закарпатська область
7247,210593,1034,21,579,475,104,210593,Закарпатська область
7248,210594,1151,9,470,424,46,210594,Закарпатська область
7249,210595,1139,7,590,528,62,210595,Закарпатська область
7250,210596,625,7,243,222,21,210596,Закарпатська область
7251,210597,220,5,109,101,8,210597,Закарпатська область
7252,210598,1289,6,271,260,11,210598,Закарпатська область
7253,210599,671,3,247,240,7,210599,Закарпатська область
7254,210600,320,6,221,187,34,210600,Закарпатська область
7255,210601,624,16,390,346,44,210601,Закарпатська область
7256,210602,521,4,162,157,5,210602,Закарпатська область
7257,210603,1399,3,423,408,15,210603,Закарпатська область
7258,210604,310,2,138,129,9,210604,Закарпатська область
7259,210605,2148,9,496,483,13,210605,Закарпатська область
7260,210606,2162,15,573,544,29,210606,Закарпатська область
7261,210607,723,5,343,285,58,210607,Закарпатська область
7262,210608,297,3,144,119,25,210608,Закарпатська область
7263,210609,462,2,199,172,27,210609,Закарпатська область
7264,210610,388,4,205,189,16,210610,Закарпатська область
7265,210611,185,3,96,84,12,210611,Закарпатська область
7266,210612,321,6,173,161,12,210612,Закарпатська область
7267,210613,832,5,328,299,29,210613,Закарпатська область
7268,210614,1534,16,504,466,38,210614,Закарпатська область
7269,210615,480,2,202,186,16,210615,Закарпатська область
7270,210713,1938,38,1149,791,358,210713,Закарпатська область
7271,210714,1259,25,720,473,247,210714,Закарпатська область
7272,210715,1278,13,541,366,175,210715,Закарпатська область
7273,210716,805,10,298,215,83,210716,Закарпатська область
7274,210717,1727,54,1016,709,307,210717,Закарпатська область
7275,210718,1722,42,1042,750,292,210718,Закарпатська область
7276,210719,1632,31,964,714,250,210719,Закарпатська область
7277,210720,1640,40,971,659,312,210720,Закарпатська область
7278,210721,1818,49,1064,775,289,210721,Закарпатська область
7279,210722,1446,39,827,598,229,210722,Закарпатська область
7280,210723,1543,36,850,604,246,210723,Закарпатська область
7281,210724,1546,34,873,574,299,210724,Закарпатська область
7282,210725,1210,36,702,466,236,210725,Закарпатська область
7283,210726,1814,68,1086,688,398,210726,Закарпатська область
7284,210727,2066,36,1229,855,374,210727,Закарпатська область
7285,210728,1839,37,1054,754,300,210728,Закарпатська область
7286,210729,1834,49,1073,694,379,210729,Закарпатська область
7287,210730,1276,27,787,531,256,210730,Закарпатська область
7288,210731,1165,24,650,422,228,210731,Закарпатська область
7289,210732,1130,20,695,438,257,210732,Закарпатська область
7290,210733,1530,24,613,466,147,210733,Закарпатська область
7291,210734,1575,21,607,512,95,210734,Закарпатська область
7292,210735,1499,32,781,576,205,210735,Закарпатська область
7293,210736,1360,24,580,439,141,210736,Закарпатська область
7294,210737,1826,28,981,757,224,210737,Закарпатська область
7295,210738,1499,30,797,630,167,210738,Закарпатська область
7296,210739,1805,41,1015,745,270,210739,Закарпатська область
7297,210740,1566,17,818,614,204,210740,Закарпатська область
7298,210741,1322,33,728,531,197,210741,Закарпатська область
7299,210742,954,23,551,378,173,210742,Закарпатська область
7300,210743,1488,34,919,647,272,210743,Закарпатська область
7301,210744,1872,51,1083,740,343,210744,Закарпатська область
7302,210745,1789,30,1067,781,286,210745,Закарпатська область
7303,210746,1702,48,999,708,291,210746,Закарпатська область
7304,210747,1771,35,1050,728,322,210747,Закарпатська область
7305,210748,1660,40,943,621,322,210748,Закарпатська область
7306,210749,1624,40,964,656,308,210749,Закарпатська область
7307,210750,1448,35,886,580,306,210750,Закарпатська область
7308,210751,1806,51,1087,727,360,210751,Закарпатська область
7309,210752,1643,35,941,631,310,210752,Закарпатська область
7310,210753,1387,24,765,548,217,210753,Закарпатська область
7311,210754,1246,25,752,555,197,210754,Закарпатська область
7312,210755,1261,26,695,486,209,210755,Закарпатська область
7313,210756,1051,27,584,419,165,210756,Закарпатська область
7314,210757,1632,23,919,674,245,210757,Закарпатська область
7315,210758,1958,45,1148,795,353,210758,Закарпатська область
7316,210759,1317,34,788,535,253,210759,Закарпатська область
7317,210760,1464,30,853,612,241,210760,Закарпатська область
7318,210761,1304,29,821,529,292,210761,Закарпатська область
7319,210762,1632,29,952,659,293,210762,Закарпатська область
7320,210763,1519,35,855,592,263,210763,Закарпатська область
7321,210764,1419,33,902,612,290,210764,Закарпатська область
7322,210765,1590,37,1002,710,292,210765,Закарпатська область
7323,210766,1656,40,921,657,264,210766,Закарпатська область
7324,210767,1326,36,737,537,200,210767,Закарпатська область
7325,210768,1651,40,902,650,252,210768,Закарпатська область
7326,210769,1377,15,772,529,243,210769,Закарпатська область
7327,210770,1756,40,1046,727,319,210770,Закарпатська область
7328,210771,1196,24,603,446,157,210771,Закарпатська область
7329,210772,1549,29,881,637,244,210772,Закарпатська область
7330,210773,41,0,39,34,5,210773,Закарпатська область
7331,210774,154,6,136,102,34,210774,Закарпатська область
7332,210775,70,2,61,46,15,210775,Закарпатська область
7333,210776,95,3,92,79,13,210776,Закарпатська область
7334,210777,302,8,260,216,44,210777,Закарпатська область
7335,210778,39,0,36,29,7,210778,Закарпатська область
7336,210779,39,3,36,31,5,210779,Закарпатська область
7337,210780,87,0,68,52,16,210780,Закарпатська область
7338,210781,54,0,43,33,10,210781,Закарпатська область
7339,210782,35,1,21,15,6,210782,Закарпатська область
7340,210783,20,1,19,15,4,210783,Закарпатська область
7341,210802,2482,22,1058,901,157,210802,Закарпатська область
7342,210803,2302,37,1181,955,226,210803,Закарпатська область
7343,210804,2215,35,1120,956,164,210804,Закарпатська область
7344,210810,1490,41,907,673,234,210810,Закарпатська область
7345,210003,1344,10,411,388,23,210003,Закарпатська область
7346,210004,2137,16,819,743,76,210004,Закарпатська область
7347,210005,563,4,250,240,10,210005,Закарпатська область
7348,210012,1374,5,476,452,24,210012,Закарпатська область
7349,210013,924,2,310,300,10,210013,Закарпатська область
7350,210015,2210,15,545,519,26,210015,Закарпатська область
7351,210017,977,1,257,253,4,210017,Закарпатська область
7352,210019,1333,8,422,413,9,210019,Закарпатська область
7353,210021,1735,9,449,412,37,210021,Закарпатська область
7354,210029,805,11,205,197,8,210029,Закарпатська область
7355,210030,523,3,184,162,22,210030,Закарпатська область
7356,210031,694,6,166,155,11,210031,Закарпатська область
7357,210032,2184,21,988,862,126,210032,Закарпатська область
7358,210035,1028,5,372,353,19,210035,Закарпатська область
7359,210172,569,2,166,150,16,210172,Закарпатська область
7360,210173,1944,24,666,612,54,210173,Закарпатська область
7361,210174,1221,14,717,651,66,210174,Закарпатська область
7362,210175,2018,11,987,852,135,210175,Закарпатська область
7363,210176,1270,10,592,544,48,210176,Закарпатська область
7364,210177,1407,12,726,663,63,210177,Закарпатська область
7365,210178,1805,14,718,607,111,210178,Закарпатська область
7366,210179,1723,19,838,697,141,210179,Закарпатська область
7367,210180,1789,22,815,694,121,210180,Закарпатська область
7368,210203,1187,9,534,454,80,210203,Закарпатська область
7369,210204,639,4,366,319,47,210204,Закарпатська область
7370,210205,356,3,187,157,30,210205,Закарпатська область
7371,210206,243,0,158,136,22,210206,Закарпатська область
7372,210207,116,2,69,52,17,210207,Закарпатська область
7373,210208,715,11,349,312,37,210208,Закарпатська область
7374,210209,411,3,297,229,68,210209,Закарпатська область
7375,210210,772,4,556,511,45,210210,Закарпатська область
7376,210211,247,0,151,141,10,210211,Закарпатська область
7377,210212,196,5,89,71,18,210212,Закарпатська область
7378,210223,551,3,213,184,29,210223,Закарпатська область
7379,210224,580,11,312,275,37,210224,Закарпатська область
7380,210225,1092,18,430,396,34,210225,Закарпатська область
7381,210226,525,4,279,238,41,210226,Закарпатська область
7382,210227,1464,13,745,646,99,210227,Закарпатська область
7383,210228,759,11,387,353,34,210228,Закарпатська область
7384,210303,1846,10,705,597,108,210303,Закарпатська область
7385,210304,1989,17,760,677,83,210304,Закарпатська область
7386,210305,1402,14,507,455,52,210305,Закарпатська область
7387,210306,1328,13,472,431,41,210306,Закарпатська область
7388,210307,2132,33,935,814,121,210307,Закарпатська область
7389,210308,988,16,350,304,46,210308,Закарпатська область
7390,210309,2141,12,593,580,13,210309,Закарпатська область
7391,210310,1697,7,444,394,50,210310,Закарпатська область
7392,210311,433,0,226,193,33,210311,Закарпатська область
7393,210312,1278,12,837,750,87,210312,Закарпатська область
7394,210313,1361,12,781,688,93,210313,Закарпатська область
7395,210314,1379,19,649,526,123,210314,Закарпатська область
7396,210315,396,1,199,182,17,210315,Закарпатська область
7397,210316,208,1,107,87,20,210316,Закарпатська область
7398,210317,1416,13,565,520,45,210317,Закарпатська область
7399,210318,591,10,417,363,54,210318,Закарпатська область
7400,210319,998,22,489,384,105,210319,Закарпатська область
7401,210320,490,7,294,238,56,210320,Закарпатська область
7402,210321,1538,17,735,656,79,210321,Закарпатська область
7403,210322,623,9,356,314,42,210322,Закарпатська область
7404,210323,329,4,168,127,41,210323,Закарпатська область
7405,210324,203,1,102,69,33,210324,Закарпатська область
7406,210325,77,2,47,26,21,210325,Закарпатська область
7407,210326,2075,28,959,803,156,210326,Закарпатська область
7408,210327,547,5,338,235,103,210327,Закарпатська область
7409,210328,205,2,100,70,30,210328,Закарпатська область
7410,210329,124,4,55,41,14,210329,Закарпатська область
7411,210330,195,0,83,40,43,210330,Закарпатська область
7412,210332,702,8,526,371,155,210332,Закарпатська область
7413,210333,515,9,306,250,56,210333,Закарпатська область
7414,210334,1079,20,630,564,66,210334,Закарпатська область
7415,210335,1254,17,646,535,111,210335,Закарпатська область
7416,210336,771,13,358,299,59,210336,Закарпатська область
7417,210337,2040,44,910,778,132,210337,Закарпатська область
7418,210338,942,14,412,359,53,210338,Закарпатська область
7419,210339,735,14,411,334,77,210339,Закарпатська область
7420,210343,832,19,421,341,80,210343,Закарпатська область
7421,210344,583,6,368,312,56,210344,Закарпатська область
7422,210345,395,1,256,143,113,210345,Закарпатська область
7423,210347,132,0,54,37,17,210347,Закарпатська область
7424,210348,279,19,158,80,78,210348,Закарпатська область
7425,210349,51,0,34,16,18,210349,Закарпатська область
7426,210350,2353,20,674,609,65,210350,Закарпатська область
7427,210351,1134,10,477,415,62,210351,Закарпатська область
7428,210352,506,9,255,209,46,210352,Закарпатська область
7429,210353,823,10,377,329,48,210353,Закарпатська область
7430,210354,299,3,172,151,21,210354,Закарпатська область
7431,210355,1519,9,471,405,66,210355,Закарпатська область
7432,210356,1623,7,478,426,52,210356,Закарпатська область
7433,210357,736,4,438,366,72,210357,Закарпатська область
7434,210358,186,1,127,88,39,210358,Закарпатська область
7435,210359,1183,15,581,463,118,210359,Закарпатська область
7436,210360,1410,28,573,497,76,210360,Закарпатська область
7437,210361,1138,7,357,343,14,210361,Закарпатська область
7438,210362,1803,11,515,397,118,210362,Закарпатська область
7439,210363,346,7,210,179,31,210363,Закарпатська область
7440,210364,486,4,263,245,18,210364,Закарпатська область
7441,210365,200,3,135,108,27,210365,Закарпатська область
7442,210677,2469,46,1272,1052,220,210677,Закарпатська область
7443,210678,2378,36,1358,1071,287,210678,Закарпатська область
7444,210679,2347,38,1298,1010,288,210679,Закарпатська область
7445,210680,1965,27,1074,844,230,210680,Закарпатська область
7446,210681,2087,28,1086,903,183,210681,Закарпатська область
7447,210682,2263,37,1225,978,247,210682,Закарпатська область
7448,210683,2296,46,1234,994,240,210683,Закарпатська область
7449,210684,2154,44,1109,877,232,210684,Закарпатська область
7450,210685,1296,30,668,520,148,210685,Закарпатська область
7451,210686,834,10,410,325,85,210686,Закарпатська область
7452,210687,1189,13,624,522,102,210687,Закарпатська область
7453,210688,1662,31,904,746,158,210688,Закарпатська область
7454,210689,1298,22,716,578,138,210689,Закарпатська область
7455,210690,1898,37,1016,824,192,210690,Закарпатська область
7456,210691,1820,34,903,737,166,210691,Закарпатська область
7457,210692,2199,38,1083,922,161,210692,Закарпатська область
7458,210693,1571,20,716,593,123,210693,Закарпатська область
7459,210694,1573,22,769,618,151,210694,Закарпатська область
7460,210695,1431,22,620,509,111,210695,Закарпатська область
7461,210696,2049,13,285,255,30,210696,Закарпатська область
7462,210697,524,5,265,222,43,210697,Закарпатська область
7463,210698,2067,33,995,805,190,210698,Закарпатська область
7464,210699,1457,26,696,558,138,210699,Закарпатська область
7465,210700,1147,25,607,489,118,210700,Закарпатська область
7466,210701,2058,25,976,836,140,210701,Закарпатська область
7467,210702,2214,35,1140,925,215,210702,Закарпатська область
7468,210703,1737,32,955,798,157,210703,Закарпатська область
7469,210704,1808,27,929,770,159,210704,Закарпатська область
7470,210705,2012,42,1132,953,179,210705,Закарпатська область
7471,210706,1516,33,836,689,147,210706,Закарпатська область
7472,210707,1459,28,752,630,122,210707,Закарпатська область
7473,210708,1810,21,778,627,151,210708,Закарпатська область
7474,210709,1688,28,915,748,167,210709,Закарпатська область
7475,210710,1338,24,777,599,178,210710,Закарпатська область
7476,210711,891,10,520,355,165,210711,Закарпатська область
7477,210712,167,4,158,143,15,210712,Закарпатська область
7478,210037,245,3,136,107,29,210037,Закарпатська область
7479,210038,125,3,46,42,4,210038,Закарпатська область
7480,210039,971,8,438,392,46,210039,Закарпатська область
7481,210040,473,13,305,261,44,210040,Закарпатська область
7482,210041,135,4,81,66,15,210041,Закарпатська область
7483,210042,1095,15,787,639,148,210042,Закарпатська область
7484,210043,1621,34,844,635,209,210043,Закарпатська область
7485,210044,1838,32,654,534,120,210044,Закарпатська область
7486,210045,1462,31,745,571,174,210045,Закарпатська область
7487,210046,110,3,81,47,34,210046,Закарпатська область
7488,210047,135,2,119,93,26,210047,Закарпатська область
7489,210048,242,2,187,142,45,210048,Закарпатська область
7490,210049,223,2,190,151,39,210049,Закарпатська область
7491,210050,564,9,264,224,40,210050,Закарпатська область
7492,210051,355,7,191,156,35,210051,Закарпатська область
7493,210052,473,7,280,242,38,210052,Закарпатська область
7494,210053,379,2,178,139,39,210053,Закарпатська область
7495,210054,158,0,106,82,24,210054,Закарпатська область
7496,210055,238,3,127,113,14,210055,Закарпатська область
7497,210056,828,18,399,333,66,210056,Закарпатська область
7498,210057,346,9,260,221,39,210057,Закарпатська область
7499,210058,589,7,260,211,49,210058,Закарпатська область
7500,210059,603,0,277,227,50,210059,Закарпатська область
7501,210060,516,5,315,260,55,210060,Закарпатська область
7502,210061,508,1,270,226,44,210061,Закарпатська область
7503,210062,655,6,364,322,42,210062,Закарпатська область
7504,210063,198,0,103,80,23,210063,Закарпатська область
7505,210064,365,6,171,130,41,210064,Закарпатська область
7506,210065,329,0,193,177,16,210065,Закарпатська область
7507,210066,1135,12,579,453,126,210066,Закарпатська область
7508,210067,126,1,77,24,53,210067,Закарпатська область
7509,210068,331,1,215,169,46,210068,Закарпатська область
7510,210069,485,3,229,182,47,210069,Закарпатська область
7511,210070,662,7,323,265,58,210070,Закарпатська область
7512,210071,429,4,195,136,59,210071,Закарпатська область
7513,210072,109,1,63,53,10,210072,Закарпатська область
7514,210073,315,2,156,125,31,210073,Закарпатська область
7515,210074,51,3,47,23,24,210074,Закарпатська область
7516,210075,517,3,250,208,42,210075,Закарпатська область
7517,210141,1345,23,744,541,203,210141,Закарпатська область
7518,210142,1423,17,661,525,136,210142,Закарпатська область
7519,210143,1312,14,739,528,211,210143,Закарпатська область
7520,210144,541,9,275,213,62,210144,Закарпатська область
7521,210145,1635,11,773,667,106,210145,Закарпатська область
7522,210146,1006,11,566,494,72,210146,Закарпатська область
7523,210147,1738,24,1063,902,161,210147,Закарпатська область
7524,210148,773,8,460,394,66,210148,Закарпатська область
7525,210149,1836,18,873,712,161,210149,Закарпатська область
7526,210150,310,0,158,138,20,210150,Закарпатська область
7527,210151,765,7,377,295,82,210151,Закарпатська область
7528,210152,492,3,257,203,54,210152,Закарпатська область
7529,210153,171,2,93,80,13,210153,Закарпатська область
7530,210154,656,6,375,307,68,210154,Закарпатська область
7531,210155,380,0,243,173,70,210155,Закарпатська область
7532,210156,421,5,259,217,42,210156,Закарпатська область
7533,210157,429,5,209,175,34,210157,Закарпатська область
7534,210158,609,3,349,316,33,210158,Закарпатська область
7535,210159,303,4,150,143,7,210159,Закарпатська область
7536,210160,194,0,106,84,22,210160,Закарпатська область
7537,210161,1033,9,694,606,88,210161,Закарпатська область
7538,210162,162,2,110,83,27,210162,Закарпатська область
7539,210163,117,0,79,56,23,210163,Закарпатська область
7540,210164,402,4,213,179,34,210164,Закарпатська область
7541,210165,276,1,169,132,37,210165,Закарпатська область
7542,210166,286,1,175,147,28,210166,Закарпатська область
7543,210167,333,2,221,190,31,210167,Закарпатська область
7544,210229,429,9,253,218,35,210229,Закарпатська область
7545,210230,715,9,394,325,69,210230,Закарпатська область
7546,210231,818,13,470,384,86,210231,Закарпатська область
7547,210232,896,31,494,390,104,210232,Закарпатська область
7548,210233,1440,30,867,642,225,210233,Закарпатська область
7549,210234,1424,16,693,568,125,210234,Закарпатська область
7550,210235,697,11,349,284,65,210235,Закарпатська область
7551,210236,1054,7,714,555,159,210236,Закарпатська область
7552,210237,794,5,463,361,102,210237,Закарпатська область
7553,210238,330,4,170,102,68,210238,Закарпатська область
7554,210239,418,1,250,207,43,210239,Закарпатська область
7555,210240,925,18,445,366,79,210240,Закарпатська область
7556,210241,458,11,273,185,88,210241,Закарпатська область
7557,210242,57,0,37,23,14,210242,Закарпатська область
7558,210243,107,0,65,45,20,210243,Закарпатська область
7559,210244,996,15,451,349,102,210244,Закарпатська область
7560,210245,623,6,339,262,77,210245,Закарпатська область
7561,210246,522,3,328,221,107,210246,Закарпатська область
7562,210247,2499,12,815,661,154,210247,Закарпатська область
7563,210248,1368,16,498,387,111,210248,Закарпатська область
7564,210249,1016,10,360,316,44,210249,Закарпатська область
7565,210250,406,0,205,173,32,210250,Закарпатська область
7566,210251,379,1,211,154,57,210251,Закарпатська область
7567,210252,212,1,166,131,35,210252,Закарпатська область
7568,210253,575,3,329,278,51,210253,Закарпатська область
7569,210254,633,3,341,309,32,210254,Закарпатська область
7570,210255,198,0,119,104,15,210255,Закарпатська область
7571,210256,1316,15,638,535,103,210256,Закарпатська область
7572,210257,1664,14,725,622,103,210257,Закарпатська область
7573,210258,709,6,481,336,145,210258,Закарпатська область
7574,210259,502,7,294,209,85,210259,Закарпатська область
7575,210260,749,4,440,394,46,210260,Закарпатська область
7576,210261,859,8,491,381,110,210261,Закарпатська область
7577,210262,300,3,184,142,42,210262,Закарпатська область
7578,210263,273,3,207,146,61,210263,Закарпатська область
7579,210264,578,10,371,287,84,210264,Закарпатська область
7580,210265,129,0,91,68,23,210265,Закарпатська область
7581,210266,118,1,66,58,8,210266,Закарпатська область
7582,210267,890,13,516,467,49,210267,Закарпатська область
7583,210268,308,1,174,151,23,210268,Закарпатська область
7584,210269,113,2,79,72,7,210269,Закарпатська область
7585,210270,638,2,401,324,77,210270,Закарпатська область
7586,210271,2441,13,1104,972,132,210271,Закарпатська область
7587,210272,1146,5,753,656,97,210272,Закарпатська область
7588,210273,1397,26,532,419,113,210273,Закарпатська область
7589,210274,869,8,483,434,49,210274,Закарпатська область
7590,210275,901,9,417,353,64,210275,Закарпатська область
7591,210276,464,4,241,209,32,210276,Закарпатська область
7592,210277,600,2,312,247,65,210277,Закарпатська область
7593,210278,1240,18,692,540,152,210278,Закарпатська область
7594,210279,2255,34,1146,958,188,210279,Закарпатська область
7595,210280,605,13,321,266,55,210280,Закарпатська область
7596,210281,982,15,470,399,71,210281,Закарпатська область
7597,210282,222,3,185,132,53,210282,Закарпатська область
7598,210283,2031,27,984,814,170,210283,Закарпатська область
7599,210284,1007,8,442,368,74,210284,Закарпатська область
7600,210285,1164,18,514,432,82,210285,Закарпатська область
7601,210286,1020,18,494,370,124,210286,Закарпатська область
7602,210287,277,2,208,159,49,210287,Закарпатська область
7603,210288,191,1,130,103,27,210288,Закарпатська область
7604,210289,727,7,411,344,67,210289,Закарпатська область
7605,210290,246,5,154,108,46,210290,Закарпатська область
7606,210291,763,7,386,348,38,210291,Закарпатська область
7607,210292,558,8,279,239,40,210292,Закарпатська область
7608,210293,1585,15,797,680,117,210293,Закарпатська область
7609,210294,48,0,35,13,22,210294,Закарпатська область
7610,210295,474,2,205,191,14,210295,Закарпатська область
7611,210296,604,8,368,310,58,210296,Закарпатська область
7612,210297,1084,7,481,426,55,210297,Закарпатська область
7613,210298,212,1,143,115,28,210298,Закарпатська область
7614,210299,230,3,117,98,19,210299,Закарпатська область
7615,210300,1141,22,648,523,125,210300,Закарпатська область
7616,210301,630,10,473,345,128,210301,Закарпатська область
7617,210302,603,8,398,312,86,210302,Закарпатська область
7618,210331,1049,17,498,402,96,210331,Закарпатська область
7619,210340,711,7,285,236,49,210340,Закарпатська область
7620,210341,737,8,367,321,46,210341,Закарпатська область
7621,210342,558,4,310,281,29,210342,Закарпатська область
7622,210346,90,2,72,47,25,210346,Закарпатська область
7623,210366,193,3,122,109,13,210366,Закарпатська область
7624,210367,1290,21,758,618,140,210367,Закарпатська область
7625,210368,1153,13,589,497,92,210368,Закарпатська область
7626,210369,1469,27,768,627,141,210369,Закарпатська область
7627,210370,960,17,531,419,112,210370,Закарпатська область
7628,210371,1402,26,846,709,137,210371,Закарпатська область
7629,210372,211,2,137,123,14,210372,Закарпатська область
7630,210373,219,0,146,130,16,210373,Закарпатська область
7631,210374,1622,20,762,638,124,210374,Закарпатська область
7632,210375,436,3,225,203,22,210375,Закарпатська область
7633,210376,773,12,218,124,94,210376,Закарпатська область
7634,210377,570,10,367,328,39,210377,Закарпатська область
7635,210378,401,4,283,246,37,210378,Закарпатська область
7636,210379,1698,20,768,626,142,210379,Закарпатська область
7637,210380,1363,16,752,645,107,210380,Закарпатська область
7638,210381,717,11,417,365,52,210381,Закарпатська область
7639,210382,1224,24,596,482,114,210382,Закарпатська область
7640,210383,755,11,470,401,69,210383,Закарпатська область
7641,210384,190,1,104,90,14,210384,Закарпатська область
7642,210385,51,0,20,11,9,210385,Закарпатська область
7643,210386,86,2,56,42,14,210386,Закарпатська область
7644,210387,86,0,72,48,24,210387,Закарпатська область
7645,210388,422,7,256,190,66,210388,Закарпатська область
7646,210389,1204,16,582,484,98,210389,Закарпатська область
7647,210390,692,10,394,356,38,210390,Закарпатська область
7648,210391,31,0,21,15,6,210391,Закарпатська область
7649,210392,238,5,114,95,19,210392,Закарпатська область
7650,210393,103,0,41,32,9,210393,Закарпатська область
7651,210394,970,10,532,446,86,210394,Закарпатська область
7652,210395,361,0,205,162,43,210395,Закарпатська область
7653,210396,1092,13,554,488,66,210396,Закарпатська область
7654,210397,124,2,97,63,34,210397,Закарпатська область
7655,210440,2362,39,1262,1018,244,210440,Закарпатська область
7656,210441,1650,32,922,718,204,210441,Закарпатська область
7657,210442,1643,22,866,732,134,210442,Закарпатська область
7658,210443,1721,17,628,516,112,210443,Закарпатська область
7659,210444,1764,30,932,737,195,210444,Закарпатська область
7660,210445,1541,30,749,618,131,210445,Закарпатська область
7661,210446,1424,17,685,535,150,210446,Закарпатська область
7662,210447,731,13,344,291,53,210447,Закарпатська область
7663,210448,2315,21,1181,1084,97,210448,Закарпатська область
7664,210449,441,7,221,195,26,210449,Закарпатська область
7665,210450,2098,24,1043,915,128,210450,Закарпатська область
7666,210451,1003,18,587,495,92,210451,Закарпатська область
7667,210452,1172,13,607,555,52,210452,Закарпатська область
7668,210453,1676,14,696,634,62,210453,Закарпатська область
7669,210454,569,2,272,264,8,210454,Закарпатська область
7670,210455,180,0,125,91,34,210455,Закарпатська область
7671,210456,1619,9,806,718,88,210456,Закарпатська область
7672,210457,1685,24,683,593,90,210457,Закарпатська область
7673,210458,2366,32,1178,989,189,210458,Закарпатська область
7674,210459,1109,17,700,656,44,210459,Закарпатська область
7675,210460,911,10,439,397,42,210460,Закарпатська область
7676,210461,542,2,253,227,26,210461,Закарпатська область
7677,210462,324,2,187,170,17,210462,Закарпатська область
7678,210463,265,1,144,120,24,210463,Закарпатська область
7679,210464,2280,32,1383,1155,228,210464,Закарпатська область
7680,210465,319,6,241,220,21,210465,Закарпатська область
7681,210466,609,0,297,248,49,210466,Закарпатська область
7682,210467,401,5,269,222,47,210467,Закарпатська область
7683,210468,1934,22,902,822,80,210468,Закарпатська область
7684,210469,441,2,248,221,27,210469,Закарпатська область
7685,210470,1070,12,533,487,46,210470,Закарпатська область
7686,210471,849,6,420,386,34,210471,Закарпатська область
7687,210472,675,2,390,351,39,210472,Закарпатська область
7688,210473,633,5,417,371,46,210473,Закарпатська область
7689,210807,1139,9,547,474,73,210807,Закарпатська область
7690,210168,1709,25,793,632,161,210168,Закарпатська область
7691,210169,1830,21,817,710,107,210169,Закарпатська область
7692,210170,1745,24,845,690,155,210170,Закарпатська область
7693,210171,2077,38,1043,875,168,210171,Закарпатська область
7694,210181,1025,13,458,401,57,210181,Закарпатська область
7695,210182,1643,24,871,775,96,210182,Закарпатська область
7696,210183,1187,18,525,458,67,210183,Закарпатська область
7697,210185,2178,15,955,832,123,210185,Закарпатська область
7698,210186,2379,32,1024,871,153,210186,Закарпатська область
7699,210187,1491,10,582,510,72,210187,Закарпатська область
7700,210188,2281,20,729,647,82,210188,Закарпатська область
7701,210189,1481,13,774,626,148,210189,Закарпатська область
7702,210190,1938,23,979,878,101,210190,Закарпатська область
7703,210192,896,14,454,382,72,210192,Закарпатська область
7704,210193,423,5,243,204,39,210193,Закарпатська область
7705,210194,443,6,256,198,58,210194,Закарпатська область
7706,210195,1001,6,494,433,61,210195,Закарпатська область
7707,210198,2285,27,1048,924,124,210198,Закарпатська область
7708,210199,391,6,185,120,65,210199,Закарпатська область
7709,210200,2283,20,906,805,101,210200,Закарпатська область
7710,210201,2357,30,1102,966,136,210201,Закарпатська область
7711,210202,2185,11,862,756,106,210202,Закарпатська область
7712,210479,2064,31,864,684,180,210479,Закарпатська область
7713,210480,1825,22,787,641,146,210480,Закарпатська область
7714,210481,2209,24,885,712,173,210481,Закарпатська область
7715,210504,1812,19,740,672,68,210504,Закарпатська область
7716,210516,1231,9,505,451,54,210516,Закарпатська область
7717,210522,2086,21,678,595,83,210522,Закарпатська область
7718,210523,2308,15,798,722,76,210523,Закарпатська область
7719,210524,849,4,280,257,23,210524,Закарпатська область
7720,210529,1335,13,556,488,68,210529,Закарпатська область
7721,210534,1863,17,822,719,103,210534,Закарпатська область
7722,210535,1407,21,532,500,32,210535,Закарпатська область
7723,210537,1870,18,781,686,95,210537,Закарпатська область
7724,210538,561,13,264,241,23,210538,Закарпатська область
7725,210616,1400,16,770,665,105,210616,Закарпатська область
7726,210617,1211,12,590,480,110,210617,Закарпатська область
7727,210618,1294,13,553,456,97,210618,Закарпатська область
7728,210619,1142,4,384,359,25,210619,Закарпатська область
7729,210620,655,1,266,215,51,210620,Закарпатська область
7730,210621,1992,17,665,572,93,210621,Закарпатська область
7731,210622,1599,19,445,396,49,210622,Закарпатська область
7732,210623,2165,25,728,660,68,210623,Закарпатська область
7733,210624,1064,9,423,367,56,210624,Закарпатська область
7734,210625,892,8,389,351,38,210625,Закарпатська область
7735,210626,762,5,377,305,72,210626,Закарпатська область
7736,210627,1830,22,712,621,91,210627,Закарпатська область
7737,210628,1576,21,680,623,57,210628,Закарпатська область
7738,210629,1863,21,896,822,74,210629,Закарпатська область
7739,210630,1233,9,506,459,47,210630,Закарпатська область
7740,210631,1372,18,732,667,65,210631,Закарпатська область
7741,210632,1838,20,634,510,124,210632,Закарпатська область
7742,210633,2340,8,895,765,130,210633,Закарпатська область
7743,210634,670,4,257,212,45,210634,Закарпатська область
7744,210635,1445,11,518,469,49,210635,Закарпатська область
7745,210636,1588,26,718,647,71,210636,Закарпатська область
7746,210637,1495,23,587,528,59,210637,Закарпатська область
7747,210638,2358,17,1109,1013,96,210638,Закарпатська область
7748,210639,2020,25,863,816,47,210639,Закарпатська область
7749,210640,1033,6,505,438,67,210640,Закарпатська область
7750,210641,2194,18,1060,1001,59,210641,Закарпатська область
7751,210642,1251,7,559,485,74,210642,Закарпатська область
7752,210643,979,15,520,424,96,210643,Закарпатська область
7753,210644,1744,23,790,746,44,210644,Закарпатська область
7754,210645,1118,26,439,403,36,210645,Закарпатська область
7755,210646,1798,25,790,741,49,210646,Закарпатська область
7756,210647,1762,24,776,735,41,210647,Закарпатська область
7757,210648,1036,12,497,473,24,210648,Закарпатська область
7758,210649,2096,16,958,901,57,210649,Закарпатська область
7759,210650,1136,9,513,497,16,210650,Закарпатська область
7760,210651,1391,14,614,565,49,210651,Закарпатська область
7761,210652,827,9,430,337,93,210652,Закарпатська область
7762,210653,216,2,103,75,28,210653,Закарпатська область
7763,210654,349,8,280,191,89,210654,Закарпатська область
7764,210655,1718,39,804,749,55,210655,Закарпатська область
7765,210656,2233,40,1040,944,96,210656,Закарпатська область
7766,210657,1725,17,863,822,41,210657,Закарпатська область
7767,210658,1956,24,780,616,164,210658,Закарпатська область
7768,210659,1652,33,714,563,151,210659,Закарпатська область
7769,210660,322,3,145,103,42,210660,Закарпатська область
7770,210661,2073,31,923,810,113,210661,Закарпатська область
7771,210662,1874,21,721,645,76,210662,Закарпатська область
7772,210663,1578,19,695,590,105,210663,Закарпатська область
7773,210784,302,3,144,136,8,210784,Закарпатська область
7774,210785,1366,23,568,511,57,210785,Закарпатська область
7775,210786,627,9,340,290,50,210786,Закарпатська область
7776,210787,1654,39,938,761,177,210787,Закарпатська область
7777,210788,1475,22,793,621,172,210788,Закарпатська область
7778,210789,1411,20,741,603,138,210789,Закарпатська область
7779,210790,1309,24,629,494,135,210790,Закарпатська область
7780,210791,1055,25,529,380,149,210791,Закарпатська область
7781,210792,1334,15,556,471,85,210792,Закарпатська область
7782,210793,1189,9,523,433,90,210793,Закарпатська область
7783,210794,1558,25,809,646,163,210794,Закарпатська область
7784,210795,1646,28,877,677,200,210795,Закарпатська область
7785,210796,1185,31,637,525,112,210796,Закарпатська область
7786,210797,1445,19,737,605,132,210797,Закарпатська область
7787,210798,1974,36,915,778,137,210798,Закарпатська область
7788,210799,1579,23,810,653,157,210799,Закарпатська область
7789,210800,2094,40,1043,836,207,210800,Закарпатська область
7790,210801,1185,13,479,433,46,210801,Закарпатська область
7791,210805,782,6,374,331,43,210805,Закарпатська область
7792,210806,850,13,392,359,33,210806,Закарпатська область
7793,210398,2082,8,408,391,17,210398,Закарпатська область
7794,210399,280,0,50,46,4,210399,Закарпатська область
7795,210400,2351,9,276,249,27,210400,Закарпатська область
7796,210401,2164,1,239,225,14,210401,Закарпатська область
7797,210402,885,3,108,81,27,210402,Закарпатська область
7798,210403,1257,8,514,443,71,210403,Закарпатська область
7799,210404,689,1,135,128,7,210404,Закарпатська область
7800,210405,2134,17,663,581,82,210405,Закарпатська область
7801,210406,1757,17,668,628,40,210406,Закарпатська область
7802,210407,1058,2,244,220,24,210407,Закарпатська область
7803,210408,2382,15,912,823,89,210408,Закарпатська область
7804,210409,2272,29,896,651,245,210409,Закарпатська область
7805,210410,2286,14,987,695,292,210410,Закарпатська область
7806,210411,2300,19,919,731,188,210411,Закарпатська область
7807,210412,1775,18,639,420,219,210412,Закарпатська область
7808,210413,1240,4,408,288,120,210413,Закарпатська область
7809,210414,823,7,400,313,87,210414,Закарпатська область
7810,210415,1474,17,605,455,150,210415,Закарпатська область
7811,210416,418,7,204,173,31,210416,Закарпатська область
7812,210417,2046,21,913,736,177,210417,Закарпатська область
7813,210418,2209,16,819,660,159,210418,Закарпатська область
7814,210419,1916,4,502,437,65,210419,Закарпатська область
7815,210420,1565,5,579,516,63,210420,Закарпатська область
7816,210421,1253,9,440,369,71,210421,Закарпатська область
7817,210422,1814,15,700,566,134,210422,Закарпатська область
7818,210423,1018,5,603,507,96,210423,Закарпатська область
7819,210424,1241,6,485,389,96,210424,Закарпатська область
7820,210425,2097,29,986,658,328,210425,Закарпатська область
7821,210426,2219,20,616,448,168,210426,Закарпатська область
7822,210427,2364,36,948,657,291,210427,Закарпатська область
7823,210428,2397,13,674,514,160,210428,Закарпатська область
7824,210429,1994,16,721,538,183,210429,Закарпатська область
7825,210430,1339,14,532,430,102,210430,Закарпатська область
7826,210431,1818,11,812,612,200,210431,Закарпатська область
7827,210432,1101,7,374,287,87,210432,Закарпатська область
7828,210433,1983,17,914,665,249,210433,Закарпатська область
7829,210434,2354,34,1368,1012,356,210434,Закарпатська область
7830,210435,568,14,282,186,96,210435,Закарпатська область
7831,210436,684,7,387,261,126,210436,Закарпатська область
7832,210437,1769,18,751,545,206,210437,Закарпатська область
7833,210438,1114,16,521,405,116,210438,Закарпатська область
7834,210439,2132,34,1247,1023,224,210439,Закарпатська область
7835,210474,2275,33,886,774,112,210474,Закарпатська область
7836,210475,2017,24,729,647,82,210475,Закарпатська область
7837,210476,1880,15,876,727,149,210476,Закарпатська область
7838,210477,1595,17,665,536,129,210477,Закарпатська область
7839,210478,1219,11,465,434,31,210478,Закарпатська область
7840,210482,876,9,324,305,19,210482,Закарпатська область
7841,210483,1849,11,774,659,115,210483,Закарпатська область
7842,210484,2052,17,815,702,113,210484,Закарпатська область
7843,210485,2304,22,848,772,76,210485,Закарпатська область
7844,210486,1469,13,596,518,78,210486,Закарпатська область
7845,210487,2249,18,644,602,42,210487,Закарпатська область
7846,210488,2247,14,626,572,54,210488,Закарпатська область
7847,210489,1760,9,274,263,11,210489,Закарпатська область
7848,210490,1762,19,686,585,101,210490,Закарпатська область
7849,210491,1983,21,808,693,115,210491,Закарпатська область
7850,210492,1816,22,694,609,85,210492,Закарпатська область
7851,210493,1021,11,528,396,132,210493,Закарпатська область
7852,210494,1920,12,752,657,95,210494,Закарпатська область
7853,210495,1948,10,607,510,97,210495,Закарпатська область
7854,210496,776,8,420,388,32,210496,Закарпатська область
7855,210497,1262,10,409,381,28,210497,Закарпатська область
7856,210498,1747,15,665,575,90,210498,Закарпатська область
7857,210499,790,1,352,316,36,210499,Закарпатська область
7858,210500,300,0,136,122,14,210500,Закарпатська область
7859,210501,1148,6,352,326,26,210501,Закарпатська область
7860,210502,2482,29,945,750,195,210502,Закарпатська область
7861,210503,801,7,310,233,77,210503,Закарпатська область
7862,210505,2453,10,677,616,61,210505,Закарпатська область
7863,210506,1561,15,415,373,42,210506,Закарпатська область
7864,210507,2375,9,250,212,38,210507,Закарпатська область
7865,210508,1955,1,93,85,8,210508,Закарпатська область
7866,210509,2247,8,650,579,71,210509,Закарпатська область
7867,210510,2304,9,493,454,39,210510,Закарпатська область
7868,210511,2183,4,337,323,14,210511,Закарпатська область
7869,210512,1715,4,277,263,14,210512,Закарпатська область
7870,210513,1822,3,264,247,17,210513,Закарпатська область
7871,210514,989,0,71,61,10,210514,Закарпатська область
7872,210515,1970,23,869,802,67,210515,Закарпатська область
7873,210517,1652,9,661,605,56,210517,Закарпатська область
7874,210518,1104,9,388,363,25,210518,Закарпатська область
7875,210519,1443,10,685,643,42,210519,Закарпатська область
7876,210520,1824,22,819,661,158,210520,Закарпатська область
7877,210521,2357,9,863,775,88,210521,Закарпатська область
7878,210525,2365,10,1115,562,553,210525,Закарпатська область
7879,210526,1935,18,817,707,110,210526,Закарпатська область
7880,210527,684,3,250,214,36,210527,Закарпатська область
7881,210528,899,10,289,261,28,210528,Закарпатська область
7882,210530,2416,29,1054,908,146,210530,Закарпатська область
7883,210531,943,4,459,411,48,210531,Закарпатська область
7884,210532,954,5,429,322,107,210532,Закарпатська область
7885,210533,390,3,263,163,100,210533,Закарпатська область
7886,210536,2228,18,651,546,105,210536,Закарпатська область
7887,210539,2370,10,853,735,118,210539,Закарпатська область
7888,210540,2402,12,690,642,48,210540,Закарпатська область
7889,210541,1659,9,540,496,44,210541,Закарпатська область
7890,210542,1822,3,180,158,22,210542,Закарпатська область
7891,210543,1776,10,740,652,88,210543,Закарпатська область
7892,210544,1492,9,521,455,66,210544,Закарпатська область
7893,210545,931,7,386,338,48,210545,Закарпатська область
7894,210546,1835,26,629,579,50,210546,Закарпатська область
7895,210547,1841,17,732,687,45,210547,Закарпатська область
7896,210809,1424,8,472,422,50,210809,Закарпатська область
7897,210001,517,4,183,172,11,210001,Закарпатська область
7898,210002,1286,5,466,458,8,210002,Закарпатська область
7899,210006,1026,9,342,333,9,210006,Закарпатська область
7900,210007,1442,15,517,495,22,210007,Закарпатська область
7901,210008,1102,6,331,314,17,210008,Закарпатська область
7902,210009,2255,19,456,446,10,210009,Закарпатська область
7903,210010,823,10,388,308,80,210010,Закарпатська область
7904,210011,2004,17,621,597,24,210011,Закарпатська область
7905,210014,570,4,223,219,4,210014,Закарпатська область
7906,210016,754,8,265,256,9,210016,Закарпатська область
7907,210018,1578,8,517,503,14,210018,Закарпатська область
7908,210020,666,6,308,262,46,210020,Закарпатська область
7909,210022,684,1,269,258,11,210022,Закарпатська область
7910,210023,511,2,229,215,14,210023,Закарпатська область
7911,210024,241,3,174,154,20,210024,Закарпатська область
7912,210025,1499,12,543,508,35,210025,Закарпатська область
7913,210026,545,5,240,210,30,210026,Закарпатська область
7914,210027,441,1,207,170,37,210027,Закарпатська область
7915,210028,645,3,298,291,7,210028,Закарпатська область
7916,210033,575,3,181,172,9,210033,Закарпатська область
7917,210034,694,4,254,233,21,210034,Закарпатська область
7918,210036,2151,20,658,593,65,210036,Закарпатська область
7919,210076,2205,26,1178,970,208,210076,Закарпатська область
7920,210077,1532,15,615,552,63,210077,Закарпатська область
7921,210078,2419,13,823,676,147,210078,Закарпатська область
7922,210079,715,9,407,356,51,210079,Закарпатська область
7923,210080,1716,28,539,470,69,210080,Закарпатська область
7924,210081,1342,17,642,540,102,210081,Закарпатська область
7925,210082,1167,18,545,470,75,210082,Закарпатська область
7926,210083,1340,3,328,324,4,210083,Закарпатська область
7927,210084,725,7,168,164,4,210084,Закарпатська область
7928,210085,1548,9,782,697,85,210085,Закарпатська область
7929,210086,443,3,220,185,35,210086,Закарпатська область
7930,210087,1780,11,511,502,9,210087,Закарпатська область
7931,210088,1500,19,614,547,67,210088,Закарпатська область
7932,210089,1139,17,439,433,6,210089,Закарпатська область
7933,210090,967,13,476,409,67,210090,Закарпатська область
7934,210091,1168,12,495,474,21,210091,Закарпатська область
7935,210092,1229,15,446,425,21,210092,Закарпатська область
7936,210093,654,7,278,270,8,210093,Закарпатська область
7937,210094,279,6,120,119,1,210094,Закарпатська область
7938,210095,411,2,124,121,3,210095,Закарпатська область
7939,210096,229,0,70,57,13,210096,Закарпатська область
7940,210097,962,6,414,368,46,210097,Закарпатська область
7941,210098,1364,16,491,459,32,210098,Закарпатська область
7942,210099,1986,27,801,683,118,210099,Закарпатська область
7943,210100,1499,19,648,525,123,210100,Закарпатська область
7944,210101,2276,24,1186,1014,172,210101,Закарпатська область
7945,210102,1934,13,534,468,66,210102,Закарпатська область
7946,210103,1741,24,739,642,97,210103,Закарпатська область
7947,210104,557,5,251,246,5,210104,Закарпатська область
7948,210105,302,5,136,127,9,210105,Закарпатська область
7949,210106,1591,4,478,468,10,210106,Закарпатська область
7950,210107,1643,9,422,416,6,210107,Закарпатська область
7951,210108,575,3,167,162,5,210108,Закарпатська область
7952,210109,1097,13,460,388,72,210109,Закарпатська область
7953,210110,1768,29,926,805,121,210110,Закарпатська область
7954,210111,417,3,188,169,19,210111,Закарпатська область
7955,210112,1201,18,532,477,55,210112,Закарпатська область
7956,210113,1656,12,676,618,58,210113,Закарпатська область
7957,210114,1637,15,662,630,32,210114,Закарпатська область
7958,210115,1281,22,551,488,63,210115,Закарпатська область
7959,210116,1503,20,649,611,38,210116,Закарпатська область
7960,210117,624,9,315,296,19,210117,Закарпатська область
7961,210118,287,2,119,104,15,210118,Закарпатська область
7962,210119,1650,11,654,598,56,210119,Закарпатська область
7963,210120,509,7,277,253,24,210120,Закарпатська область
7964,210121,1618,31,735,651,84,210121,Закарпатська область
7965,210122,2263,18,737,698,39,210122,Закарпатська область
7966,210123,1842,21,691,612,79,210123,Закарпатська область
7967,210124,1227,9,418,390,28,210124,Закарпатська область
7968,210125,1283,3,296,284,12,210125,Закарпатська область
7969,210126,1800,15,812,674,138,210126,Закарпатська область
7970,210127,1830,19,804,728,76,210127,Закарпатська область
7971,210128,2455,10,445,397,48,210128,Закарпатська область
7972,210129,2297,34,1035,854,181,210129,Закарпатська область
7973,210130,2448,45,1177,974,203,210130,Закарпатська область
7974,210131,1459,24,657,559,98,210131,Закарпатська область
7975,210132,2188,26,955,813,142,210132,Закарпатська область
7976,210133,1291,28,558,477,81,210133,Закарпатська область
7977,210134,1725,31,851,716,135,210134,Закарпатська область
7978,210135,1592,13,710,615,95,210135,Закарпатська область
7979,210136,1996,19,924,780,144,210136,Закарпатська область
7980,210137,2026,26,968,800,168,210137,Закарпатська область
7981,210138,2133,34,1045,830,215,210138,Закарпатська область
7982,210139,767,11,330,292,38,210139,Закарпатська область
7983,210140,40,1,37,31,6,210140,Закарпатська область
7984,210184,1924,19,832,719,113,210184,Закарпатська область
7985,210191,621,11,376,330,46,210191,Закарпатська область
7986,210196,1442,11,569,510,59,210196,Закарпатська область
7987,210197,992,24,531,340,191,210197,Закарпатська область
7988,210213,1764,11,907,795,112,210213,Закарпатська область
7989,210214,529,0,231,208,23,210214,Закарпатська область
7990,210215,935,6,498,409,89,210215,Закарпатська область
7991,210216,2335,32,1403,1274,129,210216,Закарпатська область
7992,210217,1586,22,619,501,118,210217,Закарпатська область
7993,210218,1538,18,577,457,120,210218,Закарпатська область
7994,210219,1117,12,455,397,58,210219,Закарпатська область
7995,210220,357,7,193,168,25,210220,Закарпатська область
7996,210221,169,0,76,69,7,210221,Закарпатська область
7997,210222,605,12,288,244,44,210222,Закарпатська область
7998,210664,1664,18,665,552,113,210664,Закарпатська область
7999,210665,2250,18,920,752,168,210665,Закарпатська область
8000,210666,1240,12,546,442,104,210666,Закарпатська область
8001,210667,2255,31,811,728,83,210667,Закарпатська область
8002,210668,1198,9,371,325,46,210668,Закарпатська область
8003,210669,2210,25,753,628,125,210669,Закарпатська область
8004,210670,1927,27,664,540,124,210670,Закарпатська область
8005,210671,1413,18,585,492,93,210671,Закарпатська область
8006,210672,2119,17,883,718,165,210672,Закарпатська область
8007,210673,1024,17,327,314,13,210673,Закарпатська область
8008,210674,379,3,233,197,36,210674,Закарпатська область
8009,210675,1195,19,193,157,36,210675,Закарпатська область
8010,210676,81,8,72,66,6,210676,Закарпатська область
8011,210808,23,0,21,19,2,210808,Закарпатська область
8012,1,680,83,594,575,19,1,Запорізька область
8013,230811,2195,33,1454,1206,248,230811,Запорізька область
8014,230814,1973,35,1377,1141,236,230814,Запорізька область
8015,230820,2257,36,1553,1285,268,230820,Запорізька область
8016,230821,1819,39,1195,976,219,230821,Запорізька область
8017,230822,2111,38,1316,1053,263,230822,Запорізька область
8018,230823,2134,34,1405,1158,247,230823,Запорізька область
8019,230824,2157,29,1363,1165,198,230824,Запорізька область
8020,230825,2338,38,1537,1235,302,230825,Запорізька область
8021,230826,2253,36,1562,1295,267,230826,Запорізька область
8022,230827,2217,35,1364,1155,209,230827,Запорізька область
8023,230828,2293,34,1507,1250,257,230828,Запорізька область
8024,230829,2289,42,1267,1098,169,230829,Запорізька область
8025,230830,2366,48,1333,1123,210,230830,Запорізька область
8026,230831,2053,20,1172,960,212,230831,Запорізька область
8027,230832,2170,34,1316,1102,214,230832,Запорізька область
8028,230834,12,0,12,11,1,230834,Запорізька область
8029,230835,27,0,26,23,3,230835,Запорізька область
8030,230836,27,0,25,20,5,230836,Запорізька область
8031,230862,1614,13,958,851,107,230862,Запорізька область
8032,230863,1543,7,879,785,94,230863,Запорізька область
8033,230864,1963,28,1153,1012,141,230864,Запорізька область
8034,230865,1865,23,1134,991,143,230865,Запорізька область
8035,230866,1801,14,1174,986,188,230866,Запорізька область
8036,230867,2185,25,1447,1310,137,230867,Запорізька область
8037,230868,2295,27,1573,1369,204,230868,Запорізька область
8038,230869,2193,29,1082,942,140,230869,Запорізька область
8039,230870,2408,21,1185,1064,121,230870,Запорізька область
8040,230871,2047,21,1282,1131,151,230871,Запорізька область
8041,230872,1918,25,917,819,98,230872,Запорізька область
8042,230873,1562,25,783,681,102,230873,Запорізька область
8043,230874,2325,26,1460,1293,167,230874,Запорізька область
8044,230875,2263,29,1295,1135,160,230875,Запорізька область
8045,230876,2243,23,1369,1173,196,230876,Запорізька область
8046,230877,2218,36,1353,1197,156,230877,Запорізька область
8047,230878,2251,19,1475,1280,195,230878,Запорізька область
8048,230879,2218,32,1404,1153,251,230879,Запорізька область
8049,230880,2181,30,1376,1177,199,230880,Запорізька область
8050,230881,2263,29,1466,1269,197,230881,Запорізька область
8051,230882,2298,37,1543,1326,217,230882,Запорізька область
8052,230883,2259,36,1480,1261,219,230883,Запорізька область
8053,230884,2144,47,1421,1205,216,230884,Запорізька область
8054,230885,1986,15,1315,1097,218,230885,Запорізька область
8055,230886,1945,23,1218,1065,153,230886,Запорізька область
8056,230887,2070,28,1350,1141,209,230887,Запорізька область
8057,230888,1999,24,1362,1176,186,230888,Запорізька область
8058,230889,2102,43,1410,1196,214,230889,Запорізька область
8059,230890,2163,28,1483,1241,242,230890,Запорізька область
8060,230891,2101,28,1342,1132,210,230891,Запорізька область
8061,230892,2048,34,1344,1154,190,230892,Запорізька область
8062,230893,2121,42,1463,1228,235,230893,Запорізька область
8063,230894,2181,19,1483,1262,221,230894,Запорізька область
8064,230895,2069,25,1296,1141,155,230895,Запорізька область
8065,230896,1498,21,903,807,96,230896,Запорізька область
8066,230897,2305,25,1523,1324,199,230897,Запорізька область
8067,230898,2146,31,1456,1233,223,230898,Запорізька область
8068,230899,2116,21,1437,1211,226,230899,Запорізька область
8069,230900,2284,40,1537,1311,226,230900,Запорізька область
8070,230901,2023,27,1373,1167,206,230901,Запорізька область
8071,230902,2300,34,1546,1357,189,230902,Запорізька область
8072,230903,2152,21,1446,1229,217,230903,Запорізька область
8073,230904,2148,43,1462,1241,221,230904,Запорізька область
8074,230905,1865,27,1250,1073,177,230905,Запорізька область
8075,230906,2246,138,1411,1228,183,230906,Запорізька область
8076,230907,1893,34,1331,1081,250,230907,Запорізька область
8077,230908,2192,28,1496,1271,225,230908,Запорізька область
8078,230909,2413,61,1629,1375,254,230909,Запорізька область
8079,230910,270,6,222,207,15,230910,Запорізька область
8080,230911,319,14,276,238,38,230911,Запорізька область
8081,230912,101,1,79,69,10,230912,Запорізька область
8082,230913,61,3,57,49,8,230913,Запорізька область
8083,230915,115,3,111,91,20,230915,Запорізька область
8084,230916,28,1,27,25,2,230916,Запорізька область
8085,231128,50,0,48,40,8,231128,Запорізька область
8086,230838,2368,29,1526,1368,158,230838,Запорізька область
8087,230842,1854,34,1159,1043,116,230842,Запорізька область
8088,230843,1580,21,1048,941,107,230843,Запорізька область
8089,230844,2143,37,1394,1224,170,230844,Запорізька область
8090,230845,2076,31,1337,1231,106,230845,Запорізька область
8091,230846,2000,30,1306,1152,154,230846,Запорізька область
8092,230847,973,14,618,560,58,230847,Запорізька область
8093,230848,608,11,388,360,28,230848,Запорізька область
8094,230849,2296,21,1457,1307,150,230849,Запорізька область
8095,230850,2319,33,1452,1298,154,230850,Запорізька область
8096,230851,2197,28,1394,1224,170,230851,Запорізька область
8097,230852,2099,37,1321,1195,126,230852,Запорізька область
8098,230853,2202,40,1413,1253,160,230853,Запорізька область
8099,230854,1900,33,1259,1089,170,230854,Запорізька область
8100,230855,1944,29,1286,1146,140,230855,Запорізька область
8101,230856,1632,24,1028,931,97,230856,Запорізька область
8102,230857,1841,26,1194,1077,117,230857,Запорізька область
8103,230858,2279,23,1427,1270,157,230858,Запорізька область
8104,230859,2085,22,1378,1254,124,230859,Запорізька область
8105,230860,86,1,81,74,7,230860,Запорізька область
8106,230861,17,0,17,16,1,230861,Запорізька область
8107,230918,2103,36,1343,1103,240,230918,Запорізька область
8108,230919,1849,29,1221,1001,220,230919,Запорізька область
8109,230920,2062,28,1358,1107,251,230920,Запорізька область
8110,230921,1810,32,1147,906,241,230921,Запорізька область
8111,230922,1667,21,1114,914,200,230922,Запорізька область
8112,230923,1797,37,1197,964,233,230923,Запорізька область
8113,230925,1273,23,851,744,107,230925,Запорізька область
8114,230926,2343,32,1491,1254,237,230926,Запорізька область
8115,230927,2366,41,1660,1385,275,230927,Запорізька область
8116,230928,2338,37,1635,1397,238,230928,Запорізька область
8117,230929,2243,45,1584,1303,281,230929,Запорізька область
8118,230930,2150,40,1463,1217,246,230930,Запорізька область
8119,230931,2135,31,1448,1217,231,230931,Запорізька область
8120,230932,2262,46,1572,1337,235,230932,Запорізька область
8121,230933,2185,30,1475,1241,234,230933,Запорізька область
8122,230934,2176,26,1507,1249,258,230934,Запорізька область
8123,230935,2349,29,1577,1307,270,230935,Запорізька область
8124,230936,2348,40,1510,1254,256,230936,Запорізька область
8125,230937,2200,41,1533,1257,276,230937,Запорізька область
8126,230938,2199,47,1549,1308,241,230938,Запорізька область
8127,230939,2328,28,1536,1300,236,230939,Запорізька область
8128,230940,2447,29,1395,1123,272,230940,Запорізька область
8129,230942,2309,37,1546,1287,259,230942,Запорізька область
8130,230943,2248,38,1441,1211,230,230943,Запорізька область
8131,230946,2256,30,1338,1099,239,230946,Запорізька область
8132,230948,2350,37,1471,1269,202,230948,Запорізька область
8133,230949,2295,28,1453,1243,210,230949,Запорізька область
8134,230950,2321,30,1532,1344,188,230950,Запорізька область
8135,230951,1942,34,1275,1078,197,230951,Запорізька область
8136,230952,2234,27,1456,1268,188,230952,Запорізька область
8137,230953,2020,18,1318,1156,162,230953,Запорізька область
8138,230954,2000,25,1302,1141,161,230954,Запорізька область
8139,230955,1852,38,1237,1067,170,230955,Запорізька область
8140,230956,1932,27,1296,1067,229,230956,Запорізька область
8141,230957,1967,33,1297,1098,199,230957,Запорізька область
8142,230958,1813,28,1205,1036,169,230958,Запорізька область
8143,230959,2237,27,1465,1221,244,230959,Запорізька область
8144,230960,1987,27,1321,1103,218,230960,Запорізька область
8145,230961,2150,20,1324,1133,191,230961,Запорізька область
8146,230963,2279,20,1411,1247,164,230963,Запорізька область
8147,230964,1989,23,1263,1053,210,230964,Запорізька область
8148,230966,2129,23,1396,1148,248,230966,Запорізька область
8149,230967,2189,44,1405,1102,303,230967,Запорізька область
8150,230968,99,1,82,73,9,230968,Запорізька область
8151,230969,27,0,27,26,1,230969,Запорізька область
8152,230970,102,5,91,77,14,230970,Запорізька область
8153,230971,20,1,19,15,4,230971,Запорізька область
8154,1,10,0,10,7,3,1,Запорізька область
8155,230972,1143,17,768,640,128,230972,Запорізька область
8156,230973,1979,32,1284,1037,247,230973,Запорізька область
8157,230974,2042,34,1323,1099,224,230974,Запорізька область
8158,230975,2088,45,1309,1052,257,230975,Запорізька область
8159,230976,2285,51,1482,1169,313,230976,Запорізька область
8160,230977,2092,41,1398,1131,267,230977,Запорізька область
8161,230978,2252,32,1471,1241,230,230978,Запорізька область
8162,230979,2074,25,1310,1046,264,230979,Запорізька область
8163,230980,1726,39,1162,940,222,230980,Запорізька область
8164,230981,1528,36,988,785,203,230981,Запорізька область
8165,230982,1929,12,1316,1211,105,230982,Запорізька область
8166,230983,2038,26,1358,1094,264,230983,Запорізька область
8167,230984,1880,30,1065,887,178,230984,Запорізька область
8168,230985,1775,36,1140,881,259,230985,Запорізька область
8169,230986,1572,18,1047,861,186,230986,Запорізька область
8170,230987,2048,33,1286,1068,218,230987,Запорізька область
8171,230988,2059,30,1323,1101,222,230988,Запорізька область
8172,230989,2156,31,1511,1229,282,230989,Запорізька область
8173,230990,2085,23,1366,1127,239,230990,Запорізька область
8174,230991,2002,41,1165,1006,159,230991,Запорізька область
8175,230992,2008,23,1230,1023,207,230992,Запорізька область
8176,230993,1944,27,1256,999,257,230993,Запорізька область
8177,230994,1904,24,1195,1021,174,230994,Запорізька область
8178,230995,1929,31,1270,1043,227,230995,Запорізька область
8179,230996,2077,32,1370,1134,236,230996,Запорізька область
8180,230997,1634,21,1071,917,154,230997,Запорізька область
8181,230998,2158,38,1345,1103,242,230998,Запорізька область
8182,230999,1805,26,1135,914,221,230999,Запорізька область
8183,231000,1537,23,960,776,184,231000,Запорізька область
8184,231001,1404,33,914,711,203,231001,Запорізька область
8185,231002,2125,39,1371,1064,307,231002,Запорізька область
8186,231003,2227,36,1355,1133,222,231003,Запорізька область
8187,231004,2083,27,1325,1104,221,231004,Запорізька область
8188,231005,2156,45,1440,1163,277,231005,Запорізька область
8189,231006,2135,20,1372,1151,221,231006,Запорізька область
8190,231007,43,0,42,34,8,231007,Запорізька область
8191,231008,34,0,31,26,5,231008,Запорізька область
8192,231009,32,1,31,23,8,231009,Запорізька область
8193,231010,102,3,99,84,15,231010,Запорізька область
8194,231011,141,1,124,109,15,231011,Запорізька область
8195,231012,230,13,190,149,41,231012,Запорізька область
8196,231013,57,0,52,42,10,231013,Запорізька область
8197,231014,76,1,70,60,10,231014,Запорізька область
8198,231015,2060,32,1390,1197,193,231015,Запорізька область
8199,231016,2244,26,1547,1312,235,231016,Запорізька область
8200,231017,2096,31,1406,1198,208,231017,Запорізька область
8201,231018,2383,30,1587,1361,226,231018,Запорізька область
8202,231019,2070,32,1371,1177,194,231019,Запорізька область
8203,231020,2014,35,1364,1182,182,231020,Запорізька область
8204,231021,1875,27,1296,1096,200,231021,Запорізька область
8205,231022,1895,26,1266,1090,176,231022,Запорізька область
8206,231023,1937,25,1288,1095,193,231023,Запорізька область
8207,231024,2153,38,1425,1218,207,231024,Запорізька область
8208,231025,2035,35,1371,1149,222,231025,Запорізька область
8209,231026,1881,16,1289,1093,196,231026,Запорізька область
8210,231027,2064,27,1410,1177,233,231027,Запорізька область
8211,231028,1758,21,1154,977,177,231028,Запорізька область
8212,231029,1934,42,1277,1112,165,231029,Запорізька область
8213,231030,2059,30,1412,1210,202,231030,Запорізька область
8214,231031,2060,34,1365,1156,209,231031,Запорізька область
8215,231032,1788,33,1195,1020,175,231032,Запорізька область
8216,231033,1559,29,1062,907,155,231033,Запорізька область
8217,231034,1994,44,1346,1144,202,231034,Запорізька область
8218,231035,1513,21,1041,886,155,231035,Запорізька область
8219,231036,1563,26,1092,907,185,231036,Запорізька область
8220,231037,1609,30,1104,938,166,231037,Запорізька область
8221,231038,1782,30,1171,986,185,231038,Запорізька область
8222,231039,1947,24,1295,1090,205,231039,Запорізька область
8223,231040,1782,29,1192,1013,179,231040,Запорізька область
8224,231041,1961,33,1299,1095,204,231041,Запорізька область
8225,231042,1942,29,1302,1112,190,231042,Запорізька область
8226,231043,2136,38,1451,1254,197,231043,Запорізька область
8227,231044,1992,22,1359,1129,230,231044,Запорізька область
8228,231045,2063,32,1422,1199,223,231045,Запорізька область
8229,231046,1896,30,1269,1117,152,231046,Запорізька область
8230,231047,1396,22,916,771,145,231047,Запорізька область
8231,231048,1840,29,1275,1074,201,231048,Запорізька область
8232,231049,1926,27,1302,1124,178,231049,Запорізька область
8233,231050,1908,40,1265,1068,197,231050,Запорізька область
8234,231051,2360,32,1476,1272,204,231051,Запорізька область
8235,231052,1873,24,1238,1096,142,231052,Запорізька область
8236,231053,2020,29,1340,1095,245,231053,Запорізька область
8237,231054,2046,37,1351,1167,184,231054,Запорізька область
8238,231055,1408,24,945,819,126,231055,Запорізька область
8239,231056,2052,25,1272,1126,146,231056,Запорізька область
8240,231057,1977,37,1359,1151,208,231057,Запорізька область
8241,231058,1807,27,1232,1012,220,231058,Запорізька область
8242,231059,2003,29,1376,1155,221,231059,Запорізька область
8243,231060,39,1,38,35,3,231060,Запорізька область
8244,230809,2227,26,1406,1192,214,230809,Запорізька область
8245,230810,2161,34,1388,1140,248,230810,Запорізька область
8246,230812,2066,41,1359,1115,244,230812,Запорізька область
8247,230813,2212,34,1378,1166,212,230813,Запорізька область
8248,230815,2215,28,1405,1194,211,230815,Запорізька область
8249,230816,2180,23,1360,1118,242,230816,Запорізька область
8250,230817,2345,32,1537,1333,204,230817,Запорізька область
8251,230818,2102,32,1435,1178,257,230818,Запорізька область
8252,230819,2098,44,1431,1177,254,230819,Запорізька область
8253,231061,1943,22,1177,1011,166,231061,Запорізька область
8254,231062,2062,35,1230,1074,156,231062,Запорізька область
8255,231063,1773,28,1076,915,161,231063,Запорізька область
8256,231064,2278,17,1463,1281,182,231064,Запорізька область
8257,231065,2321,28,1520,1327,193,231065,Запорізька область
8258,231066,1803,147,1057,1040,17,231066,Запорізька область
8259,231067,1626,10,1051,936,115,231067,Запорізька область
8260,231068,1698,15,1071,924,147,231068,Запорізька область
8261,231069,2396,45,1466,1297,169,231069,Запорізька область
8262,231070,2378,25,1495,1354,141,231070,Запорізька область
8263,231071,1169,11,738,632,106,231071,Запорізька область
8264,231072,2142,32,1417,1230,187,231072,Запорізька область
8265,231073,2300,26,1412,1169,243,231073,Запорізька область
8266,231074,1630,28,1022,862,160,231074,Запорізька область
8267,231075,1809,18,1133,988,145,231075,Запорізька область
8268,231076,1975,26,1254,1074,180,231076,Запорізька область
8269,231077,1700,25,1137,980,157,231077,Запорізька область
8270,231078,1988,26,1265,1076,189,231078,Запорізька область
8271,231079,2068,26,1508,1304,204,231079,Запорізька область
8272,231080,2035,35,1338,1156,182,231080,Запорізька область
8273,231081,1861,29,1259,1068,191,231081,Запорізька область
8274,231082,1918,17,1330,1138,192,231082,Запорізька область
8275,231083,1952,36,1312,1135,177,231083,Запорізька область
8276,231084,2257,26,1454,1307,147,231084,Запорізька область
8277,231085,2017,25,1389,1197,192,231085,Запорізька область
8278,231086,1996,19,1342,1134,208,231086,Запорізька область
8279,231087,1823,23,1229,1060,169,231087,Запорізька область
8280,231088,1995,27,1335,1157,178,231088,Запорізька область
8281,231089,2110,35,1487,1290,197,231089,Запорізька область
8282,231090,1928,24,1316,1138,178,231090,Запорізька область
8283,231091,1976,40,1328,1123,205,231091,Запорізька область
8284,231092,2000,22,1401,1179,222,231092,Запорізька область
8285,231093,1796,19,1230,1053,177,231093,Запорізька область
8286,231094,2095,14,1452,1240,212,231094,Запорізька область
8287,231095,2039,25,1432,1207,225,231095,Запорізька область
8288,231096,2003,41,1338,1168,170,231096,Запорізька область
8289,231097,1978,28,1328,1156,172,231097,Запорізька область
8290,231098,1968,25,1370,1188,182,231098,Запорізька область
8291,231099,1988,29,1360,1172,188,231099,Запорізька область
8292,231100,1924,21,1324,1158,166,231100,Запорізька область
8293,231101,1942,42,1362,1170,192,231101,Запорізька область
8294,231102,1906,30,1413,1215,198,231102,Запорізька область
8295,231103,1304,19,760,702,58,231103,Запорізька область
8296,231104,1745,18,984,924,60,231104,Запорізька область
8297,231105,2001,22,1251,1106,145,231105,Запорізька область
8298,231106,2010,24,1244,1110,134,231106,Запорізька область
8299,231107,1995,22,1260,1072,188,231107,Запорізька область
8300,231108,1565,26,1000,856,144,231108,Запорізька область
8301,231109,1716,19,1065,942,123,231109,Запорізька область
8302,231110,1544,18,1036,933,103,231110,Запорізька область
8303,231111,1778,22,1182,1056,126,231111,Запорізька область
8304,231112,2147,25,1364,1225,139,231112,Запорізька область
8305,231113,1856,22,1150,1059,91,231113,Запорізька область
8306,231114,2281,21,1382,1207,175,231114,Запорізька область
8307,231115,2357,52,1476,1351,125,231115,Запорізька область
8308,231116,1917,10,1211,1104,107,231116,Запорізька область
8309,231117,2258,27,1361,1233,128,231117,Запорізька область
8310,231118,2356,35,1503,1357,146,231118,Запорізька область
8311,231119,1836,26,1134,1002,132,231119,Запорізька область
8312,231120,261,8,142,128,14,231120,Запорізька область
8313,231121,51,1,50,43,7,231121,Запорізька область
8314,231122,69,2,67,61,6,231122,Запорізька область
8315,231123,16,0,16,13,3,231123,Запорізька область
8316,231124,26,0,26,24,2,231124,Запорізька область
8317,1,286,5,275,237,38,1,Запорізька область
8318,230001,1303,10,756,701,55,230001,Запорізька область
8319,230002,1034,5,605,576,29,230002,Запорізька область
8320,230003,771,5,439,415,24,230003,Запорізька область
8321,230005,442,2,254,231,23,230005,Запорізька область
8322,230006,984,12,603,568,35,230006,Запорізька область
8323,230007,961,9,554,519,35,230007,Запорізька область
8324,230008,197,1,117,107,10,230008,Запорізька область
8325,230009,632,4,439,408,31,230009,Запорізька область
8326,230010,404,6,270,256,14,230010,Запорізька область
8327,230011,559,7,365,326,39,230011,Запорізька область
8328,230012,1775,13,1028,986,42,230012,Запорізька область
8329,230013,117,4,64,57,7,230013,Запорізька область
8330,230014,453,3,249,232,17,230014,Запорізька область
8331,230015,399,1,256,239,17,230015,Запорізька область
8332,230016,738,4,423,379,44,230016,Запорізька область
8333,230018,2138,18,1209,1109,100,230018,Запорізька область
8334,230019,1073,4,598,551,47,230019,Запорізька область
8335,230020,1543,7,862,778,84,230020,Запорізька область
8336,230021,842,4,459,409,50,230021,Запорізька область
8337,230022,786,8,474,432,42,230022,Запорізька область
8338,230023,1523,13,889,814,75,230023,Запорізька область
8339,230024,1313,13,702,632,70,230024,Запорізька область
8340,230025,489,4,322,293,29,230025,Запорізька область
8341,230026,825,6,515,487,28,230026,Запорізька область
8342,230027,345,2,222,207,15,230027,Запорізька область
8343,230266,1921,17,1190,1000,190,230266,Запорізька область
8344,230267,1483,20,896,778,118,230267,Запорізька область
8345,230268,1244,17,716,594,122,230268,Запорізька область
8346,230269,1306,5,860,737,123,230269,Запорізька область
8347,230270,515,8,347,307,40,230270,Запорізька область
8348,230271,1750,11,1019,904,115,230271,Запорізька область
8349,230272,977,6,625,560,65,230272,Запорізька область
8350,230273,241,2,185,173,12,230273,Запорізька область
8351,230274,1117,15,708,637,71,230274,Запорізька область
8352,230275,395,0,331,289,42,230275,Запорізька область
8353,230276,723,1,419,385,34,230276,Запорізька область
8354,230277,263,2,158,140,18,230277,Запорізька область
8355,230278,367,4,247,227,20,230278,Запорізька область
8356,230279,453,3,305,265,40,230279,Запорізька область
8357,230280,744,10,452,376,76,230280,Запорізька область
8358,230281,232,0,136,127,9,230281,Запорізька область
8359,230282,419,5,264,228,36,230282,Запорізька область
8360,230283,200,2,121,95,26,230283,Запорізька область
8361,230284,811,14,470,401,69,230284,Запорізька область
8362,230285,871,14,568,508,60,230285,Запорізька область
8363,230286,380,1,268,217,51,230286,Запорізька область
8364,230287,421,1,275,236,39,230287,Запорізька область
8365,230288,809,6,483,421,62,230288,Запорізька область
8366,230524,1744,17,969,890,79,230524,Запорізька область
8367,230525,1661,14,915,836,79,230525,Запорізька область
8368,230526,393,4,233,220,13,230526,Запорізька область
8369,230527,373,4,217,201,16,230527,Запорізька область
8370,230528,278,2,186,159,27,230528,Запорізька область
8371,230529,432,2,311,262,49,230529,Запорізька область
8372,230530,337,3,201,179,22,230530,Запорізька область
8373,230531,266,1,183,173,10,230531,Запорізька область
8374,230532,266,1,185,181,4,230532,Запорізька область
8375,230533,559,6,319,258,61,230533,Запорізька область
8376,230534,660,0,366,325,41,230534,Запорізька область
8377,230535,517,4,282,262,20,230535,Запорізька область
8378,230573,1748,21,1040,947,93,230573,Запорізька область
8379,230574,1589,16,952,875,77,230574,Запорізька область
8380,230575,1064,17,627,586,41,230575,Запорізька область
8381,230576,931,5,550,512,38,230576,Запорізька область
8382,230577,376,4,247,234,13,230577,Запорізька область
8383,230578,209,0,134,112,22,230578,Запорізька область
8384,230579,551,6,349,305,44,230579,Запорізька область
8385,230580,337,3,232,217,15,230580,Запорізька область
8386,230581,716,7,445,404,41,230581,Запорізька область
8387,230582,807,9,508,429,79,230582,Запорізька область
8388,230583,591,1,379,358,21,230583,Запорізька область
8389,230584,508,4,305,268,37,230584,Запорізька область
8390,230585,1057,15,657,627,30,230585,Запорізька область
8391,230586,200,0,158,135,23,230586,Запорізька область
8392,230587,459,3,296,246,50,230587,Запорізька область
8393,230588,303,4,191,169,22,230588,Запорізька область
8394,230589,595,3,385,347,38,230589,Запорізька область
8395,230590,616,3,376,343,33,230590,Запорізька область
8396,230591,392,2,270,250,20,230591,Запорізька область
8397,230592,449,2,296,258,38,230592,Запорізька область
8398,230593,231,0,167,155,12,230593,Запорізька область
8399,230594,340,1,196,174,22,230594,Запорізька область
8400,230595,360,4,211,187,24,230595,Запорізька область
8401,230636,2219,33,1435,1328,107,230636,Запорізька область
8402,230637,2327,34,1464,1324,140,230637,Запорізька область
8403,230638,2106,36,1297,1182,115,230638,Запорізька область
8404,230639,2098,37,1293,1186,107,230639,Запорізька область
8405,230640,2277,25,1423,1286,137,230640,Запорізька область
8406,230641,1271,15,752,679,73,230641,Запорізька область
8407,230642,1488,17,893,812,81,230642,Запорізька область
8408,230643,2214,24,1379,1242,137,230643,Запорізька область
8409,230644,2122,18,1392,1241,151,230644,Запорізька область
8410,230645,1760,16,1065,953,112,230645,Запорізька область
8411,230646,2023,20,1211,1091,120,230646,Запорізька область
8412,230647,2125,34,1368,1223,145,230647,Запорізька область
8413,230648,1815,18,1128,991,137,230648,Запорізька область
8414,230649,2115,30,1341,1176,165,230649,Запорізька область
8415,230650,2073,24,1269,1147,122,230650,Запорізька область
8416,230651,1895,25,1227,1064,163,230651,Запорізька область
8417,230652,2024,28,1340,1190,150,230652,Запорізька область
8418,230653,1916,30,1177,1038,139,230653,Запорізька область
8419,230654,1955,29,1216,1048,168,230654,Запорізька область
8420,230655,1879,26,1109,1003,106,230655,Запорізька область
8421,230656,2094,32,1402,1240,162,230656,Запорізька область
8422,230657,1820,18,1179,1059,120,230657,Запорізька область
8423,230658,2068,22,1352,1245,107,230658,Запорізька область
8424,230659,1600,13,963,883,80,230659,Запорізька область
8425,230660,1854,28,1116,1030,86,230660,Запорізька область
8426,230661,1503,13,875,789,86,230661,Запорізька область
8427,230662,2117,20,1346,1199,147,230662,Запорізька область
8428,230663,2251,30,1395,1264,131,230663,Запорізька область
8429,230664,1449,16,844,747,97,230664,Запорізька область
8430,230665,1258,13,804,735,69,230665,Запорізька область
8431,230666,1547,21,986,860,126,230666,Запорізька область
8432,230667,2019,21,1328,1181,147,230667,Запорізька область
8433,230668,2055,38,1287,1127,160,230668,Запорізька область
8434,230669,2099,26,1369,1203,166,230669,Запорізька область
8435,230670,1020,21,625,543,82,230670,Запорізька область
8436,230671,2166,30,1357,1192,165,230671,Запорізька область
8437,230672,1931,33,1218,1060,158,230672,Запорізька область
8438,230673,926,16,524,452,72,230673,Запорізька область
8439,230674,829,18,541,467,74,230674,Запорізька область
8440,230675,1115,13,647,570,77,230675,Запорізька область
8441,230676,738,6,488,415,73,230676,Запорізька область
8442,230677,729,9,462,421,41,230677,Запорізька область
8443,230678,1310,21,780,704,76,230678,Запорізька область
8444,230679,1604,25,1007,916,91,230679,Запорізька область
8445,230680,1194,12,776,716,60,230680,Запорізька область
8446,230681,417,3,252,224,28,230681,Запорізька область
8447,230682,1013,8,567,517,50,230682,Запорізька область
8448,230683,1055,7,671,610,61,230683,Запорізька область
8449,230684,1821,15,1177,1055,122,230684,Запорізька область
8450,230685,1774,17,1057,981,76,230685,Запорізька область
8451,230686,2026,10,1090,1017,73,230686,Запорізька область
8452,230687,540,3,312,299,13,230687,Запорізька область
8453,230688,53,1,51,45,6,230688,Запорізька область
8454,230689,40,1,37,34,3,230689,Запорізька область
8455,230690,82,0,81,75,6,230690,Запорізька область
8456,230691,362,4,328,262,66,230691,Запорізька область
8457,230028,1955,28,1325,1191,134,230028,Запорізька область
8458,230029,1371,15,887,774,113,230029,Запорізька область
8459,230030,1683,12,1117,971,146,230030,Запорізька область
8460,230031,1501,17,958,861,97,230031,Запорізька область
8461,230032,1111,7,655,609,46,230032,Запорізька область
8462,230033,1338,12,769,703,66,230033,Запорізька область
8463,230034,1865,12,1113,1032,81,230034,Запорізька область
8464,230035,1440,21,929,873,56,230035,Запорізька область
8465,230036,1731,25,1056,988,68,230036,Запорізька область
8466,230037,1985,32,1255,1157,98,230037,Запорізька область
8467,230038,1364,21,809,752,57,230038,Запорізька область
8468,230039,1337,22,802,750,52,230039,Запорізька область
8469,230040,1157,4,762,692,70,230040,Запорізька область
8470,230041,1673,30,1071,966,105,230041,Запорізька область
8471,230042,1601,14,1003,920,83,230042,Запорізька область
8472,230043,1986,29,1306,1184,122,230043,Запорізька область
8473,230044,628,4,410,364,46,230044,Запорізька область
8474,230045,972,8,532,500,32,230045,Запорізька область
8475,230046,1594,22,826,757,69,230046,Запорізька область
8476,230047,1432,11,768,699,69,230047,Запорізька область
8477,230048,1228,19,705,656,49,230048,Запорізька область
8478,230049,1368,13,758,701,57,230049,Запорізька область
8479,230050,955,9,606,571,35,230050,Запорізька область
8480,230051,723,8,454,427,27,230051,Запорізька область
8481,230052,1163,9,694,615,79,230052,Запорізька область
8482,230053,1708,11,919,853,66,230053,Запорізька область
8483,230055,233,0,143,126,17,230055,Запорізька область
8484,230056,437,4,278,268,10,230056,Запорізька область
8485,230057,978,5,603,549,54,230057,Запорізька область
8486,230058,876,8,572,528,44,230058,Запорізька область
8487,230059,1074,5,714,665,49,230059,Запорізька область
8488,230060,1041,14,636,562,74,230060,Запорізька область
8489,230062,1309,20,760,693,67,230062,Запорізька область
8490,230063,842,7,506,475,31,230063,Запорізька область
8491,230064,376,1,237,216,21,230064,Запорізька область
8492,230065,457,3,305,288,17,230065,Запорізька область
8493,230066,601,8,374,333,41,230066,Запорізька область
8494,230067,1443,13,850,788,62,230067,Запорізька область
8495,230068,704,3,366,334,32,230068,Запорізька область
8496,230069,707,3,424,401,23,230069,Запорізька область
8497,230070,171,4,113,92,21,230070,Запорізька область
8498,230071,325,3,197,164,33,230071,Запорізька область
8499,230072,307,0,202,189,13,230072,Запорізька область
8500,230073,833,8,518,486,32,230073,Запорізька область
8501,230074,650,6,402,378,24,230074,Запорізька область
8502,230075,402,4,275,243,32,230075,Запорізька область
8503,230076,545,8,285,262,23,230076,Запорізька область
8504,230077,630,8,381,342,39,230077,Запорізька область
8505,230078,375,2,197,173,24,230078,Запорізька область
8506,230079,11,0,11,6,5,230079,Запорізька область
8507,230080,15,0,15,14,1,230080,Запорізька область
8508,230081,682,4,425,392,33,230081,Запорізька область
8509,230082,1235,19,711,630,81,230082,Запорізька область
8510,230083,549,5,367,342,25,230083,Запорізька область
8511,230084,449,5,298,266,32,230084,Запорізька область
8512,230085,1000,10,595,547,48,230085,Запорізька область
8513,230086,628,6,406,376,30,230086,Запорізька область
8514,230087,464,2,322,309,13,230087,Запорізька область
8515,230088,122,1,78,72,6,230088,Запорізька область
8516,230089,825,2,515,492,23,230089,Запорізька область
8517,230234,1585,12,947,889,58,230234,Запорізька область
8518,230235,1369,20,814,762,52,230235,Запорізька область
8519,230236,1891,25,1129,1057,72,230236,Запорізька область
8520,230237,1271,13,775,723,52,230237,Запорізька область
8521,230238,874,2,559,519,40,230238,Запорізька область
8522,230239,1237,10,701,670,31,230239,Запорізька область
8523,230240,1557,5,998,946,52,230240,Запорізька область
8524,230241,528,3,290,265,25,230241,Запорізька область
8525,230242,400,3,177,159,18,230242,Запорізька область
8526,230243,1039,12,576,541,35,230243,Запорізька область
8527,230244,849,4,446,416,30,230244,Запорізька область
8528,230245,1058,6,528,506,22,230245,Запорізька область
8529,230246,922,9,461,440,21,230246,Запорізька область
8530,230247,873,4,449,435,14,230247,Запорізька область
8531,230248,682,4,366,358,8,230248,Запорізька область
8532,230249,633,7,329,320,9,230249,Запорізька область
8533,230250,548,4,247,238,9,230250,Запорізька область
8534,230251,878,5,447,431,16,230251,Запорізька область
8535,230252,1547,20,1001,968,33,230252,Запорізька область
8536,230253,1225,17,713,677,36,230253,Запорізька область
8537,230254,1252,14,774,746,28,230254,Запорізька область
8538,230255,984,1,586,564,22,230255,Запорізька область
8539,230256,725,7,504,485,19,230256,Запорізька область
8540,230257,883,4,538,520,18,230257,Запорізька область
8541,230258,933,7,591,562,29,230258,Запорізька область
8542,230259,1677,14,1048,974,74,230259,Запорізька область
8543,230260,1093,10,901,825,76,230260,Запорізька область
8544,230261,326,4,209,187,22,230261,Запорізька область
8545,230262,1104,8,798,765,33,230262,Запорізька область
8546,230263,204,2,133,127,6,230263,Запорізька область
8547,230264,102,1,69,68,1,230264,Запорізька область
8548,230265,16,0,16,15,1,230265,Запорізька область
8549,230376,2180,30,1368,1196,172,230376,Запорізька область
8550,230377,1786,25,1065,993,72,230377,Запорізька область
8551,230378,1678,26,1042,893,149,230378,Запорізька область
8552,230379,851,5,501,455,46,230379,Запорізька область
8553,230380,1428,13,792,734,58,230380,Запорізька область
8554,230381,1498,20,907,829,78,230381,Запорізька область
8555,230382,1912,21,1161,1063,98,230382,Запорізька область
8556,230383,1435,9,810,745,65,230383,Запорізька область
8557,230384,1978,34,1166,1049,117,230384,Запорізька область
8558,230385,2198,20,1280,1148,132,230385,Запорізька область
8559,230386,379,4,197,172,25,230386,Запорізька область
8560,230388,1360,10,852,748,104,230388,Запорізька область
8561,230389,699,3,414,380,34,230389,Запорізька область
8562,230390,1627,12,895,815,80,230390,Запорізька область
8563,230391,347,8,205,185,20,230391,Запорізька область
8564,230392,1917,27,1081,960,121,230392,Запорізька область
8565,230394,656,2,383,354,29,230394,Запорізька область
8566,230395,1044,11,611,562,49,230395,Запорізька область
8567,230396,472,7,306,290,16,230396,Запорізька область
8568,230397,663,5,385,362,23,230397,Запорізька область
8569,230398,564,0,358,307,51,230398,Запорізька область
8570,230399,434,5,253,235,18,230399,Запорізька область
8571,230401,991,11,601,560,41,230401,Запорізька область
8572,230402,330,2,209,199,10,230402,Запорізька область
8573,230403,321,1,203,183,20,230403,Запорізька область
8574,230404,276,2,172,155,17,230404,Запорізька область
8575,230405,382,5,233,205,28,230405,Запорізька область
8576,230406,324,1,227,213,14,230406,Запорізька область
8577,230408,931,7,562,497,65,230408,Запорізька область
8578,230409,1825,20,1085,990,95,230409,Запорізька область
8579,230410,527,6,288,246,42,230410,Запорізька область
8580,230411,1050,10,560,513,47,230411,Запорізька область
8581,230412,392,5,244,210,34,230412,Запорізька область
8582,230413,25,0,24,20,4,230413,Запорізька область
8583,230414,463,28,423,406,17,230414,Запорізька область
8584,230692,1845,21,1126,1011,115,230692,Запорізька область
8585,230693,2359,33,1504,1315,189,230693,Запорізька область
8586,230694,1738,22,1238,1055,183,230694,Запорізька область
8587,230695,1730,12,1240,1080,160,230695,Запорізька область
8588,230696,2125,33,1355,1189,166,230696,Запорізька область
8589,230697,1845,21,1263,1109,154,230697,Запорізька область
8590,230698,1643,18,1081,974,107,230698,Запорізька область
8591,230699,1749,15,1209,1027,182,230699,Запорізька область
8592,230700,1928,12,1327,1145,182,230700,Запорізька область
8593,230701,1674,24,1096,956,140,230701,Запорізька область
8594,230702,1797,40,1200,1014,186,230702,Запорізька область
8595,230703,2089,33,1415,1239,176,230703,Запорізька область
8596,230704,1746,22,1186,1025,161,230704,Запорізька область
8597,230705,2021,26,1387,1220,167,230705,Запорізька область
8598,230706,2281,28,1556,1363,193,230706,Запорізька область
8599,230707,2106,25,1423,1252,171,230707,Запорізька область
8600,230708,2317,31,1553,1358,195,230708,Запорізька область
8601,230709,2199,24,1452,1254,198,230709,Запорізька область
8602,230710,2355,31,1572,1380,192,230710,Запорізька область
8603,230711,2315,31,1542,1388,154,230711,Запорізька область
8604,230712,2334,26,1598,1441,157,230712,Запорізька область
8605,230713,92,1,88,82,6,230713,Запорізька область
8606,230289,852,7,547,516,31,230289,Запорізька область
8607,230290,869,2,504,486,18,230290,Запорізька область
8608,230291,219,0,145,138,7,230291,Запорізька область
8609,230292,2234,23,1319,1265,54,230292,Запорізька область
8610,230293,1800,8,1190,1135,55,230293,Запорізька область
8611,230294,1731,19,1083,1033,50,230294,Запорізька область
8612,230295,1759,18,1091,1020,71,230295,Запорізька область
8613,230296,1906,19,1201,1121,80,230296,Запорізька область
8614,230297,1709,19,1070,1012,58,230297,Запорізька область
8615,230298,2219,13,1345,1274,71,230298,Запорізька область
8616,230299,717,10,473,454,19,230299,Запорізька область
8617,230300,959,3,574,548,26,230300,Запорізька область
8618,230301,606,3,380,349,31,230301,Запорізька область
8619,230302,1018,14,659,610,49,230302,Запорізька область
8620,230303,562,6,332,310,22,230303,Запорізька область
8621,230304,484,5,330,302,28,230304,Запорізька область
8622,230305,1414,14,778,710,68,230305,Запорізька область
8623,230306,1058,8,614,566,48,230306,Запорізька область
8624,230307,489,4,313,271,42,230307,Запорізька область
8625,230308,236,1,162,144,18,230308,Запорізька область
8626,230309,1378,2,856,791,65,230309,Запорізька область
8627,230310,504,5,301,291,10,230310,Запорізька область
8628,230311,703,6,434,407,27,230311,Запорізька область
8629,230312,234,1,140,131,9,230312,Запорізька область
8630,230313,572,4,331,299,32,230313,Запорізька область
8631,230314,384,4,198,166,32,230314,Запорізька область
8632,230315,616,5,357,322,35,230315,Запорізька область
8633,230316,459,6,262,247,15,230316,Запорізька область
8634,230317,858,2,508,458,50,230317,Запорізька область
8635,230318,717,6,464,323,141,230318,Запорізька область
8636,230319,1151,9,784,735,49,230319,Запорізька область
8637,230320,516,6,337,313,24,230320,Запорізька область
8638,230321,382,0,244,231,13,230321,Запорізька область
8639,230322,1637,14,879,814,65,230322,Запорізька область
8640,230323,1579,12,967,902,65,230323,Запорізька область
8641,230324,351,2,205,167,38,230324,Запорізька область
8642,230325,539,3,325,293,32,230325,Запорізька область
8643,230326,181,1,113,108,5,230326,Запорізька область
8644,230327,163,2,110,98,12,230327,Запорізька область
8645,230328,899,10,570,534,36,230328,Запорізька область
8646,230329,798,4,454,434,20,230329,Запорізька область
8647,230330,1616,17,1011,942,69,230330,Запорізька область
8648,230331,18,0,18,11,7,230331,Запорізька область
8649,230714,2048,15,1240,1107,133,230714,Запорізька область
8650,230715,2075,17,1255,1131,124,230715,Запорізька область
8651,230716,1566,24,956,852,104,230716,Запорізька область
8652,230717,2316,12,1384,1247,137,230717,Запорізька область
8653,230718,2276,13,1377,1276,101,230718,Запорізька область
8654,230719,2314,20,1437,1310,127,230719,Запорізька область
8655,230720,2237,27,1416,1233,183,230720,Запорізька область
8656,230721,1406,20,869,802,67,230721,Запорізька область
8657,230722,1836,18,1028,906,122,230722,Запорізька область
8658,230723,2138,31,1277,1125,152,230723,Запорізька область
8659,230724,1542,17,933,846,87,230724,Запорізька область
8660,230725,578,2,354,315,39,230725,Запорізька область
8661,230726,1824,19,1086,968,118,230726,Запорізька область
8662,230727,2093,16,1234,1120,114,230727,Запорізька область
8663,230728,2156,22,1247,1118,129,230728,Запорізька область
8664,230729,1552,14,822,748,74,230729,Запорізька область
8665,230730,1027,9,619,556,63,230730,Запорізька область
8666,230731,1568,12,1026,931,95,230731,Запорізька область
8667,230732,2127,28,1300,1179,121,230732,Запорізька область
8668,230733,2051,27,1353,1210,143,230733,Запорізька область
8669,230734,793,7,525,463,62,230734,Запорізька область
8670,230735,2010,28,1311,1181,130,230735,Запорізька область
8671,230736,1761,19,1170,1010,160,230736,Запорізька область
8672,230737,1730,34,1131,974,157,230737,Запорізька область
8673,230738,1979,36,1262,1135,127,230738,Запорізька область
8674,230739,738,9,470,405,65,230739,Запорізька область
8675,230740,2068,24,1236,1115,121,230740,Запорізька область
8676,230741,1688,19,946,852,94,230741,Запорізька область
8677,230742,2104,28,1436,1259,177,230742,Запорізька область
8678,230743,1788,17,937,862,75,230743,Запорізька область
8679,230744,2105,17,1302,1151,151,230744,Запорізька область
8680,230745,2020,20,1171,1058,113,230745,Запорізька область
8681,230746,1746,19,1085,987,98,230746,Запорізька область
8682,230747,2054,25,1381,1262,119,230747,Запорізька область
8683,230748,2008,21,1255,1143,112,230748,Запорізька область
8684,230749,2236,17,1467,1310,157,230749,Запорізька область
8685,230750,2040,25,1345,1209,136,230750,Запорізька область
8686,230751,1994,23,1337,1210,127,230751,Запорізька область
8687,230752,2186,25,1455,1314,141,230752,Запорізька область
8688,230753,1991,23,1201,1052,149,230753,Запорізька область
8689,230754,2148,30,1354,1211,143,230754,Запорізька область
8690,230755,2304,20,1394,1270,124,230755,Запорізька область
8691,230756,2183,24,1385,1244,141,230756,Запорізька область
8692,230757,2206,21,1342,1219,123,230757,Запорізька область
8693,230758,2239,23,1445,1322,123,230758,Запорізька область
8694,230759,1197,11,774,708,66,230759,Запорізька область
8695,230760,1911,18,1178,1108,70,230760,Запорізька область
8696,230761,2183,24,1225,1096,129,230761,Запорізька область
8697,230762,1987,19,1057,952,105,230762,Запорізька область
8698,230763,2005,17,1129,1019,110,230763,Запорізька область
8699,230764,1625,14,985,900,85,230764,Запорізька область
8700,230765,1815,29,1131,937,194,230765,Запорізька область
8701,230766,2095,22,1300,1105,195,230766,Запорізька область
8702,230767,2214,16,1211,1100,111,230767,Запорізька область
8703,230768,1450,19,817,744,73,230768,Запорізька область
8704,230769,1516,14,916,854,62,230769,Запорізька область
8705,230770,2081,19,1283,1191,92,230770,Запорізька область
8706,230771,1585,20,993,908,85,230771,Запорізька область
8707,230772,1910,22,1207,1106,101,230772,Запорізька область
8708,230773,2002,13,1299,1205,94,230773,Запорізька область
8709,230774,2268,33,1429,1319,110,230774,Запорізька область
8710,230775,9,0,8,8,0,230775,Запорізька область
8711,230776,9,1,7,7,0,230776,Запорізька область
8712,230777,5,0,5,4,1,230777,Запорізька область
8713,230778,23,2,19,18,1,230778,Запорізька область
8714,230779,12,0,12,11,1,230779,Запорізька область
8715,230780,9,0,9,8,1,230780,Запорізька область
8716,230781,73,0,73,66,7,230781,Запорізька область
8717,231130,1386,25,890,813,77,231130,Запорізька область
8718,230090,1520,27,867,794,73,230090,Запорізька область
8719,230091,1344,8,763,705,58,230091,Запорізька область
8720,230092,1679,19,939,882,57,230092,Запорізька область
8721,230093,1969,19,1112,1021,91,230093,Запорізька область
8722,230094,774,11,452,424,28,230094,Запорізька область
8723,230095,1292,13,720,681,39,230095,Запорізька область
8724,230096,442,4,263,255,8,230096,Запорізька область
8725,230097,233,0,112,100,12,230097,Запорізька область
8726,230098,103,0,63,53,10,230098,Запорізька область
8727,230099,421,0,246,227,19,230099,Запорізька область
8728,230100,205,0,129,107,22,230100,Запорізька область
8729,230101,325,1,170,159,11,230101,Запорізька область
8730,230102,530,2,349,324,25,230102,Запорізька область
8731,230103,383,2,239,205,34,230103,Запорізька область
8732,230104,545,2,283,256,27,230104,Запорізька область
8733,230105,538,5,302,271,31,230105,Запорізька область
8734,230106,578,3,378,360,18,230106,Запорізька область
8735,230107,524,4,329,279,50,230107,Запорізька область
8736,230108,443,1,250,228,22,230108,Запорізька область
8737,230109,345,1,207,171,36,230109,Запорізька область
8738,230110,620,8,373,327,46,230110,Запорізька область
8739,230111,319,1,205,181,24,230111,Запорізька область
8740,230112,442,5,283,258,25,230112,Запорізька область
8741,230113,377,3,245,230,15,230113,Запорізька область
8742,230114,735,4,435,387,48,230114,Запорізька область
8743,230115,698,9,394,347,47,230115,Запорізька область
8744,230332,1492,16,950,836,114,230332,Запорізька область
8745,230333,866,7,547,480,67,230333,Запорізька область
8746,230334,1372,8,780,704,76,230334,Запорізька область
8747,230335,1422,11,910,862,48,230335,Запорізька область
8748,230336,1412,19,848,787,61,230336,Запорізька область
8749,230337,669,5,396,374,22,230337,Запорізька область
8750,230338,1512,16,859,799,60,230338,Запорізька область
8751,230339,1006,9,554,519,35,230339,Запорізька область
8752,230340,182,3,135,117,18,230340,Запорізька область
8753,230341,1036,8,595,558,37,230341,Запорізька область
8754,230342,767,8,449,413,36,230342,Запорізька область
8755,230343,875,10,459,432,27,230343,Запорізька область
8756,230344,1160,10,757,703,54,230344,Запорізька область
8757,230345,707,5,412,382,30,230345,Запорізька область
8758,230346,326,0,236,212,24,230346,Запорізька область
8759,230347,1217,16,799,741,58,230347,Запорізька область
8760,230348,410,3,267,260,7,230348,Запорізька область
8761,230349,205,0,131,122,9,230349,Запорізька область
8762,230350,1414,10,858,826,32,230350,Запорізька область
8763,230351,320,13,239,185,54,230351,Запорізька область
8764,230352,225,1,123,116,7,230352,Запорізька область
8765,230353,617,5,444,408,36,230353,Запорізька область
8766,230354,169,1,115,103,12,230354,Запорізька область
8767,230355,176,0,134,123,11,230355,Запорізька область
8768,230356,555,4,388,380,8,230356,Запорізька область
8769,230357,937,6,599,589,10,230357,Запорізька область
8770,230358,1023,3,603,581,22,230358,Запорізька область
8771,230451,2231,25,1370,1277,93,230451,Запорізька область
8772,230452,1603,18,966,906,60,230452,Запорізька область
8773,230453,604,7,319,285,34,230453,Запорізька область
8774,230454,1109,7,686,648,38,230454,Запорізька область
8775,230455,526,1,297,290,7,230455,Запорізька область
8776,230456,147,0,110,107,3,230456,Запорізька область
8777,230457,1844,13,993,954,39,230457,Запорізька область
8778,230458,158,2,126,118,8,230458,Запорізька область
8779,230459,53,0,45,41,4,230459,Запорізька область
8780,230460,276,1,180,177,3,230460,Запорізька область
8781,230461,240,0,146,126,20,230461,Запорізька область
8782,230462,602,1,408,396,12,230462,Запорізька область
8783,230463,466,1,261,247,14,230463,Запорізька область
8784,230464,1056,7,741,699,42,230464,Запорізька область
8785,230465,352,0,218,205,13,230465,Запорізька область
8786,230466,422,3,269,249,20,230466,Запорізька область
8787,230467,493,3,250,227,23,230467,Запорізька область
8788,230468,110,0,77,69,8,230468,Запорізька область
8789,230469,390,1,235,224,11,230469,Запорізька область
8790,230470,214,2,138,119,19,230470,Запорізька область
8791,230471,349,0,203,191,12,230471,Запорізька область
8792,230472,296,3,206,185,21,230472,Запорізька область
8793,230473,767,6,525,493,32,230473,Запорізька область
8794,230474,471,6,341,310,31,230474,Запорізька область
8795,230475,241,2,137,122,15,230475,Запорізька область
8796,230476,405,0,268,242,26,230476,Запорізька область
8797,230477,491,2,301,273,28,230477,Запорізька область
8798,230478,224,1,148,133,15,230478,Запорізька область
8799,230479,386,2,263,250,13,230479,Запорізька область
8800,230480,532,6,330,295,35,230480,Запорізька область
8801,230481,392,2,229,198,31,230481,Запорізька область
8802,230482,176,4,107,91,16,230482,Запорізька область
8803,230483,211,1,136,120,16,230483,Запорізька область
8804,230484,656,8,438,399,39,230484,Запорізька область
8805,230485,289,1,174,158,16,230485,Запорізька область
8806,230486,572,2,314,297,17,230486,Запорізька область
8807,230487,797,9,517,492,25,230487,Запорізька область
8808,230488,201,2,136,128,8,230488,Запорізька область
8809,230489,336,3,199,183,16,230489,Запорізька область
8810,230490,646,16,391,357,34,230490,Запорізька область
8811,230491,241,6,151,145,6,230491,Запорізька область
8812,230492,2124,32,1253,1132,121,230492,Запорізька область
8813,230493,2178,23,1263,1129,134,230493,Запорізька область
8814,230494,1356,13,819,750,69,230494,Запорізька область
8815,230495,2187,23,1278,1116,162,230495,Запорізька область
8816,230497,361,3,216,183,33,230497,Запорізька область
8817,230498,410,3,242,216,26,230498,Запорізька область
8818,230499,867,8,559,513,46,230499,Запорізька область
8819,230500,1175,5,698,600,98,230500,Запорізька область
8820,230501,535,4,360,341,19,230501,Запорізька область
8821,230502,522,4,341,322,19,230502,Запорізька область
8822,230503,364,1,259,221,38,230503,Запорізька область
8823,230504,281,1,180,161,19,230504,Запорізька область
8824,230505,681,7,402,366,36,230505,Запорізька область
8825,230506,224,1,153,145,8,230506,Запорізька область
8826,230507,631,10,358,318,40,230507,Запорізька область
8827,230508,675,9,396,362,34,230508,Запорізька область
8828,230509,356,4,245,220,25,230509,Запорізька область
8829,230510,95,0,53,50,3,230510,Запорізька область
8830,230511,882,18,539,501,38,230511,Запорізька область
8831,230512,716,6,441,415,26,230512,Запорізька область
8832,230513,365,1,212,202,10,230513,Запорізька область
8833,230514,566,4,363,336,27,230514,Запорізька область
8834,230515,421,1,269,248,21,230515,Запорізька область
8835,230516,434,1,260,233,27,230516,Запорізька область
8836,230517,535,6,291,267,24,230517,Запорізька область
8837,230518,355,0,196,166,30,230518,Запорізька область
8838,230519,613,10,344,314,30,230519,Запорізька область
8839,230520,325,2,226,207,19,230520,Запорізька область
8840,230521,1489,47,910,850,60,230521,Запорізька область
8841,230522,500,0,316,300,16,230522,Запорізька область
8842,230523,50,0,47,40,7,230523,Запорізька область
8843,230536,651,5,342,320,22,230536,Запорізька область
8844,230537,1235,8,677,631,46,230537,Запорізька область
8845,230538,736,7,437,398,39,230538,Запорізька область
8846,230539,867,9,458,421,37,230539,Запорізька область
8847,230540,784,4,426,397,29,230540,Запорізька область
8848,230541,487,8,270,251,19,230541,Запорізька область
8849,230542,688,6,407,333,74,230542,Запорізька область
8850,230543,387,5,268,243,25,230543,Запорізька область
8851,230544,493,4,326,306,20,230544,Запорізька область
8852,230545,520,7,317,282,35,230545,Запорізька область
8853,230546,264,1,179,163,16,230546,Запорізька область
8854,230547,211,1,116,97,19,230547,Запорізька область
8855,230548,287,1,208,196,12,230548,Запорізька область
8856,230549,63,4,36,28,8,230549,Запорізька область
8857,230550,614,10,382,321,61,230550,Запорізька область
8858,230551,221,4,137,116,21,230551,Запорізька область
8859,230552,453,2,241,206,35,230552,Запорізька область
8860,230553,476,6,317,253,64,230553,Запорізька область
8861,230554,239,0,143,108,35,230554,Запорізька область
8862,230555,707,2,427,374,53,230555,Запорізька область
8863,230556,428,3,255,222,33,230556,Запорізька область
8864,230557,698,3,421,386,35,230557,Запорізька область
8865,230558,747,10,439,402,37,230558,Запорізька область
8866,230559,259,2,145,128,17,230559,Запорізька область
8867,230560,682,6,394,362,32,230560,Запорізька область
8868,230561,256,5,164,156,8,230561,Запорізька область
8869,230562,560,4,332,303,29,230562,Запорізька область
8870,230563,303,3,197,152,45,230563,Запорізька область
8871,230564,238,2,124,116,8,230564,Запорізька область
8872,230565,292,1,218,196,22,230565,Запорізька область
8873,230566,288,0,154,139,15,230566,Запорізька область
8874,230567,397,4,263,230,33,230567,Запорізька область
8875,230568,110,0,77,68,9,230568,Запорізька область
8876,230569,619,3,366,341,25,230569,Запорізька область
8877,230570,909,11,560,508,52,230570,Запорізька область
8878,230571,42,0,42,35,7,230571,Запорізька область
8879,230572,14,0,13,10,3,230572,Запорізька область
8880,230596,450,9,258,228,30,230596,Запорізька область
8881,230597,2275,24,1312,1177,135,230597,Запорізька область
8882,230598,2263,38,1310,1206,104,230598,Запорізька область
8883,230599,2202,22,1302,1228,74,230599,Запорізька область
8884,230600,860,8,481,455,26,230600,Запорізька область
8885,230601,1376,11,744,696,48,230601,Запорізька область
8886,230602,665,10,417,375,42,230602,Запорізька область
8887,230603,196,8,93,79,14,230603,Запорізька область
8888,230604,119,1,55,48,7,230604,Запорізька область
8889,230605,954,10,561,531,30,230605,Запорізька область
8890,230606,107,0,76,59,17,230606,Запорізька область
8891,230607,671,2,369,324,45,230607,Запорізька область
8892,230608,100,1,54,40,14,230608,Запорізька область
8893,230609,559,1,386,362,24,230609,Запорізька область
8894,230610,674,4,368,300,68,230610,Запорізька область
8895,230611,1276,13,828,734,94,230611,Запорізька область
8896,230612,1522,8,948,864,84,230612,Запорізька область
8897,230613,168,2,110,107,3,230613,Запорізька область
8898,230614,474,4,279,252,27,230614,Запорізька область
8899,230615,872,4,495,466,29,230615,Запорізька область
8900,230616,459,4,302,278,24,230616,Запорізька область
8901,230617,141,1,92,84,8,230617,Запорізька область
8902,230618,1011,8,599,527,72,230618,Запорізька область
8903,230619,478,4,258,237,21,230619,Запорізька область
8904,230620,561,6,280,259,21,230620,Запорізька область
8905,230621,105,0,84,79,5,230621,Запорізька область
8906,230622,120,3,78,69,9,230622,Запорізька область
8907,230623,1206,7,737,680,57,230623,Запорізька область
8908,230624,429,1,255,239,16,230624,Запорізька область
8909,230625,121,0,83,74,9,230625,Запорізька область
8910,230626,554,3,334,290,44,230626,Запорізька область
8911,230627,160,1,80,64,16,230627,Запорізька область
8912,230628,114,0,63,49,14,230628,Запорізька область
8913,230629,866,3,482,443,39,230629,Запорізька область
8914,230630,397,4,215,183,32,230630,Запорізька область
8915,230631,297,2,163,144,19,230631,Запорізька область
8916,230632,307,0,204,193,11,230632,Запорізька область
8917,230633,914,7,547,502,45,230633,Запорізька область
8918,230634,127,0,105,93,12,230634,Запорізька область
8919,230635,47,0,40,35,5,230635,Запорізька область
8920,230782,567,10,296,274,22,230782,Запорізька область
8921,230783,1328,15,755,719,36,230783,Запорізька область
8922,230784,1601,14,1009,928,81,230784,Запорізька область
8923,230785,1076,18,686,639,47,230785,Запорізька область
8924,230786,1091,14,668,592,76,230786,Запорізька область
8925,230787,722,11,387,346,41,230787,Запорізька область
8926,230788,964,11,610,542,68,230788,Запорізька область
8927,230789,1186,16,758,678,80,230789,Запорізька область
8928,230790,1026,11,642,582,60,230790,Запорізька область
8929,230791,1177,10,727,651,76,230791,Запорізька область
8930,230792,1550,17,971,874,97,230792,Запорізька область
8931,230793,1227,12,691,645,46,230793,Запорізька область
8932,230794,1107,9,670,571,99,230794,Запорізька область
8933,230795,878,2,511,460,51,230795,Запорізька область
8934,230796,980,9,542,492,50,230796,Запорізька область
8935,230797,960,15,522,490,32,230797,Запорізька область
8936,230798,907,11,513,468,45,230798,Запорізька область
8937,230799,1209,16,698,633,65,230799,Запорізька область
8938,230800,966,5,549,506,43,230800,Запорізька область
8939,230801,800,5,424,390,34,230801,Запорізька область
8940,230802,975,14,591,531,60,230802,Запорізька область
8941,230803,954,7,512,468,44,230803,Запорізька область
8942,230804,935,10,529,491,38,230804,Запорізька область
8943,230805,790,4,439,393,46,230805,Запорізька область
8944,230806,921,10,501,455,46,230806,Запорізька область
8945,230807,871,7,460,432,28,230807,Запорізька область
8946,230808,45,0,39,32,7,230808,Запорізька область
8947,231126,81,3,78,77,1,231126,Запорізька область
8948,1,311,24,286,278,8,1,Запорізька область
8949,230116,2039,26,1412,1292,120,230116,Запорізька область
8950,230117,1706,23,1050,960,90,230117,Запорізька область
8951,230118,2293,19,1598,1421,177,230118,Запорізька область
8952,230119,2153,25,1399,1234,165,230119,Запорізька область
8953,230120,2214,33,1427,1273,154,230120,Запорізька область
8954,230121,2162,35,1396,1303,93,230121,Запорізька область
8955,230122,1038,10,670,617,53,230122,Запорізька область
8956,230123,575,2,369,338,31,230123,Запорізька область
8957,230124,901,6,524,472,52,230124,Запорізька область
8958,230125,834,7,526,455,71,230125,Запорізька область
8959,230126,1144,13,690,636,54,230126,Запорізька область
8960,230127,625,8,409,381,28,230127,Запорізька область
8961,230128,718,8,443,418,25,230128,Запорізька область
8962,230129,720,9,384,321,63,230129,Запорізька область
8963,230130,889,9,619,565,54,230130,Запорізька область
8964,230131,1047,11,660,607,53,230131,Запорізька область
8965,230132,502,8,308,267,41,230132,Запорізька область
8966,230133,305,4,197,181,16,230133,Запорізька область
8967,230134,1812,27,1251,1144,107,230134,Запорізька область
8968,230135,1061,8,709,639,70,230135,Запорізька область
8969,230136,2106,28,1360,1253,107,230136,Запорізька область
8970,230137,797,9,469,440,29,230137,Запорізька область
8971,230138,584,10,374,347,27,230138,Запорізька область
8972,230139,888,7,575,530,45,230139,Запорізька область
8973,230140,299,2,194,175,19,230140,Запорізька область
8974,230141,583,12,371,340,31,230141,Запорізька область
8975,230142,888,4,542,505,37,230142,Запорізька область
8976,230143,1060,4,661,592,69,230143,Запорізька область
8977,230144,852,8,474,430,44,230144,Запорізька область
8978,230145,1102,12,718,657,61,230145,Запорізька область
8979,230146,224,3,163,146,17,230146,Запорізька область
8980,230147,646,7,329,295,34,230147,Запорізька область
8981,230148,987,13,669,632,37,230148,Запорізька область
8982,230149,583,8,373,331,42,230149,Запорізька область
8983,230150,215,1,133,124,9,230150,Запорізька область
8984,230151,157,21,121,57,64,230151,Запорізька область
8985,230152,434,27,407,286,121,230152,Запорізька область
8986,230153,521,23,493,387,106,230153,Запорізька область
8987,230154,473,25,448,412,36,230154,Запорізька область
8988,230155,72,1,71,63,8,230155,Запорізька область
8989,230156,158,1,115,113,2,230156,Запорізька область
8990,230157,103,1,74,66,8,230157,Запорізька область
8991,230158,910,14,554,484,70,230158,Запорізька область
8992,230159,1512,12,884,799,85,230159,Запорізька область
8993,230161,1584,19,920,818,102,230161,Запорізька область
8994,230162,1731,22,1096,960,136,230162,Запорізька область
8995,230163,2118,22,1371,1239,132,230163,Запорізька область
8996,230164,1553,15,963,860,103,230164,Запорізька область
8997,230165,830,6,492,444,48,230165,Запорізька область
8998,230166,779,8,445,393,52,230166,Запорізька область
8999,230167,987,6,539,498,41,230167,Запорізька область
9000,230168,719,11,437,405,32,230168,Запорізька область
9001,230169,747,5,457,435,22,230169,Запорізька область
9002,230170,731,10,517,485,32,230170,Запорізька область
9003,230171,470,5,258,238,20,230171,Запорізька область
9004,230172,419,2,279,261,18,230172,Запорізька область
9005,230173,225,3,158,149,9,230173,Запорізька область
9006,230174,664,4,399,366,33,230174,Запорізька область
9007,230175,536,5,346,305,41,230175,Запорізька область
9008,230176,468,2,304,274,30,230176,Запорізька область
9009,230177,391,3,223,203,20,230177,Запорізька область
9010,230178,615,7,380,319,61,230178,Запорізька область
9011,230179,546,3,343,313,30,230179,Запорізька область
9012,230180,207,0,136,120,16,230180,Запорізька область
9013,230181,629,3,411,381,30,230181,Запорізька область
9014,230182,295,4,181,153,28,230182,Запорізька область
9015,230183,205,0,141,125,16,230183,Запорізька область
9016,230184,355,2,215,182,33,230184,Запорізька область
9017,230185,1075,8,601,568,33,230185,Запорізька область
9018,230186,330,2,179,162,17,230186,Запорізька область
9019,230187,18,0,16,14,2,230187,Запорізька область
9020,230188,19,1,18,16,2,230188,Запорізька область
9021,230189,40,0,38,32,6,230189,Запорізька область
9022,230190,1184,12,673,618,55,230190,Запорізька область
9023,230191,1111,9,672,615,57,230191,Запорізька область
9024,230192,2429,27,1569,1390,179,230192,Запорізька область
9025,230193,2307,33,1556,1377,179,230193,Запорізька область
9026,230194,1302,13,774,702,72,230194,Запорізька область
9027,230195,1398,8,740,662,78,230195,Запорізька область
9028,230196,1368,15,789,705,84,230196,Запорізька область
9029,230197,626,18,346,289,57,230197,Запорізька область
9030,230198,615,7,389,360,29,230198,Запорізька область
9031,230199,1675,19,1060,950,110,230199,Запорізька область
9032,230200,971,6,612,568,44,230200,Запорізька область
9033,230201,787,8,481,422,59,230201,Запорізька область
9034,230202,477,4,296,255,41,230202,Запорізька область
9035,230203,731,8,468,396,72,230203,Запорізька область
9036,230204,360,1,230,207,23,230204,Запорізька область
9037,230205,385,7,260,233,27,230205,Запорізька область
9038,230206,387,2,270,241,29,230206,Запорізька область
9039,230207,2107,35,1199,1089,110,230207,Запорізька область
9040,230208,2062,32,1317,1209,108,230208,Запорізька область
9041,230209,2190,36,1349,1244,105,230209,Запорізька область
9042,230210,758,5,470,429,41,230210,Запорізька область
9043,230211,504,11,336,311,25,230211,Запорізька область
9044,230212,602,6,344,318,26,230212,Запорізька область
9045,230213,973,10,567,510,57,230213,Запорізька область
9046,230214,115,0,67,55,12,230214,Запорізька область
9047,230215,971,11,596,529,67,230215,Запорізька область
9048,230216,1197,14,722,647,75,230216,Запорізька область
9049,230217,1371,15,716,647,69,230217,Запорізька область
9050,230218,265,1,145,130,15,230218,Запорізька область
9051,230219,835,14,531,479,52,230219,Запорізька область
9052,230220,741,7,521,464,57,230220,Запорізька область
9053,230221,929,11,572,518,54,230221,Запорізька область
9054,230222,1758,11,1148,1076,72,230222,Запорізька область
9055,230223,1301,9,810,735,75,230223,Запорізька область
9056,230224,403,8,215,200,15,230224,Запорізька область
9057,230225,1548,19,1034,918,116,230225,Запорізька область
9058,230226,674,4,461,393,68,230226,Запорізька область
9059,230227,544,2,292,267,25,230227,Запорізька область
9060,230228,971,13,632,535,97,230228,Запорізька область
9061,230229,1357,15,947,832,115,230229,Запорізька область
9062,230230,306,7,183,174,9,230230,Запорізька область
9063,230231,877,11,595,535,60,230231,Запорізька область
9064,230232,18,1,17,12,5,230232,Запорізька область
9065,230233,341,12,325,309,16,230233,Запорізька область
9066,230359,1793,26,1135,1005,130,230359,Запорізька область
9067,230360,1636,26,1070,961,109,230360,Запорізька область
9068,230361,1120,19,711,647,64,230361,Запорізька область
9069,230362,1040,11,598,535,63,230362,Запорізька область
9070,230363,384,2,235,222,13,230363,Запорізька область
9071,230364,397,3,259,241,18,230364,Запорізька область
9072,230365,425,2,248,217,31,230365,Запорізька область
9073,230366,518,8,347,320,27,230366,Запорізька область
9074,230367,491,2,326,276,50,230367,Запорізька область
9075,230368,792,3,459,406,53,230368,Запорізька область
9076,230369,383,3,256,231,25,230369,Запорізька область
9077,230370,456,3,261,220,41,230370,Запорізька область
9078,230371,583,3,400,359,41,230371,Запорізька область
9079,230372,542,8,360,333,27,230372,Запорізька область
9080,230373,605,4,367,333,34,230373,Запорізька область
9081,230374,629,3,371,345,26,230374,Запорізька область
9082,230375,18,0,16,12,4,230375,Запорізька область
9083,230387,399,4,227,195,32,230387,Запорізька область
9084,230393,250,4,155,141,14,230393,Запорізька область
9085,230400,374,9,217,200,17,230400,Запорізька область
9086,230407,478,2,303,270,33,230407,Запорізька область
9087,230415,645,1,298,260,38,230415,Запорізька область
9088,230416,1593,12,952,851,101,230416,Запорізька область
9089,230417,2091,29,1288,1121,167,230417,Запорізька область
9090,230418,1389,21,848,769,79,230418,Запорізька область
9091,230419,1736,13,1054,954,100,230419,Запорізька область
9092,230420,2145,27,1300,1165,135,230420,Запорізька область
9093,230421,1051,18,650,576,74,230421,Запорізька область
9094,230422,850,6,482,449,33,230422,Запорізька область
9095,230423,1620,21,1018,933,85,230423,Запорізька область
9096,230424,1629,12,968,865,103,230424,Запорізька область
9097,230425,1458,22,877,809,68,230425,Запорізька область
9098,230426,437,1,234,226,8,230426,Запорізька область
9099,230427,627,7,321,301,20,230427,Запорізька область
9100,230428,672,2,401,370,31,230428,Запорізька область
9101,230429,750,7,485,440,45,230429,Запорізька область
9102,230430,527,2,325,287,38,230430,Запорізька область
9103,230431,716,8,411,370,41,230431,Запорізька область
9104,230432,278,0,169,154,15,230432,Запорізька область
9105,230433,915,2,583,520,63,230433,Запорізька область
9106,230434,938,6,663,600,63,230434,Запорізька область
9107,230435,132,0,91,85,6,230435,Запорізька область
9108,230436,387,4,222,202,20,230436,Запорізька область
9109,230437,668,6,396,361,35,230437,Запорізька область
9110,230438,1075,9,660,608,52,230438,Запорізька область
9111,230439,1182,15,833,777,56,230439,Запорізька область
9112,230440,183,2,128,114,14,230440,Запорізька область
9113,230441,698,7,492,449,43,230441,Запорізька область
9114,230442,889,3,405,362,43,230442,Запорізька область
9115,230443,369,7,162,147,15,230443,Запорізька область
9116,230444,541,4,296,269,27,230444,Запорізька область
9117,230445,1819,9,997,906,91,230445,Запорізька область
9118,230446,908,7,466,446,20,230446,Запорізька область
9119,230447,481,2,260,244,16,230447,Запорізька область
9120,230449,248,1,148,137,11,230449,Запорізька область
9121,230450,35,0,32,25,7,230450,Запорізька область
9122,231125,1041,7,648,516,132,231125,Запорізька область
9123,231127,339,3,222,201,21,231127,Запорізька область
9124,231129,109,3,106,100,6,231129,Запорізька область
9125,1,385,50,335,289,46,1,Івано-Франківська область
9126,260855,1903,39,1195,498,697,260855,Івано-Франківська область
9127,260856,1908,48,1085,527,558,260856,Івано-Франківська область
9128,260857,2006,52,1193,551,642,260857,Івано-Франківська область
9129,260858,1727,37,1140,546,594,260858,Івано-Франківська область
9130,260859,2115,46,1263,537,726,260859,Івано-Франківська область
9131,260860,2024,41,1178,550,628,260860,Івано-Франківська область
9132,260861,1739,34,1043,462,581,260861,Івано-Франківська область
9133,260862,1729,60,1084,463,621,260862,Івано-Франківська область
9134,260863,2123,35,1238,615,623,260863,Івано-Франківська область
9135,260864,2077,52,1173,560,613,260864,Івано-Франківська область
9136,260865,1142,22,696,317,379,260865,Івано-Франківська область
9137,260866,2313,48,1300,613,687,260866,Івано-Франківська область
9138,260867,2188,53,1325,662,663,260867,Івано-Франківська область
9139,260868,2036,36,1234,564,670,260868,Івано-Франківська область
9140,260869,1415,41,799,375,424,260869,Івано-Франківська область
9141,260870,1569,44,949,467,482,260870,Івано-Франківська область
9142,260871,1489,29,870,501,369,260871,Івано-Франківська область
9143,260872,1992,46,1158,574,584,260872,Івано-Франківська область
9144,260873,1379,49,826,374,452,260873,Івано-Франківська область
9145,260874,2013,36,1286,606,680,260874,Івано-Франківська область
9146,260875,1991,57,1159,562,597,260875,Івано-Франківська область
9147,260876,737,13,441,213,228,260876,Івано-Франківська область
9148,260877,1909,37,1121,492,629,260877,Івано-Франківська область
9149,260878,1571,21,995,467,528,260878,Івано-Франківська область
9150,260879,2348,48,1372,644,728,260879,Івано-Франківська область
9151,260880,2429,65,1420,649,771,260880,Івано-Франківська область
9152,260881,1787,37,1071,482,589,260881,Івано-Франківська область
9153,260882,1659,38,998,445,553,260882,Івано-Франківська область
9154,260883,1117,20,689,317,372,260883,Івано-Франківська область
9155,260884,2310,47,1323,612,711,260884,Івано-Франківська область
9156,260887,2673,53,1646,743,903,260887,Івано-Франківська область
9157,260888,2258,53,1389,647,742,260888,Івано-Франківська область
9158,260889,1115,26,604,287,317,260889,Івано-Франківська область
9159,260890,2148,52,1265,641,624,260890,Івано-Франківська область
9160,260891,2146,36,1311,631,680,260891,Івано-Франківська область
9161,260892,2122,45,1213,636,577,260892,Івано-Франківська область
9162,260893,2587,48,1468,751,717,260893,Івано-Франківська область
9163,260894,1502,35,852,420,432,260894,Івано-Франківська область
9164,260895,2279,56,1371,624,747,260895,Івано-Франківська область
9165,260896,2380,45,1369,652,717,260896,Івано-Франківська область
9166,260897,2300,39,1387,600,787,260897,Івано-Франківська область
9167,260898,2182,47,1302,644,658,260898,Івано-Франківська область
9168,260899,1567,40,927,434,493,260899,Івано-Франківська область
9169,260900,2170,40,1332,617,715,260900,Івано-Франківська область
9170,260901,2405,64,1515,685,830,260901,Івано-Франківська область
9171,260902,2117,45,1292,607,685,260902,Івано-Франківська область
9172,260903,2364,42,1441,652,789,260903,Івано-Франківська область
9173,260904,2115,45,1244,591,653,260904,Івано-Франківська область
9174,260905,2388,66,1375,606,769,260905,Івано-Франківська область
9175,260906,2049,44,1271,579,692,260906,Івано-Франківська область
9176,260907,771,9,489,167,322,260907,Івано-Франківська область
9177,260911,2460,51,1513,680,833,260911,Івано-Франківська область
9178,260912,1900,50,1239,565,674,260912,Івано-Франківська область
9179,260913,1681,35,1073,495,578,260913,Івано-Франківська область
9180,260914,2350,37,1474,694,780,260914,Івано-Франківська область
9181,260915,1519,40,928,454,474,260915,Івано-Франківська область
9182,260916,1460,37,953,429,524,260916,Івано-Франківська область
9183,260917,2113,46,1340,588,752,260917,Івано-Франківська область
9184,260919,1796,52,1073,473,600,260919,Івано-Франківська область
9185,260920,1476,39,863,367,496,260920,Івано-Франківська область
9186,260921,2383,56,1433,762,671,260921,Івано-Франківська область
9187,260922,1862,51,1115,504,611,260922,Івано-Франківська область
9188,260923,1247,23,724,356,368,260923,Івано-Франківська область
9189,260924,2257,43,1335,689,646,260924,Івано-Франківська область
9190,260925,1862,41,1033,471,562,260925,Івано-Франківська область
9191,260926,2076,58,1273,709,564,260926,Івано-Франківська область
9192,260927,1971,30,1112,516,596,260927,Івано-Франківська область
9193,260928,2147,55,1200,572,628,260928,Івано-Франківська область
9194,260929,1168,25,675,321,354,260929,Івано-Франківська область
9195,260930,2143,54,1279,569,710,260930,Івано-Франківська область
9196,260931,944,20,566,278,288,260931,Івано-Франківська область
9197,260932,1712,32,1010,476,534,260932,Івано-Франківська область
9198,260933,2228,41,1272,616,656,260933,Івано-Франківська область
9199,260934,2085,51,1274,642,632,260934,Івано-Франківська область
9200,260935,2094,44,1268,656,612,260935,Івано-Франківська область
9201,260936,1876,34,1192,569,623,260936,Івано-Франківська область
9202,260937,1698,31,1009,545,464,260937,Івано-Франківська область
9203,260938,2020,26,1122,612,510,260938,Івано-Франківська область
9204,260939,2114,41,1227,671,556,260939,Івано-Франківська область
9205,260940,1804,23,881,467,414,260940,Івано-Франківська область
9206,260941,2259,45,1234,580,654,260941,Івано-Франківська область
9207,260942,2243,40,1143,660,483,260942,Івано-Франківська область
9208,260943,2295,32,1162,594,568,260943,Івано-Франківська область
9209,260946,160,3,143,59,84,260946,Івано-Франківська область
9210,260947,150,6,113,60,53,260947,Івано-Франківська область
9211,260948,29,0,25,15,10,260948,Івано-Франківська область
9212,260949,41,0,38,21,17,260949,Івано-Франківська область
9213,260950,49,3,40,23,17,260950,Івано-Франківська область
9214,260951,63,0,61,37,24,260951,Івано-Франківська область
9215,260952,106,5,91,55,36,260952,Івано-Франківська область
9216,260953,40,2,25,13,12,260953,Івано-Франківська область
9217,260954,63,0,48,27,21,260954,Івано-Франківська область
9218,260955,107,2,61,44,17,260955,Івано-Франківська область
9219,260956,291,13,192,93,99,260956,Івано-Франківська область
9220,260957,45,4,38,13,25,260957,Івано-Франківська область
9221,260958,1,0,1,0,1,260958,Івано-Франківська область
9222,260959,21,2,19,6,13,260959,Івано-Франківська область
9223,260960,22,0,13,6,7,260960,Івано-Франківська область
9224,261040,1042,15,638,308,330,261040,Івано-Франківська область
9225,261041,1811,45,1122,508,614,261041,Івано-Франківська область
9226,261043,1204,22,769,368,401,261043,Івано-Франківська область
9227,260087,1877,49,1076,589,487,260087,Івано-Франківська область
9228,260088,1142,27,593,335,258,260088,Івано-Франківська область
9229,260089,1951,35,1051,600,451,260089,Івано-Франківська область
9230,260090,1657,50,964,560,404,260090,Івано-Франківська область
9231,260091,1891,35,1133,669,464,260091,Івано-Франківська область
9232,260092,1752,32,1033,619,414,260092,Івано-Франківська область
9233,260093,1689,36,936,569,367,260093,Івано-Франківська область
9234,260094,1475,38,816,526,290,260094,Івано-Франківська область
9235,260095,1394,26,754,478,276,260095,Івано-Франківська область
9236,260096,658,15,365,192,173,260096,Івано-Франківська область
9237,260097,678,17,372,222,150,260097,Івано-Франківська область
9238,260098,274,2,193,92,101,260098,Івано-Франківська область
9239,260099,1635,26,931,506,425,260099,Івано-Франківська область
9240,260100,462,9,303,150,153,260100,Івано-Франківська область
9241,260101,191,7,130,55,75,260101,Івано-Франківська область
9242,260102,129,1,104,49,55,260102,Івано-Франківська область
9243,260103,111,5,94,53,41,260103,Івано-Франківська область
9244,260104,146,6,85,45,40,260104,Івано-Франківська область
9245,260105,1032,24,680,375,305,260105,Івано-Франківська область
9246,260110,286,0,186,83,103,260110,Івано-Франківська область
9247,260111,183,3,123,29,94,260111,Івано-Франківська область
9248,260112,249,2,158,98,60,260112,Івано-Франківська область
9249,260113,372,6,215,124,91,260113,Івано-Франківська область
9250,260114,241,9,186,124,62,260114,Івано-Франківська область
9251,260115,207,1,134,102,32,260115,Івано-Франківська область
9252,260116,1380,27,922,536,386,260116,Івано-Франківська область
9253,260117,304,3,184,103,81,260117,Івано-Франківська область
9254,260118,268,2,230,83,147,260118,Івано-Франківська область
9255,260119,42,2,36,12,24,260119,Івано-Франківська область
9256,260120,531,5,318,174,144,260120,Івано-Франківська область
9257,260121,467,2,400,220,180,260121,Івано-Франківська область
9258,260122,1463,18,922,454,468,260122,Івано-Франківська область
9259,260123,452,8,318,137,181,260123,Івано-Франківська область
9260,260124,947,23,591,339,252,260124,Івано-Франківська область
9261,260125,1768,34,1090,530,560,260125,Івано-Франківська область
9262,260126,110,1,79,35,44,260126,Івано-Франківська область
9263,260127,793,13,524,307,217,260127,Івано-Франківська область
9264,260128,338,1,203,83,120,260128,Івано-Франківська область
9265,260129,87,0,36,16,20,260129,Івано-Франківська область
9266,260131,339,5,244,148,96,260131,Івано-Франківська область
9267,260132,266,7,216,117,99,260132,Івано-Франківська область
9268,260134,324,5,210,131,79,260134,Івано-Франківська область
9269,260135,350,7,298,182,116,260135,Івано-Франківська область
9270,260136,202,3,184,105,79,260136,Івано-Франківська область
9271,260137,376,3,240,115,125,260137,Івано-Франківська область
9272,260138,630,3,359,160,199,260138,Івано-Франківська область
9273,260139,382,6,281,176,105,260139,Івано-Франківська область
9274,260141,312,7,203,90,113,260141,Івано-Франківська область
9275,260142,454,64,365,72,293,260142,Івано-Франківська область
9276,260143,395,0,321,171,150,260143,Івано-Франківська область
9277,260144,634,13,487,370,117,260144,Івано-Франківська область
9278,260145,146,5,118,52,66,260145,Івано-Франківська область
9279,260146,387,7,292,137,155,260146,Івано-Франківська область
9280,260147,237,0,190,100,90,260147,Івано-Франківська область
9281,260148,316,6,166,122,44,260148,Івано-Франківська область
9282,260149,329,7,202,138,64,260149,Івано-Франківська область
9283,260150,67,1,52,26,26,260150,Івано-Франківська область
9284,260151,95,2,77,27,50,260151,Івано-Франківська область
9285,260152,54,1,45,21,24,260152,Івано-Франківська область
9286,260153,235,3,183,99,84,260153,Івано-Франківська область
9287,260155,341,10,208,131,77,260155,Івано-Франківська область
9288,260156,136,2,93,53,40,260156,Івано-Франківська область
9289,260157,282,1,235,92,143,260157,Івано-Франківська область
9290,260158,371,2,313,143,170,260158,Івано-Франківська область
9291,260159,472,8,353,75,278,260159,Івано-Франківська область
9292,260160,992,13,664,294,370,260160,Івано-Франківська область
9293,260161,326,7,242,108,134,260161,Івано-Франківська область
9294,260162,32,1,27,15,12,260162,Івано-Франківська область
9295,260163,18,0,18,12,6,260163,Івано-Франківська область
9296,260727,1453,31,781,410,371,260727,Івано-Франківська область
9297,260728,917,21,465,223,242,260728,Івано-Франківська область
9298,260729,1765,32,976,489,487,260729,Івано-Франківська область
9299,260730,1732,38,903,498,405,260730,Івано-Франківська область
9300,260731,716,4,447,268,179,260731,Івано-Франківська область
9301,260732,973,32,611,312,299,260732,Івано-Франківська область
9302,260733,2104,36,1337,658,679,260733,Івано-Франківська область
9303,260734,2176,40,1329,602,727,260734,Івано-Франківська область
9304,260735,1042,25,731,389,342,260735,Івано-Франківська область
9305,260736,1777,14,1230,478,752,260736,Івано-Франківська область
9306,260737,1176,13,848,442,406,260737,Івано-Франківська область
9307,260738,908,16,596,319,277,260738,Івано-Франківська область
9308,260739,147,2,104,24,80,260739,Івано-Франківська область
9309,260740,443,3,302,106,196,260740,Івано-Франківська область
9310,260741,1460,23,867,388,479,260741,Івано-Франківська область
9311,260742,1569,16,929,462,467,260742,Івано-Франківська область
9312,260743,1472,21,829,451,378,260743,Івано-Франківська область
9313,260744,1062,17,907,365,542,260744,Івано-Франківська область
9314,260745,1178,19,683,292,391,260745,Івано-Франківська область
9315,260746,502,8,368,172,196,260746,Івано-Франківська область
9316,260747,392,6,242,82,160,260747,Івано-Франківська область
9317,260748,1694,33,947,551,396,260748,Івано-Франківська область
9318,260749,802,20,509,270,239,260749,Івано-Франківська область
9319,260750,116,1,74,34,40,260750,Івано-Франківська область
9320,260751,736,23,408,193,215,260751,Івано-Франківська область
9321,260752,453,4,267,140,127,260752,Івано-Франківська область
9322,260753,761,18,585,198,387,260753,Івано-Франківська область
9323,260754,730,12,474,310,164,260754,Івано-Франківська область
9324,260755,233,4,163,85,78,260755,Івано-Франківська область
9325,260756,1645,28,1217,469,748,260756,Івано-Франківська область
9326,260757,1849,40,1061,583,478,260757,Івано-Франківська область
9327,260758,1396,25,887,383,504,260758,Івано-Франківська область
9328,260759,1987,105,1281,449,832,260759,Івано-Франківська область
9329,260760,1431,17,824,351,473,260760,Івано-Франківська область
9330,260761,108,0,78,30,48,260761,Івано-Франківська область
9331,260762,1047,10,650,361,289,260762,Івано-Франківська область
9332,260763,2417,48,1566,852,714,260763,Івано-Франківська область
9333,260764,219,4,162,75,87,260764,Івано-Франківська область
9334,260765,597,8,354,151,203,260765,Івано-Франківська область
9335,260766,971,14,792,339,453,260766,Івано-Франківська область
9336,260767,941,11,597,207,390,260767,Івано-Франківська область
9337,260768,1608,20,898,464,434,260768,Івано-Франківська область
9338,260769,797,16,453,232,221,260769,Івано-Франківська область
9339,260770,863,20,525,312,213,260770,Івано-Франківська область
9340,260771,2238,39,1223,702,521,260771,Івано-Франківська область
9341,260772,618,8,414,242,172,260772,Івано-Франківська область
9342,260773,648,5,475,174,301,260773,Івано-Франківська область
9343,260774,884,12,638,242,396,260774,Івано-Франківська область
9344,260775,2110,39,1535,494,1041,260775,Івано-Франківська область
9345,260776,1154,7,729,333,396,260776,Івано-Франківська область
9346,260777,624,21,357,176,181,260777,Івано-Франківська область
9347,260778,699,8,406,196,210,260778,Івано-Франківська область
9348,260779,1376,18,853,405,448,260779,Івано-Франківська область
9349,260780,1760,30,1019,522,497,260780,Івано-Франківська область
9350,260781,2273,17,1294,564,730,260781,Івано-Франківська область
9351,260782,1468,28,942,499,443,260782,Івано-Франківська область
9352,260783,1085,20,780,319,461,260783,Івано-Франківська область
9353,260784,1457,22,974,342,632,260784,Івано-Франківська область
9354,260785,26,2,20,12,8,260785,Івано-Франківська область
9355,260786,24,0,22,9,13,260786,Івано-Франківська область
9356,260787,1483,33,767,472,295,260787,Івано-Франківська область
9357,260788,1629,23,806,505,301,260788,Івано-Франківська область
9358,260789,1598,26,869,541,328,260789,Івано-Франківська область
9359,260790,1674,27,907,510,397,260790,Івано-Франківська область
9360,260791,1117,16,559,357,202,260791,Івано-Франківська область
9361,260792,1230,19,580,350,230,260792,Івано-Франківська область
9362,260793,364,5,244,110,134,260793,Івано-Франківська область
9363,260794,757,12,469,293,176,260794,Івано-Франківська область
9364,260795,665,12,462,256,206,260795,Івано-Франківська область
9365,260796,669,3,377,203,174,260796,Івано-Франківська область
9366,260797,207,9,129,78,51,260797,Івано-Франківська область
9367,260798,576,8,343,204,139,260798,Івано-Франківська область
9368,260799,418,19,244,134,110,260799,Івано-Франківська область
9369,260800,936,16,466,331,135,260800,Івано-Франківська область
9370,260801,713,6,397,212,185,260801,Івано-Франківська область
9371,260802,838,8,419,237,182,260802,Івано-Франківська область
9372,260803,1202,12,876,363,513,260803,Івано-Франківська область
9373,260804,1273,15,614,264,350,260804,Івано-Франківська область
9374,260805,384,1,254,144,110,260805,Івано-Франківська область
9375,260806,764,13,357,186,171,260806,Івано-Франківська область
9376,260807,1009,10,566,366,200,260807,Івано-Франківська область
9377,260808,178,1,118,85,33,260808,Івано-Франківська область
9378,260809,597,7,406,166,240,260809,Івано-Франківська область
9379,260810,664,6,425,264,161,260810,Івано-Франківська область
9380,260811,1024,10,789,474,315,260811,Івано-Франківська область
9381,260812,1010,14,530,331,199,260812,Івано-Франківська область
9382,260813,739,13,366,202,164,260813,Івано-Франківська область
9383,260814,1606,23,899,628,271,260814,Івано-Франківська область
9384,260815,378,10,244,105,139,260815,Івано-Франківська область
9385,260816,670,12,384,217,167,260816,Івано-Франківська область
9386,260817,594,4,330,152,178,260817,Івано-Франківська область
9387,260818,471,10,294,141,153,260818,Івано-Франківська область
9388,260819,180,3,140,51,89,260819,Івано-Франківська область
9389,260820,188,0,92,48,44,260820,Івано-Франківська область
9390,260821,604,8,372,188,184,260821,Івано-Франківська область
9391,260822,859,9,541,346,195,260822,Івано-Франківська область
9392,260823,443,6,245,198,47,260823,Івано-Франківська область
9393,260824,188,7,129,87,42,260824,Івано-Франківська область
9394,260825,362,6,226,142,84,260825,Івано-Франківська область
9395,260826,515,10,365,141,224,260826,Івано-Франківська область
9396,260827,76,1,52,24,28,260827,Івано-Франківська область
9397,260828,180,3,116,82,34,260828,Івано-Франківська область
9398,260829,576,8,371,185,186,260829,Івано-Франківська область
9399,260830,371,11,215,127,88,260830,Івано-Франківська область
9400,260831,511,17,298,116,182,260831,Івано-Франківська область
9401,260832,704,5,310,198,112,260832,Івано-Франківська область
9402,260833,555,4,313,129,184,260833,Івано-Франківська область
9403,260834,262,4,138,89,49,260834,Івано-Франківська область
9404,260835,498,5,289,182,107,260835,Івано-Франківська область
9405,260836,254,8,164,84,80,260836,Івано-Франківська область
9406,260837,1003,12,557,293,264,260837,Івано-Франківська область
9407,260838,91,4,81,47,34,260838,Івано-Франківська область
9408,260885,2172,30,1297,609,688,260885,Івано-Франківська область
9409,260886,2281,34,1393,634,759,260886,Івано-Франківська область
9410,260908,2272,44,1360,571,789,260908,Івано-Франківська область
9411,260909,915,14,485,233,252,260909,Івано-Франківська область
9412,260910,2352,37,1392,504,888,260910,Івано-Франківська область
9413,260918,1521,38,868,357,511,260918,Івано-Франківська область
9414,260944,2380,57,1445,680,765,260944,Івано-Франківська область
9415,260945,1856,37,1130,524,606,260945,Івано-Франківська область
9416,261037,574,11,338,115,223,261037,Івано-Франківська область
9417,261038,441,7,300,141,159,261038,Івано-Франківська область
9418,261042,2328,30,1370,612,758,261042,Івано-Франківська область
9419,260106,545,5,384,186,198,260106,Івано-Франківська область
9420,260107,329,2,227,106,121,260107,Івано-Франківська область
9421,260108,858,27,594,230,364,260108,Івано-Франківська область
9422,260109,555,9,406,218,188,260109,Івано-Франківська область
9423,260130,1377,40,839,443,396,260130,Івано-Франківська область
9424,260133,1227,15,803,243,560,260133,Івано-Франківська область
9425,260140,1191,24,892,523,369,260140,Івано-Франківська область
9426,260154,322,5,198,157,41,260154,Івано-Франківська область
9427,260276,1915,18,1097,558,539,260276,Івано-Франківська область
9428,260277,1893,46,1068,637,431,260277,Івано-Франківська область
9429,260278,929,11,596,320,276,260278,Івано-Франківська область
9430,260279,149,6,123,43,80,260279,Івано-Франківська область
9431,260280,1864,21,1082,700,382,260280,Івано-Франківська область
9432,260281,576,5,347,208,139,260281,Івано-Франківська область
9433,260282,335,8,173,135,38,260282,Івано-Франківська область
9434,260283,325,3,208,135,73,260283,Івано-Франківська область
9435,260284,1926,7,1001,621,380,260284,Івано-Франківська область
9436,260285,2102,26,1125,657,468,260285,Івано-Франківська область
9437,260286,1140,16,743,456,287,260286,Івано-Франківська область
9438,260287,973,16,523,315,208,260287,Івано-Франківська область
9439,260288,1290,19,694,457,237,260288,Івано-Франківська область
9440,260289,330,4,229,131,98,260289,Івано-Франківська область
9441,260290,1410,20,1130,683,447,260290,Івано-Франківська область
9442,260291,634,13,491,233,258,260291,Івано-Франківська область
9443,260292,1062,10,557,334,223,260292,Івано-Франківська область
9444,260293,215,3,167,114,53,260293,Івано-Франківська область
9445,260294,933,9,713,269,444,260294,Івано-Франківська область
9446,260295,1483,21,822,482,340,260295,Івано-Франківська область
9447,260296,1589,32,959,528,431,260296,Івано-Франківська область
9448,260297,324,2,246,201,45,260297,Івано-Франківська область
9449,260298,103,2,68,30,38,260298,Івано-Франківська область
9450,260299,277,6,202,121,81,260299,Івано-Франківська область
9451,260300,733,7,496,212,284,260300,Івано-Франківська область
9452,260301,893,19,549,368,181,260301,Івано-Франківська область
9453,260302,394,3,277,178,99,260302,Івано-Франківська область
9454,260303,1462,30,889,603,286,260303,Івано-Франківська область
9455,260304,1361,25,738,460,278,260304,Івано-Франківська область
9456,260305,756,20,440,276,164,260305,Івано-Франківська область
9457,260306,359,4,280,168,112,260306,Івано-Франківська область
9458,260307,150,3,100,65,35,260307,Івано-Франківська область
9459,260308,439,6,278,177,101,260308,Івано-Франківська область
9460,260309,2149,34,1390,803,587,260309,Івано-Франківська область
9461,260310,737,14,532,317,215,260310,Івано-Франківська область
9462,260311,1649,31,975,447,528,260311,Івано-Франківська область
9463,260312,672,12,398,190,208,260312,Івано-Франківська область
9464,260313,512,6,316,212,104,260313,Івано-Франківська область
9465,260314,591,4,426,272,154,260314,Івано-Франківська область
9466,260315,274,2,200,144,56,260315,Івано-Франківська область
9467,260316,517,8,332,129,203,260316,Івано-Франківська область
9468,260317,755,10,464,282,182,260317,Івано-Франківська область
9469,260318,358,3,197,104,93,260318,Івано-Франківська область
9470,260319,146,1,87,50,37,260319,Івано-Франківська область
9471,260320,215,3,117,59,58,260320,Івано-Франківська область
9472,260321,1226,16,913,553,360,260321,Івано-Франківська область
9473,260322,971,14,544,260,284,260322,Івано-Франківська область
9474,260323,1286,13,771,442,329,260323,Івано-Франківська область
9475,260324,375,9,259,143,116,260324,Івано-Франківська область
9476,260325,917,12,511,329,182,260325,Івано-Франківська область
9477,260326,538,7,341,197,144,260326,Івано-Франківська область
9478,260327,1382,26,783,444,339,260327,Івано-Франківська область
9479,260328,21,0,19,10,9,260328,Івано-Франківська область
9480,260538,419,8,257,153,104,260538,Івано-Франківська область
9481,260539,2174,42,1217,682,535,260539,Івано-Франківська область
9482,260540,2327,39,1346,728,618,260540,Івано-Франківська область
9483,260541,1239,20,764,480,284,260541,Івано-Франківська область
9484,260542,1181,27,638,386,252,260542,Івано-Франківська область
9485,260543,128,2,105,47,58,260543,Івано-Франківська область
9486,260544,759,15,587,393,194,260544,Івано-Франківська область
9487,260545,513,9,355,154,201,260545,Івано-Франківська область
9488,260546,114,2,70,31,39,260546,Івано-Франківська область
9489,260547,527,9,337,216,121,260547,Івано-Франківська область
9490,260548,705,12,452,288,164,260548,Івано-Франківська область
9491,260549,1015,18,629,411,218,260549,Івано-Франківська область
9492,260550,73,2,50,35,15,260550,Івано-Франківська область
9493,260551,190,6,119,68,51,260551,Івано-Франківська область
9494,260552,142,1,95,69,26,260552,Івано-Франківська область
9495,260553,207,2,135,96,39,260553,Івано-Франківська область
9496,260554,123,1,81,26,55,260554,Івано-Франківська область
9497,260555,131,0,97,31,66,260555,Івано-Франківська область
9498,260556,67,0,53,22,31,260556,Івано-Франківська область
9499,260557,283,9,180,96,84,260557,Івано-Франківська область
9500,260558,94,1,84,53,31,260558,Івано-Франківська область
9501,260559,557,16,462,164,298,260559,Івано-Франківська область
9502,260560,125,2,86,22,64,260560,Івано-Франківська область
9503,260561,292,5,232,143,89,260561,Івано-Франківська область
9504,260562,488,12,311,168,143,260562,Івано-Франківська область
9505,260563,299,3,190,86,104,260563,Івано-Франківська область
9506,260564,178,8,138,50,88,260564,Івано-Франківська область
9507,260565,276,2,229,88,141,260565,Івано-Франківська область
9508,260566,155,3,113,52,61,260566,Івано-Франківська область
9509,260567,174,5,115,45,70,260567,Івано-Франківська область
9510,260568,484,18,399,190,209,260568,Івано-Франківська область
9511,260569,485,4,324,176,148,260569,Івано-Франківська область
9512,260570,600,13,498,226,272,260570,Івано-Франківська область
9513,260571,424,6,334,167,167,260571,Івано-Франківська область
9514,260572,257,4,180,95,85,260572,Івано-Франківська область
9515,260573,463,9,351,159,192,260573,Івано-Франківська область
9516,260574,406,3,331,97,234,260574,Івано-Франківська область
9517,260575,594,12,405,213,192,260575,Івано-Франківська область
9518,260576,152,1,100,67,33,260576,Івано-Франківська область
9519,260577,359,11,295,138,157,260577,Івано-Франківська область
9520,260578,1035,19,645,417,228,260578,Івано-Франківська область
9521,260579,58,0,47,24,23,260579,Івано-Франківська область
9522,260580,202,1,154,73,81,260580,Івано-Франківська область
9523,260581,160,4,127,49,78,260581,Івано-Франківська область
9524,260582,827,17,608,437,171,260582,Івано-Франківська область
9525,260583,287,10,195,111,84,260583,Івано-Франківська область
9526,260584,415,6,276,211,65,260584,Івано-Франківська область
9527,260585,310,6,216,132,84,260585,Івано-Франківська область
9528,260586,268,7,186,129,57,260586,Івано-Франківська область
9529,260587,138,0,112,60,52,260587,Івано-Франківська область
9530,260588,405,9,252,117,135,260588,Івано-Франківська область
9531,260589,327,7,253,136,117,260589,Івано-Франківська область
9532,260590,368,5,263,146,117,260590,Івано-Франківська область
9533,260591,322,5,218,120,98,260591,Івано-Франківська область
9534,260592,279,5,217,122,95,260592,Івано-Франківська область
9535,260593,542,20,416,217,199,260593,Івано-Франківська область
9536,260594,708,20,480,281,199,260594,Івано-Франківська область
9537,260595,670,3,529,303,226,260595,Івано-Франківська область
9538,260596,535,4,336,177,159,260596,Івано-Франківська область
9539,260597,229,5,143,99,44,260597,Івано-Франківська область
9540,260598,416,1,253,134,119,260598,Івано-Франківська область
9541,260599,302,5,233,168,65,260599,Івано-Франківська область
9542,260600,55,1,44,22,22,260600,Івано-Франківська область
9543,260601,214,3,145,82,63,260601,Івано-Франківська область
9544,260602,451,11,361,129,232,260602,Івано-Франківська область
9545,260603,150,2,136,50,86,260603,Івано-Франківська область
9546,260604,226,4,138,82,56,260604,Івано-Франківська область
9547,260605,464,2,308,183,125,260605,Івано-Франківська область
9548,260606,382,17,238,122,116,260606,Івано-Франківська область
9549,260607,751,13,485,255,230,260607,Івано-Франківська область
9550,260608,471,4,326,192,134,260608,Івано-Франківська область
9551,260609,160,2,106,67,39,260609,Івано-Франківська область
9552,260610,586,21,437,271,166,260610,Івано-Франківська область
9553,260611,658,9,461,286,175,260611,Івано-Франківська область
9554,260612,303,5,175,91,84,260612,Івано-Франківська область
9555,260613,47,1,42,21,21,260613,Івано-Франківська область
9556,260614,8,0,7,3,4,260614,Івано-Франківська область
9557,260615,137,15,122,63,59,260615,Івано-Франківська область
9558,260962,1221,25,763,367,396,260962,Івано-Франківська область
9559,260963,1825,32,1013,554,459,260963,Івано-Франківська область
9560,260964,2207,57,1394,705,689,260964,Івано-Франківська область
9561,260965,1574,30,959,508,451,260965,Івано-Франківська область
9562,260966,2217,28,1355,717,638,260966,Івано-Франківська область
9563,260967,1943,39,1134,553,581,260967,Івано-Франківська область
9564,260968,1464,39,811,417,394,260968,Івано-Франківська область
9565,260969,2274,54,1302,678,624,260969,Івано-Франківська область
9566,260970,2076,41,1185,655,530,260970,Івано-Франківська область
9567,260971,2222,45,1218,693,525,260971,Івано-Франківська область
9568,260972,1960,31,1152,619,533,260972,Івано-Франківська область
9569,260973,2174,48,1231,650,581,260973,Івано-Франківська область
9570,260974,2249,41,1303,648,655,260974,Івано-Франківська область
9571,260975,2194,55,1300,644,656,260975,Івано-Франківська область
9572,260976,2335,49,1289,652,637,260976,Івано-Франківська область
9573,260977,2182,50,1190,575,615,260977,Івано-Франківська область
9574,260978,2205,49,1189,651,538,260978,Івано-Франківська область
9575,260979,2344,49,1198,674,524,260979,Івано-Франківська область
9576,260980,2376,59,1283,753,530,260980,Івано-Франківська область
9577,260981,2324,48,1206,707,499,260981,Івано-Франківська область
9578,260982,2203,42,1118,630,488,260982,Івано-Франківська область
9579,260983,1885,40,977,586,391,260983,Івано-Франківська область
9580,260984,2322,46,1210,777,433,260984,Івано-Франківська область
9581,260985,1529,23,827,492,335,260985,Івано-Франківська область
9582,260986,2037,24,1047,577,470,260986,Івано-Франківська область
9583,260987,33,0,30,17,13,260987,Івано-Франківська область
9584,260988,63,1,59,30,29,260988,Івано-Франківська область
9585,260008,636,9,359,183,176,260008,Івано-Франківська область
9586,260009,1073,14,657,389,268,260009,Івано-Франківська область
9587,260014,793,14,466,294,172,260014,Івано-Франківська область
9588,260015,858,22,480,337,143,260015,Івано-Франківська область
9589,260020,1179,24,758,371,387,260020,Івано-Франківська область
9590,260021,1471,20,800,627,173,260021,Івано-Франківська область
9591,260022,1311,12,688,430,258,260022,Івано-Франківська область
9592,260023,686,7,364,239,125,260023,Івано-Франківська область
9593,260027,473,9,277,165,112,260027,Івано-Франківська область
9594,260034,1185,20,773,540,233,260034,Івано-Франківська область
9595,260035,1303,19,831,622,209,260035,Івано-Франківська область
9596,260036,1527,19,957,685,272,260036,Івано-Франківська область
9597,260037,1390,11,740,464,276,260037,Івано-Франківська область
9598,260038,1109,10,573,362,211,260038,Івано-Франківська область
9599,260039,1336,23,815,495,320,260039,Івано-Франківська область
9600,260045,547,1,307,178,129,260045,Івано-Франківська область
9601,260046,1463,18,991,708,283,260046,Івано-Франківська область
9602,260222,1623,39,918,431,487,260222,Івано-Франківська область
9603,260223,2234,49,1233,612,621,260223,Івано-Франківська область
9604,260224,1505,26,838,453,385,260224,Івано-Франківська область
9605,260225,2036,33,1196,578,618,260225,Івано-Франківська область
9606,260226,1714,32,845,467,378,260226,Івано-Франківська область
9607,260227,1358,26,786,381,405,260227,Івано-Франківська область
9608,260228,2047,36,1181,609,572,260228,Івано-Франківська область
9609,260229,1370,29,730,406,324,260229,Івано-Франківська область
9610,260230,1313,34,740,401,339,260230,Івано-Франківська область
9611,260231,609,7,424,237,187,260231,Івано-Франківська область
9612,260232,1641,28,937,523,414,260232,Івано-Франківська область
9613,260233,1650,26,995,579,416,260233,Івано-Франківська область
9614,260234,621,13,390,216,174,260234,Івано-Франківська область
9615,260235,551,6,273,188,85,260235,Івано-Франківська область
9616,260236,975,10,558,321,237,260236,Івано-Франківська область
9617,260237,691,5,487,298,189,260237,Івано-Франківська область
9618,260238,2357,28,1119,602,517,260238,Івано-Франківська область
9619,260239,1005,10,622,377,245,260239,Івано-Франківська область
9620,260240,1481,34,974,586,388,260240,Івано-Франківська область
9621,260241,1451,27,908,458,450,260241,Івано-Франківська область
9622,260242,1706,48,1024,513,511,260242,Івано-Франківська область
9623,260243,855,6,604,371,233,260243,Івано-Франківська область
9624,260244,1086,23,605,308,297,260244,Івано-Франківська область
9625,260245,1394,28,807,407,400,260245,Івано-Франківська область
9626,260246,796,11,423,241,182,260246,Івано-Франківська область
9627,260247,489,18,268,143,125,260247,Івано-Франківська область
9628,260248,788,11,469,265,204,260248,Івано-Франківська область
9629,260249,229,3,181,70,111,260249,Івано-Франківська область
9630,260250,456,4,287,168,119,260250,Івано-Франківська область
9631,260251,1081,31,605,380,225,260251,Івано-Франківська область
9632,260252,960,18,573,320,253,260252,Івано-Франківська область
9633,260253,424,11,237,123,114,260253,Івано-Франківська область
9634,260254,960,21,713,325,388,260254,Івано-Франківська область
9635,260255,872,4,617,347,270,260255,Івано-Франківська область
9636,260256,456,5,285,143,142,260256,Івано-Франківська область
9637,260257,742,3,305,202,103,260257,Івано-Франківська область
9638,260258,613,6,457,168,289,260258,Івано-Франківська область
9639,260259,185,7,143,76,67,260259,Івано-Франківська область
9640,260260,188,0,150,33,117,260260,Івано-Франківська область
9641,260261,824,13,485,260,225,260261,Івано-Франківська область
9642,260262,819,21,548,345,203,260262,Івано-Франківська область
9643,260263,223,4,141,68,73,260263,Івано-Франківська область
9644,260264,483,5,421,235,186,260264,Івано-Франківська область
9645,260265,720,7,521,173,348,260265,Івано-Франківська область
9646,260266,2216,33,1214,693,521,260266,Івано-Франківська область
9647,260267,258,3,194,117,77,260267,Івано-Франківська область
9648,260268,780,14,517,349,168,260268,Івано-Франківська область
9649,260269,523,5,266,135,131,260269,Івано-Франківська область
9650,260270,1039,10,706,419,287,260270,Івано-Франківська область
9651,260271,1519,39,907,531,376,260271,Івано-Франківська область
9652,260272,236,2,189,152,37,260272,Івано-Франківська область
9653,260273,796,13,429,258,171,260273,Івано-Франківська область
9654,260274,36,0,30,20,10,260274,Івано-Франківська область
9655,260616,1609,46,878,497,381,260616,Івано-Франківська область
9656,260617,1592,32,966,560,406,260617,Івано-Франківська область
9657,260618,2222,31,1423,651,772,260618,Івано-Франківська область
9658,260619,1968,46,1160,539,621,260619,Івано-Франківська область
9659,260620,1997,33,1280,907,373,260620,Івано-Франківська область
9660,260621,2299,41,1630,1127,503,260621,Івано-Франківська область
9661,260622,2502,35,1312,929,383,260622,Івано-Франківська область
9662,260623,1470,30,917,569,348,260623,Івано-Франківська область
9663,260624,1405,19,771,529,242,260624,Івано-Франківська область
9664,260625,800,11,597,426,171,260625,Івано-Франківська область
9665,260626,915,16,630,273,357,260626,Івано-Франківська область
9666,260627,821,17,519,251,268,260627,Івано-Франківська область
9667,260628,782,13,535,251,284,260628,Івано-Франківська область
9668,260629,348,4,231,136,95,260629,Івано-Франківська область
9669,260630,1392,28,742,493,249,260630,Івано-Франківська область
9670,260631,522,18,329,205,124,260631,Івано-Франківська область
9671,260632,215,7,146,99,47,260632,Івано-Франківська область
9672,260633,1374,31,959,612,347,260633,Івано-Франківська область
9673,260634,905,12,660,365,295,260634,Івано-Франківська область
9674,260635,104,0,70,47,23,260635,Івано-Франківська область
9675,260636,290,5,226,142,84,260636,Івано-Франківська область
9676,260637,1063,28,710,330,380,260637,Івано-Франківська область
9677,260638,833,22,611,348,263,260638,Івано-Франківська область
9678,260639,686,12,369,234,135,260639,Івано-Франківська область
9679,260640,918,10,532,279,253,260640,Івано-Франківська область
9680,260641,1817,33,1119,553,566,260641,Івано-Франківська область
9681,260642,1207,9,834,523,311,260642,Івано-Франківська область
9682,260643,1429,32,1052,770,282,260643,Івано-Франківська область
9683,260644,637,8,379,271,108,260644,Івано-Франківська область
9684,260645,1309,14,648,469,179,260645,Івано-Франківська область
9685,260646,1369,11,712,508,204,260646,Івано-Франківська область
9686,260647,307,2,202,133,69,260647,Івано-Франківська область
9687,260648,2056,53,1258,913,345,260648,Івано-Франківська область
9688,260649,412,4,190,133,57,260649,Івано-Франківська область
9689,260650,125,2,96,42,54,260650,Івано-Франківська область
9690,260651,1035,13,609,441,168,260651,Івано-Франківська область
9691,260652,1140,13,549,350,199,260652,Івано-Франківська область
9692,260653,982,7,556,367,189,260653,Івано-Франківська область
9693,260654,478,5,277,158,119,260654,Івано-Франківська область
9694,260655,633,14,428,245,183,260655,Івано-Франківська область
9695,260656,1861,27,1098,724,374,260656,Івано-Франківська область
9696,260657,1906,31,1082,743,339,260657,Івано-Франківська область
9697,260658,999,14,676,423,253,260658,Івано-Франківська область
9698,260659,1465,25,857,589,268,260659,Івано-Франківська область
9699,260660,322,10,210,142,68,260660,Івано-Франківська область
9700,260661,165,2,117,67,50,260661,Івано-Франківська область
9701,260662,939,27,511,279,232,260662,Івано-Франківська область
9702,260663,1284,22,793,531,262,260663,Івано-Франківська область
9703,260664,521,6,345,183,162,260664,Івано-Франківська область
9704,260665,442,5,328,155,173,260665,Івано-Франківська область
9705,260666,1491,16,811,490,321,260666,Івано-Франківська область
9706,260667,1595,14,960,588,372,260667,Івано-Франківська область
9707,260839,1841,33,937,508,429,260839,Івано-Франківська область
9708,260840,1676,24,912,515,397,260840,Івано-Франківська область
9709,260841,1613,34,876,507,369,260841,Івано-Франківська область
9710,260842,1717,28,979,511,468,260842,Івано-Франківська область
9711,260843,1121,24,665,427,238,260843,Івано-Франківська область
9712,260844,654,10,360,162,198,260844,Івано-Франківська область
9713,260845,364,12,266,124,142,260845,Івано-Франківська область
9714,260846,127,4,99,50,49,260846,Івано-Франківська область
9715,260847,613,17,366,149,217,260847,Івано-Франківська область
9716,260848,308,2,238,51,187,260848,Івано-Франківська область
9717,260849,1432,27,844,422,422,260849,Івано-Франківська область
9718,260850,1048,18,554,236,318,260850,Івано-Франківська область
9719,260851,116,0,71,26,45,260851,Івано-Франківська область
9720,260852,827,12,499,274,225,260852,Івано-Франківська область
9721,260853,964,20,777,366,411,260853,Івано-Франківська область
9722,260854,1213,9,636,370,266,260854,Івано-Франківська область
9723,261039,127,1,90,52,38,261039,Івано-Франківська область
9724,260001,1892,35,1029,564,465,260001,Івано-Франківська область
9725,260002,1671,51,988,584,404,260002,Івано-Франківська область
9726,260003,1983,45,1055,611,444,260003,Івано-Франківська область
9727,260004,985,28,589,384,205,260004,Івано-Франківська область
9728,260005,827,19,464,287,177,260005,Івано-Франківська область
9729,260006,1159,13,657,424,233,260006,Івано-Франківська область
9730,260007,1956,22,875,653,222,260007,Івано-Франківська область
9731,260010,965,19,565,402,163,260010,Івано-Франківська область
9732,260011,596,13,330,220,110,260011,Івано-Франківська область
9733,260012,557,5,301,190,111,260012,Івано-Франківська область
9734,260013,950,16,493,310,183,260013,Івано-Франківська область
9735,260016,1925,36,1024,502,522,260016,Івано-Франківська область
9736,260017,1530,25,845,609,236,260017,Івано-Франківська область
9737,260018,674,12,390,177,213,260018,Івано-Франківська область
9738,260019,1870,54,1217,671,546,260019,Івано-Франківська область
9739,260024,1198,12,598,245,353,260024,Івано-Франківська область
9740,260025,1446,12,671,305,366,260025,Івано-Франківська область
9741,260026,2265,28,1335,784,551,260026,Івано-Франківська область
9742,260028,1153,30,707,501,206,260028,Івано-Франківська область
9743,260029,461,6,281,187,94,260029,Івано-Франківська область
9744,260030,489,7,318,170,148,260030,Івано-Франківська область
9745,260031,279,2,178,101,77,260031,Івано-Франківська область
9746,260032,383,6,241,130,111,260032,Івано-Франківська область
9747,260033,1933,37,1166,732,434,260033,Івано-Франківська область
9748,260040,1695,32,916,588,328,260040,Івано-Франківська область
9749,260041,971,18,523,327,196,260041,Івано-Франківська область
9750,260042,718,11,448,283,165,260042,Івано-Франківська область
9751,260043,1510,21,951,644,307,260043,Івано-Франківська область
9752,260044,968,16,567,420,147,260044,Івано-Франківська область
9753,260329,2059,42,1213,794,419,260329,Івано-Франківська область
9754,260330,1859,40,1113,706,407,260330,Івано-Франківська область
9755,260331,427,4,303,238,65,260331,Івано-Франківська область
9756,260332,177,3,134,53,81,260332,Івано-Франківська область
9757,260333,928,17,535,282,253,260333,Івано-Франківська область
9758,260334,229,2,168,116,52,260334,Івано-Франківська область
9759,260335,1317,21,862,605,257,260335,Івано-Франківська область
9760,260336,2046,35,1174,853,321,260336,Івано-Франківська область
9761,260337,941,16,550,367,183,260337,Івано-Франківська область
9762,260338,378,3,228,153,75,260338,Івано-Франківська область
9763,260408,34,1,33,14,19,260408,Івано-Франківська область
9764,260473,1632,40,916,506,410,260473,Івано-Франківська область
9765,260474,2082,45,1206,610,596,260474,Івано-Франківська область
9766,260475,1638,41,947,526,421,260475,Івано-Франківська область
9767,260476,2341,58,1366,755,611,260476,Івано-Франківська область
9768,260477,1409,34,770,381,389,260477,Івано-Франківська область
9769,260478,1700,33,937,552,385,260478,Івано-Франківська область
9770,260479,1270,23,655,340,315,260479,Івано-Франківська область
9771,260480,1061,24,618,308,310,260480,Івано-Франківська область
9772,260481,1800,36,924,579,345,260481,Івано-Франківська область
9773,260482,2066,13,1059,760,299,260482,Івано-Франківська область
9774,260483,582,8,315,228,87,260483,Івано-Франківська область
9775,260484,198,5,115,50,65,260484,Івано-Франківська область
9776,260485,2272,32,994,651,343,260485,Івано-Франківська область
9777,260486,1336,24,611,405,206,260486,Івано-Франківська область
9778,260487,1418,17,601,435,166,260487,Івано-Франківська область
9779,260488,523,11,387,234,153,260488,Івано-Франківська область
9780,260489,1068,16,557,378,179,260489,Івано-Франківська область
9781,260490,1697,18,698,468,230,260490,Івано-Франківська область
9782,260491,1956,40,830,535,295,260491,Івано-Франківська область
9783,260492,1647,29,717,461,256,260492,Івано-Франківська область
9784,260493,960,12,596,313,283,260493,Івано-Франківська область
9785,260494,1645,35,810,494,316,260494,Івано-Франківська область
9786,260495,1848,36,941,538,403,260495,Івано-Франківська область
9787,260496,1216,17,600,391,209,260496,Івано-Франківська область
9788,260497,1140,11,656,379,277,260497,Івано-Франківська область
9789,260498,1004,8,787,366,421,260498,Івано-Франківська область
9790,260499,1008,20,568,299,269,260499,Івано-Франківська область
9791,260500,1835,23,1460,600,860,260500,Івано-Франківська область
9792,260501,1101,13,514,273,241,260501,Івано-Франківська область
9793,260502,1719,41,831,535,296,260502,Івано-Франківська область
9794,260503,1543,26,789,450,339,260503,Івано-Франківська область
9795,260504,1421,11,796,451,345,260504,Івано-Франківська область
9796,260505,1818,25,893,573,320,260505,Івано-Франківська область
9797,260506,717,16,408,261,147,260506,Івано-Франківська область
9798,260507,642,0,357,251,106,260507,Івано-Франківська область
9799,260508,812,40,487,242,245,260508,Івано-Франківська область
9800,260509,1369,26,917,543,374,260509,Івано-Франківська область
9801,260510,1180,30,734,513,221,260510,Івано-Франківська область
9802,260511,1299,16,617,396,221,260511,Івано-Франківська область
9803,260512,1242,19,708,453,255,260512,Івано-Франківська область
9804,260513,2081,31,1340,857,483,260513,Івано-Франківська область
9805,260514,1847,34,1103,741,362,260514,Івано-Франківська область
9806,260515,1224,17,786,483,303,260515,Івано-Франківська область
9807,260516,214,3,159,104,55,260516,Івано-Франківська область
9808,260517,1202,15,648,504,144,260517,Івано-Франківська область
9809,260518,534,4,354,290,64,260518,Івано-Франківська область
9810,260519,2444,20,1058,782,276,260519,Івано-Франківська область
9811,260520,418,5,237,159,78,260520,Івано-Франківська область
9812,260521,1763,89,1042,517,525,260521,Івано-Франківська область
9813,260522,2068,32,1086,722,364,260522,Івано-Франківська область
9814,260523,1978,36,1189,863,326,260523,Івано-Франківська область
9815,260524,783,13,436,363,73,260524,Івано-Франківська область
9816,260525,1299,28,783,489,294,260525,Івано-Франківська область
9817,260526,1229,32,758,431,327,260526,Івано-Франківська область
9818,260527,30,0,24,15,9,260527,Івано-Франківська область
9819,260528,651,5,331,183,148,260528,Івано-Франківська область
9820,260529,187,1,107,76,31,260529,Івано-Франківська область
9821,260530,102,0,70,29,41,260530,Івано-Франківська область
9822,260531,1665,34,880,532,348,260531,Івано-Франківська область
9823,260532,2298,39,1245,698,547,260532,Івано-Франківська область
9824,260533,1139,23,812,340,472,260533,Івано-Франківська область
9825,260534,758,15,486,171,315,260534,Івано-Франківська область
9826,260535,1343,11,735,423,312,260535,Івано-Франківська область
9827,260536,2096,24,1154,517,637,260536,Івано-Франківська область
9828,260537,23,0,17,9,8,260537,Івано-Франківська область
9829,261025,2353,39,1391,875,516,261025,Івано-Франківська область
9830,261026,1504,17,870,469,401,261026,Івано-Франківська область
9831,261027,1591,35,916,500,416,261027,Івано-Франківська область
9832,261028,961,9,504,334,170,261028,Івано-Франківська область
9833,261029,1988,15,988,790,198,261029,Івано-Франківська область
9834,261030,1889,20,1026,766,260,261030,Івано-Франківська область
9835,261031,1169,21,719,492,227,261031,Івано-Франківська область
9836,261032,1494,26,739,472,267,261032,Івано-Франківська область
9837,261033,1668,21,862,594,268,261033,Івано-Франківська область
9838,261034,696,7,403,309,94,261034,Івано-Франківська область
9839,261035,1629,12,883,638,245,261035,Івано-Франківська область
9840,261036,335,0,155,113,42,261036,Івано-Франківська область
9841,260165,1875,28,956,559,397,260165,Івано-Франківська область
9842,260166,1515,28,799,496,303,260166,Івано-Франківська область
9843,260167,1101,22,611,394,217,260167,Івано-Франківська область
9844,260168,1009,6,544,389,155,260168,Івано-Франківська область
9845,260169,1333,22,807,536,271,260169,Івано-Франківська область
9846,260170,1173,18,852,504,348,260170,Івано-Франківська область
9847,260171,161,2,113,49,64,260171,Івано-Франківська область
9848,260172,602,19,373,174,199,260172,Івано-Франківська область
9849,260173,677,9,395,227,168,260173,Івано-Франківська область
9850,260174,207,1,137,77,60,260174,Івано-Франківська область
9851,260175,368,9,276,55,221,260175,Івано-Франківська область
9852,260176,888,18,699,280,419,260176,Івано-Франківська область
9853,260177,767,11,599,334,265,260177,Івано-Франківська область
9854,260178,201,2,150,79,71,260178,Івано-Франківська область
9855,260179,855,19,484,330,154,260179,Івано-Франківська область
9856,260180,283,7,153,90,63,260180,Івано-Франківська область
9857,260181,592,19,314,212,102,260181,Івано-Франківська область
9858,260182,476,5,321,235,86,260182,Івано-Франківська область
9859,260183,237,2,171,61,110,260183,Івано-Франківська область
9860,260184,464,4,411,168,243,260184,Івано-Франківська область
9861,260185,803,23,583,395,188,260185,Івано-Франківська область
9862,260186,1763,19,1081,636,445,260186,Івано-Франківська область
9863,260187,646,7,431,297,134,260187,Івано-Франківська область
9864,260188,586,11,431,271,160,260188,Івано-Франківська область
9865,260189,47,0,33,13,20,260189,Івано-Франківська область
9866,260190,62,1,38,28,10,260190,Івано-Франківська область
9867,260191,515,4,321,201,120,260191,Івано-Франківська область
9868,260192,344,5,219,137,82,260192,Івано-Франківська область
9869,260193,852,14,475,332,143,260193,Івано-Франківська область
9870,260194,354,8,242,185,57,260194,Івано-Франківська область
9871,260195,99,1,69,38,31,260195,Івано-Франківська область
9872,260196,404,8,282,167,115,260196,Івано-Франківська область
9873,260197,317,5,196,107,89,260197,Івано-Франківська область
9874,260198,942,14,782,413,369,260198,Івано-Франківська область
9875,260199,521,6,303,223,80,260199,Івано-Франківська область
9876,260200,498,6,334,202,132,260200,Івано-Франківська область
9877,260201,749,12,468,327,141,260201,Івано-Франківська область
9878,260202,242,1,157,111,46,260202,Івано-Франківська область
9879,260203,786,13,429,242,187,260203,Івано-Франківська область
9880,260204,363,6,217,138,79,260204,Івано-Франківська область
9881,260205,525,13,312,191,121,260205,Івано-Франківська область
9882,260206,73,0,50,30,20,260206,Івано-Франківська область
9883,260207,887,12,546,390,156,260207,Івано-Франківська область
9884,260208,1620,23,826,524,302,260208,Івано-Франківська область
9885,260209,547,14,301,168,133,260209,Івано-Франківська область
9886,260210,696,18,373,225,148,260210,Івано-Франківська область
9887,260211,1100,10,668,469,199,260211,Івано-Франківська область
9888,260212,138,0,90,66,24,260212,Івано-Франківська область
9889,260213,1427,15,819,469,350,260213,Івано-Франківська область
9890,260214,1361,14,844,306,538,260214,Івано-Франківська область
9891,260215,1018,11,619,269,350,260215,Івано-Франківська область
9892,260216,1454,20,966,566,400,260216,Івано-Франківська область
9893,260217,892,12,631,388,243,260217,Івано-Франківська область
9894,260218,1838,29,1131,558,573,260218,Івано-Франківська область
9895,260219,1306,7,653,410,243,260219,Івано-Франківська область
9896,260220,1233,5,630,398,232,260220,Івано-Франківська область
9897,260221,76,1,60,37,23,260221,Івано-Франківська область
9898,260339,953,7,483,332,151,260339,Івано-Франківська область
9899,260340,612,2,402,174,228,260340,Івано-Франківська область
9900,260341,1763,33,944,600,344,260341,Івано-Франківська область
9901,260342,293,9,208,133,75,260342,Івано-Франківська область
9902,260343,1240,21,646,335,311,260343,Івано-Франківська область
9903,260344,1011,15,630,407,223,260344,Івано-Франківська область
9904,260345,1777,34,1038,624,414,260345,Івано-Франківська область
9905,260346,668,9,387,255,132,260346,Івано-Франківська область
9906,260347,805,15,427,268,159,260347,Івано-Франківська область
9907,260348,745,11,417,227,190,260348,Івано-Франківська область
9908,260349,305,5,198,105,93,260349,Івано-Франківська область
9909,260350,1128,17,574,408,166,260350,Івано-Франківська область
9910,260351,1146,23,734,379,355,260351,Івано-Франківська область
9911,260352,588,9,450,275,175,260352,Івано-Франківська область
9912,260353,683,8,327,190,137,260353,Івано-Франківська область
9913,260354,2116,30,1105,653,452,260354,Івано-Франківська область
9914,260355,751,22,414,283,131,260355,Івано-Франківська область
9915,260356,432,4,215,114,101,260356,Івано-Франківська область
9916,260357,1222,16,726,406,320,260357,Івано-Франківська область
9917,260358,799,17,434,237,197,260358,Івано-Франківська область
9918,260359,1177,30,625,340,285,260359,Івано-Франківська область
9919,260360,1584,51,819,506,313,260360,Івано-Франківська область
9920,260361,270,4,166,111,55,260361,Івано-Франківська область
9921,260362,1908,27,891,581,310,260362,Івано-Франківська область
9922,260363,1066,9,549,333,216,260363,Івано-Франківська область
9923,260364,1243,23,674,420,254,260364,Івано-Франківська область
9924,260365,97,0,54,35,19,260365,Івано-Франківська область
9925,260366,515,5,295,206,89,260366,Івано-Франківська область
9926,260367,226,8,171,84,87,260367,Івано-Франківська область
9927,260368,2040,29,1127,744,383,260368,Івано-Франківська область
9928,260369,1823,30,931,603,328,260369,Івано-Франківська область
9929,260370,1330,23,569,404,165,260370,Івано-Франківська область
9930,260371,1472,13,847,519,328,260371,Івано-Франківська область
9931,260372,751,15,367,242,125,260372,Івано-Франківська область
9932,260373,939,18,534,240,294,260373,Івано-Франківська область
9933,260374,1727,23,964,434,530,260374,Івано-Франківська область
9934,260375,1596,16,897,458,439,260375,Івано-Франківська область
9935,260376,139,0,93,52,41,260376,Івано-Франківська область
9936,260377,818,21,461,246,215,260377,Івано-Франківська область
9937,260378,530,11,344,146,198,260378,Івано-Франківська область
9938,260379,789,14,425,274,151,260379,Івано-Франківська область
9939,260380,693,15,404,255,149,260380,Івано-Франківська область
9940,260381,668,6,360,175,185,260381,Івано-Франківська область
9941,260382,487,14,268,184,84,260382,Івано-Франківська область
9942,260383,210,2,119,97,22,260383,Івано-Франківська область
9943,260384,434,4,269,163,106,260384,Івано-Франківська область
9944,260385,392,4,199,122,77,260385,Івано-Франківська область
9945,260386,371,11,202,119,83,260386,Івано-Франківська область
9946,260387,1008,12,457,319,138,260387,Івано-Франківська область
9947,260388,1170,13,546,373,173,260388,Івано-Франківська область
9948,260389,968,29,586,347,239,260389,Івано-Франківська область
9949,260390,1107,12,533,358,175,260390,Івано-Франківська область
9950,260391,1029,8,511,336,175,260391,Івано-Франківська область
9951,260392,1355,15,580,335,245,260392,Івано-Франківська область
9952,260393,1181,7,493,269,224,260393,Івано-Франківська область
9953,260394,1120,12,556,344,212,260394,Івано-Франківська область
9954,260395,2010,26,1010,472,538,260395,Івано-Франківська область
9955,260396,2193,52,1093,569,524,260396,Івано-Франківська область
9956,260397,962,8,431,273,158,260397,Івано-Франківська область
9957,260398,816,10,392,193,199,260398,Івано-Франківська область
9958,260399,1885,27,932,583,349,260399,Івано-Франківська область
9959,260400,766,12,385,235,150,260400,Івано-Франківська область
9960,260401,1232,11,644,498,146,260401,Івано-Франківська область
9961,260402,1983,23,873,628,245,260402,Івано-Франківська область
9962,260403,565,10,347,200,147,260403,Івано-Франківська область
9963,260404,275,7,187,109,78,260404,Івано-Франківська область
9964,260405,79,0,61,44,17,260405,Івано-Франківська область
9965,260406,800,17,501,237,264,260406,Івано-Франківська область
9966,260407,797,10,452,280,172,260407,Івано-Франківська область
9967,260409,21,0,21,13,8,260409,Івано-Франківська область
9968,260410,20,1,18,7,11,260410,Івано-Франківська область
9969,260411,317,17,299,260,39,260411,Івано-Франківська область
9970,260989,1642,36,892,456,436,260989,Івано-Франківська область
9971,260990,1398,28,734,360,374,260990,Івано-Франківська область
9972,260991,1888,45,978,525,453,260991,Івано-Франківська область
9973,260992,1928,48,1086,539,547,260992,Івано-Франківська область
9974,260993,1628,29,879,464,415,260993,Івано-Франківська область
9975,260994,1915,38,1025,533,492,260994,Івано-Франківська область
9976,260996,2002,30,1056,579,477,260996,Івано-Франківська область
9977,260997,2035,48,1061,537,524,260997,Івано-Франківська область
9978,260998,1900,20,969,559,410,260998,Івано-Франківська область
9979,260999,1704,22,836,458,378,260999,Івано-Франківська область
9980,261002,1622,33,901,439,462,261002,Івано-Франківська область
9981,261003,1817,31,913,527,386,261003,Івано-Франківська область
9982,261004,1728,30,920,419,501,261004,Івано-Франківська область
9983,261005,1738,35,902,505,397,261005,Івано-Франківська область
9984,261006,1541,28,824,442,382,261006,Івано-Франківська область
9985,261007,1420,29,733,397,336,261007,Івано-Франківська область
9986,261008,1770,31,990,520,470,261008,Івано-Франківська область
9987,261009,1886,36,1035,585,450,261009,Івано-Франківська область
9988,261010,1859,32,994,521,473,261010,Івано-Франківська область
9989,261011,1892,33,1096,547,549,261011,Івано-Франківська область
9990,261013,1652,27,875,486,389,261013,Івано-Франківська область
9991,261014,1847,48,1035,488,547,261014,Івано-Франківська область
9992,261015,1814,44,942,437,505,261015,Івано-Франківська область
9993,261016,1435,31,805,358,447,261016,Івано-Франківська область
9994,261017,1657,18,924,412,512,261017,Івано-Франківська область
9995,261018,31,2,22,12,10,261018,Івано-Франківська область
9996,261019,17,0,16,9,7,261019,Івано-Франківська область
9997,261020,13,0,11,3,8,261020,Івано-Франківська область
9998,261021,12,0,12,4,8,261021,Івано-Франківська область
9999,261022,23,0,23,11,12,261022,Івано-Франківська область
10000,261023,76,2,67,35,32,261023,Івано-Франківська область
10001,261024,17,0,16,8,8,261024,Івано-Франківська область
10002,260048,1136,23,627,403,224,260048,Івано-Франківська область
10003,260049,518,7,326,213,113,260049,Івано-Франківська область
10004,260050,967,8,554,403,151,260050,Івано-Франківська область
10005,260051,723,9,392,291,101,260051,Івано-Франківська область
10006,260052,1007,21,511,376,135,260052,Івано-Франківська область
10007,260053,127,1,101,84,17,260053,Івано-Франківська область
10008,260054,884,12,481,362,119,260054,Івано-Франківська область
10009,260055,1491,23,776,586,190,260055,Івано-Франківська область
10010,260056,1097,11,569,433,136,260056,Івано-Франківська область
10011,260057,566,6,345,233,112,260057,Івано-Франківська область
10012,260058,136,3,88,54,34,260058,Івано-Франківська область
10013,260059,239,1,148,89,59,260059,Івано-Франківська область
10014,260060,243,3,158,102,56,260060,Івано-Франківська область
10015,260061,214,3,167,96,71,260061,Івано-Франківська область
10016,260062,1192,12,696,403,293,260062,Івано-Франківська область
10017,260063,210,5,110,77,33,260063,Івано-Франківська область
10018,260064,575,7,281,193,88,260064,Івано-Франківська область
10019,260065,886,7,483,380,103,260065,Івано-Франківська область
10020,260066,385,4,234,180,54,260066,Івано-Франківська область
10021,260067,1111,15,614,432,182,260067,Івано-Франківська область
10022,260068,375,5,273,146,127,260068,Івано-Франківська область
10023,260069,1093,21,768,430,338,260069,Івано-Франківська область
10024,260070,313,3,208,136,72,260070,Івано-Франківська область
10025,260071,939,6,438,300,138,260071,Івано-Франківська область
10026,260072,604,9,366,274,92,260072,Івано-Франківська область
10027,260073,217,1,153,101,52,260073,Івано-Франківська область
10028,260074,344,2,214,147,67,260074,Івано-Франківська область
10029,260075,678,6,432,206,226,260075,Івано-Франківська область
10030,260076,199,3,143,50,93,260076,Івано-Франківська область
10031,260077,536,2,335,262,73,260077,Івано-Франківська область
10032,260078,1055,10,614,457,157,260078,Івано-Франківська область
10033,260079,445,4,295,196,99,260079,Івано-Франківська область
10034,260080,665,2,464,372,92,260080,Івано-Франківська область
10035,260081,649,11,277,174,103,260081,Івано-Франківська область
10036,260082,107,3,78,49,29,260082,Івано-Франківська область
10037,260083,319,2,211,67,144,260083,Івано-Франківська область
10038,260084,302,3,184,114,70,260084,Івано-Франківська область
10039,260085,248,3,148,90,58,260085,Івано-Франківська область
10040,260086,28,0,24,17,7,260086,Івано-Франківська область
10041,260412,2259,39,1204,671,533,260412,Івано-Франківська область
10042,260413,2006,36,1060,620,440,260413,Івано-Франківська область
10043,260414,2264,49,1257,644,613,260414,Івано-Франківська область
10044,260415,1350,25,672,503,169,260415,Івано-Франківська область
10045,260416,1554,23,852,584,268,260416,Івано-Франківська область
10046,260417,1316,16,736,487,249,260417,Івано-Франківська область
10047,260418,603,9,265,155,110,260418,Івано-Франківська область
10048,260419,611,17,341,197,144,260419,Івано-Франківська область
10049,260420,841,23,435,220,215,260420,Івано-Франківська область
10050,260421,954,5,360,246,114,260421,Івано-Франківська область
10051,260422,1309,6,666,514,152,260422,Івано-Франківська область
10052,260423,1473,13,709,506,203,260423,Івано-Франківська область
10053,260424,1200,7,688,543,145,260424,Івано-Франківська область
10054,260425,1181,96,677,206,471,260425,Івано-Франківська область
10055,260426,1107,13,585,442,143,260426,Івано-Франківська область
10056,260427,408,6,229,149,80,260427,Івано-Франківська область
10057,260428,2009,21,916,753,163,260428,Івано-Франківська область
10058,260429,1954,14,738,434,304,260429,Івано-Франківська область
10059,260430,480,5,274,115,159,260430,Івано-Франківська область
10060,260431,480,5,171,112,59,260431,Івано-Франківська область
10061,260432,911,5,349,227,122,260432,Івано-Франківська область
10062,260433,447,7,272,107,165,260433,Івано-Франківська область
10063,260434,337,3,141,77,64,260434,Івано-Франківська область
10064,260435,944,10,687,440,247,260435,Івано-Франківська область
10065,260436,388,5,285,182,103,260436,Івано-Франківська область
10066,260437,668,6,373,265,108,260437,Івано-Франківська область
10067,260438,580,16,334,196,138,260438,Івано-Франківська область
10068,260439,922,31,486,204,282,260439,Івано-Франківська область
10069,260440,1706,19,779,516,263,260440,Івано-Франківська область
10070,260441,1411,15,646,408,238,260441,Івано-Франківська область
10071,260442,908,11,394,264,130,260442,Івано-Франківська область
10072,260443,1579,21,785,428,357,260443,Івано-Франківська область
10073,260444,1490,32,815,602,213,260444,Івано-Франківська область
10074,260445,1030,8,571,431,140,260445,Івано-Франківська область
10075,260446,1705,26,946,667,279,260446,Івано-Франківська область
10076,260447,1478,10,782,628,154,260447,Івано-Франківська область
10077,260448,899,12,489,377,112,260448,Івано-Франківська область
10078,260449,1355,21,770,521,249,260449,Івано-Франківська область
10079,260450,592,12,322,218,104,260450,Івано-Франківська область
10080,260451,1624,21,981,736,245,260451,Івано-Франківська область
10081,260452,625,5,270,177,93,260452,Івано-Франківська область
10082,260453,1220,23,665,473,192,260453,Івано-Франківська область
10083,260454,829,21,424,281,143,260454,Івано-Франківська область
10084,260455,1097,18,642,311,331,260455,Івано-Франківська область
10085,260456,1310,22,653,445,208,260456,Івано-Франківська область
10086,260457,1468,23,719,521,198,260457,Івано-Франківська область
10087,260458,786,11,390,283,107,260458,Івано-Франківська область
10088,260459,677,9,347,186,161,260459,Івано-Франківська область
10089,260460,1064,7,483,302,181,260460,Івано-Франківська область
10090,260461,1455,18,718,545,173,260461,Івано-Франківська область
10091,260462,1093,6,487,339,148,260462,Івано-Франківська область
10092,260464,1551,10,764,525,239,260464,Івано-Франківська область
10093,260465,1182,5,536,397,139,260465,Івано-Франківська область
10094,260466,1207,6,515,403,112,260466,Івано-Франківська область
10095,260467,834,11,472,319,153,260467,Івано-Франківська область
10096,260468,1182,5,613,363,250,260468,Івано-Франківська область
10097,260469,1510,23,816,446,370,260469,Івано-Франківська область
10098,260470,865,4,420,309,111,260470,Івано-Франківська область
10099,260471,764,1,376,284,92,260471,Івано-Франківська область
10100,260472,77,1,71,40,31,260472,Івано-Франківська область
10101,260668,1873,28,970,577,393,260668,Івано-Франківська область
10102,260669,1899,60,962,703,259,260669,Івано-Франківська область
10103,260670,1481,24,850,535,315,260670,Івано-Франківська область
10104,260671,990,30,563,363,200,260671,Івано-Франківська область
10105,260672,1525,19,814,658,156,260672,Івано-Франківська область
10106,260673,1431,30,748,535,213,260673,Івано-Франківська область
10107,260674,1435,29,821,519,302,260674,Івано-Франківська область
10108,260675,918,19,500,345,155,260675,Івано-Франківська область
10109,260676,518,12,306,210,96,260676,Івано-Франківська область
10110,260677,529,23,304,179,125,260677,Івано-Франківська область
10111,260678,1116,53,649,330,319,260678,Івано-Франківська область
10112,260679,657,14,406,310,96,260679,Івано-Франківська область
10113,260680,166,4,116,88,28,260680,Івано-Франківська область
10114,260681,415,8,213,166,47,260681,Івано-Франківська область
10115,260682,894,16,538,395,143,260682,Івано-Франківська область
10116,260683,769,15,393,220,173,260683,Івано-Франківська область
10117,260684,1679,33,868,590,278,260684,Івано-Франківська область
10118,260685,1231,15,696,461,235,260685,Івано-Франківська область
10119,260686,67,0,55,33,22,260686,Івано-Франківська область
10120,260687,934,21,489,311,178,260687,Івано-Франківська область
10121,260688,1332,28,654,472,182,260688,Івано-Франківська область
10122,260689,1361,23,813,447,366,260689,Івано-Франківська область
10123,260690,827,11,493,338,155,260690,Івано-Франківська область
10124,260691,156,6,105,77,28,260691,Івано-Франківська область
10125,260692,1374,25,828,504,324,260692,Івано-Франківська область
10126,260693,900,6,481,373,108,260693,Івано-Франківська область
10127,260694,791,16,426,354,72,260694,Івано-Франківська область
10128,260695,1083,14,578,466,112,260695,Івано-Франківська область
10129,260696,412,5,283,185,98,260696,Івано-Франківська область
10130,260697,733,7,482,186,296,260697,Івано-Франківська область
10131,260698,998,15,686,525,161,260698,Івано-Франківська область
10132,260699,717,24,523,393,130,260699,Івано-Франківська область
10133,260700,852,17,468,309,159,260700,Івано-Франківська область
10134,260701,438,18,276,189,87,260701,Івано-Франківська область
10135,260702,500,10,302,222,80,260702,Івано-Франківська область
10136,260703,1903,20,1181,745,436,260703,Івано-Франківська область
10137,260704,1124,12,739,478,261,260704,Івано-Франківська область
10138,260705,848,14,486,300,186,260705,Івано-Франківська область
10139,260706,1035,16,606,380,226,260706,Івано-Франківська область
10140,260707,977,14,591,421,170,260707,Івано-Франківська область
10141,260708,821,19,484,261,223,260708,Івано-Франківська область
10142,260709,1469,19,717,456,261,260709,Івано-Франківська область
10143,260710,1105,21,521,303,218,260710,Івано-Франківська область
10144,260711,731,5,345,275,70,260711,Івано-Франківська область
10145,260712,665,10,384,293,91,260712,Івано-Франківська область
10146,260713,953,14,431,320,111,260713,Івано-Франківська область
10147,260714,702,13,432,326,106,260714,Івано-Франківська область
10148,260715,274,4,147,101,46,260715,Івано-Франківська область
10149,260716,400,6,258,140,118,260716,Івано-Франківська область
10150,260717,938,22,524,371,153,260717,Івано-Франківська область
10151,260718,588,8,381,243,138,260718,Івано-Франківська область
10152,260719,641,21,437,281,156,260719,Івано-Франківська область
10153,260720,886,16,459,307,152,260720,Івано-Франківська область
10154,260721,302,7,185,126,59,260721,Івано-Франківська область
10155,260722,539,9,286,201,85,260722,Івано-Франківська область
10156,260723,257,4,143,95,48,260723,Івано-Франківська область
10157,260724,34,0,23,7,16,260724,Івано-Франківська область
10158,260725,19,1,18,7,11,260725,Івано-Франківська область
10159,321097,1862,30,1231,926,305,321097,Київська область
10160,321098,1720,25,1075,866,209,321098,Київська область
10161,321099,1238,19,750,572,178,321099,Київська область
10162,321100,2231,59,1403,1082,321,321100,Київська область
10163,321101,389,7,243,177,66,321101,Київська область
10164,321102,2193,42,1299,989,310,321102,Київська область
10165,321103,2392,52,1554,1146,408,321103,Київська область
10166,321104,285,4,174,131,43,321104,Київська область
10167,321105,2165,61,1361,986,375,321105,Київська область
10168,321106,1766,41,1123,840,283,321106,Київська область
10169,321107,1364,31,951,656,295,321107,Київська область
10170,321108,1745,23,1173,846,327,321108,Київська область
10171,321109,2292,42,1454,1075,379,321109,Київська область
10172,321110,625,9,301,198,103,321110,Київська область
10173,321111,2106,29,1380,1028,352,321111,Київська область
10174,321112,2301,44,1478,1055,423,321112,Київська область
10175,321113,711,7,474,335,139,321113,Київська область
10176,321114,1985,38,1358,977,381,321114,Київська область
10177,321115,2245,50,1530,1106,424,321115,Київська область
10178,321116,1081,15,726,553,173,321116,Київська область
10179,321117,450,9,298,231,67,321117,Київська область
10180,321118,1680,35,1108,815,293,321118,Київська область
10181,321119,2267,34,1458,1055,403,321119,Київська область
10182,321120,1867,44,1224,895,329,321120,Київська область
10183,321121,2175,41,1435,1073,362,321121,Київська область
10184,321122,2153,51,1443,1035,408,321122,Київська область
10185,321123,339,8,210,151,59,321123,Київська область
10186,321124,1413,25,862,644,218,321124,Київська область
10187,321125,2087,36,1328,981,347,321125,Київська область
10188,321126,1258,18,861,589,272,321126,Київська область
10189,321127,2291,72,1385,1040,345,321127,Київська область
10190,321128,2107,52,1415,1052,363,321128,Київська область
10191,321129,360,8,237,166,71,321129,Київська область
10192,321130,1663,28,1067,808,259,321130,Київська область
10193,321131,2242,37,1383,1077,306,321131,Київська область
10194,321132,1815,26,1291,914,377,321132,Київська область
10195,321133,1445,34,938,689,249,321133,Київська область
10196,321134,1075,28,650,444,206,321134,Київська область
10197,321135,2339,25,1410,1072,338,321135,Київська область
10198,321136,1390,36,859,629,230,321136,Київська область
10199,321137,1455,24,930,710,220,321137,Київська область
10200,321138,1967,35,1260,955,305,321138,Київська область
10201,321139,2220,40,1413,1051,362,321139,Київська область
10202,321140,565,11,388,259,129,321140,Київська область
10203,321141,2223,36,1368,1053,315,321141,Київська область
10204,321142,1628,29,864,714,150,321142,Київська область
10205,321143,1951,28,1169,902,267,321143,Київська область
10206,321144,1829,27,1163,888,275,321144,Київська область
10207,321145,2217,41,1419,1098,321,321145,Київська область
10208,321146,2256,44,1439,1061,378,321146,Київська область
10209,321147,413,9,256,194,62,321147,Київська область
10210,321148,1849,42,1081,868,213,321148,Київська область
10211,321149,872,22,573,452,121,321149,Київська область
10212,321150,2154,49,1408,1093,315,321150,Київська область
10213,321151,2252,42,1514,1107,407,321151,Київська область
10214,321152,2273,46,1510,1074,436,321152,Київська область
10215,321153,348,4,245,173,72,321153,Київська область
10216,321154,2162,27,1437,1081,356,321154,Київська область
10217,321155,2333,51,1597,1085,512,321155,Київська область
10218,321156,466,6,310,228,82,321156,Київська область
10219,321157,2311,40,1468,1084,384,321157,Київська область
10220,321158,2216,41,1448,1116,332,321158,Київська область
10221,321159,411,6,248,204,44,321159,Київська область
10222,321160,2191,39,1432,1077,355,321160,Київська область
10223,321161,1925,35,1219,909,310,321161,Київська область
10224,321162,763,15,496,379,117,321162,Київська область
10225,321163,2278,38,1423,1120,303,321163,Київська область
10226,321164,1417,28,883,662,221,321164,Київська область
10227,321165,1291,28,791,594,197,321165,Київська область
10228,321166,2342,22,1483,1151,332,321166,Київська область
10229,321167,1488,17,855,630,225,321167,Київська область
10230,321168,1063,9,621,487,134,321168,Київська область
10231,321169,2245,30,1470,1122,348,321169,Київська область
10232,321170,1526,36,977,757,220,321170,Київська область
10233,321171,2457,30,1425,1096,329,321171,Київська область
10234,321172,2292,32,1410,1052,358,321172,Київська область
10235,321173,404,5,193,176,17,321173,Київська область
10236,321174,2412,42,1577,1148,429,321174,Київська область
10237,321175,2202,35,1452,1088,364,321175,Київська область
10238,321176,1224,24,729,568,161,321176,Київська область
10239,321177,2081,29,1308,1012,296,321177,Київська область
10240,321178,1911,25,971,767,204,321178,Київська область
10241,321179,1796,30,1155,892,263,321179,Київська область
10242,321180,2160,35,1385,1026,359,321180,Київська область
10243,321181,894,18,576,425,151,321181,Київська область
10244,321182,2330,42,1569,1103,466,321182,Київська область
10245,321183,2151,36,1435,1049,386,321183,Київська область
10246,321184,386,10,254,211,43,321184,Київська область
10247,321185,35,0,34,29,5,321185,Київська область
10248,321186,26,0,23,17,6,321186,Київська область
10249,321187,13,0,13,10,3,321187,Київська область
10250,321188,27,1,26,18,8,321188,Київська область
10251,321189,24,0,20,15,5,321189,Київська область
10252,321190,69,3,65,47,18,321190,Київська область
10253,321191,28,2,26,19,7,321191,Київська область
10254,321192,381,15,362,344,18,321192,Київська область
10255,321398,916,13,573,455,118,321398,Київська область
10256,320562,612,8,419,287,132,320562,Київська область
10257,320578,1374,16,824,592,232,320578,Київська область
10258,320579,776,10,473,343,130,320579,Київська область
10259,320580,160,1,120,76,44,320580,Київська область
10260,320581,1620,14,990,701,289,320581,Київська область
10261,320582,893,7,560,386,174,320582,Київська область
10262,320597,2275,38,1427,882,545,320597,Київська область
10263,320598,1392,20,867,612,255,320598,Київська область
10264,320607,1386,17,905,647,258,320607,Київська область
10265,320608,711,13,419,309,110,320608,Київська область
10266,320609,433,9,308,205,103,320609,Київська область
10267,320612,1145,13,721,514,207,320612,Київська область
10268,320613,745,15,497,324,173,320613,Київська область
10269,320614,1331,16,815,543,272,320614,Київська область
10270,320617,1153,13,724,469,255,320617,Київська область
10271,320618,347,0,218,151,67,320618,Київська область
10272,320624,561,13,370,229,141,320624,Київська область
10273,320628,1766,22,1120,674,446,320628,Київська область
10274,320629,1698,32,1058,679,379,320629,Київська область
10275,320630,763,6,520,329,191,320630,Київська область
10276,320631,1191,20,782,524,258,320631,Київська область
10277,320632,639,6,410,308,102,320632,Київська область
10278,320633,2300,39,1401,952,449,320633,Київська область
10279,320634,1851,29,1109,751,358,320634,Київська область
10280,320635,1802,39,1217,767,450,320635,Київська область
10281,320636,2328,51,1563,970,593,320636,Київська область
10282,320637,1017,17,653,406,247,320637,Київська область
10283,320638,1817,29,1025,675,350,320638,Київська область
10284,320639,459,5,299,198,101,320639,Київська область
10285,320640,209,3,137,91,46,320640,Київська область
10286,320642,2344,41,1526,935,591,320642,Київська область
10287,320645,1040,6,626,469,157,320645,Київська область
10288,320646,134,1,80,52,28,320646,Київська область
10289,320647,670,14,408,274,134,320647,Київська область
10290,320648,2405,22,1478,1098,380,320648,Київська область
10291,320649,2339,36,1447,1067,380,320649,Київська область
10292,320650,1637,23,905,677,228,320650,Київська область
10293,320651,1935,29,1183,845,338,320651,Київська область
10294,320652,768,16,454,324,130,320652,Київська область
10295,320653,2397,30,1236,980,256,320653,Київська область
10296,320654,455,3,253,180,73,320654,Київська область
10297,320655,538,6,334,245,89,320655,Київська область
10298,320656,314,0,210,129,81,320656,Київська область
10299,320657,594,7,287,246,41,320657,Київська область
10300,320658,696,8,431,338,93,320658,Київська область
10301,320659,708,10,393,279,114,320659,Київська область
10302,320660,85,2,59,47,12,320660,Київська область
10303,320661,640,4,397,295,102,320661,Київська область
10304,320662,170,2,103,72,31,320662,Київська область
10305,320663,879,7,571,368,203,320663,Київська область
10306,320664,344,5,228,156,72,320664,Київська область
10307,320665,418,12,262,187,75,320665,Київська область
10308,320666,919,9,509,349,160,320666,Київська область
10309,320667,187,1,118,78,40,320667,Київська область
10310,320668,652,8,351,199,152,320668,Київська область
10311,320669,90,0,57,26,31,320669,Київська область
10312,320670,802,7,422,315,107,320670,Київська область
10313,320671,397,7,261,203,58,320671,Київська область
10314,320672,244,1,159,127,32,320672,Київська область
10315,320673,311,3,199,175,24,320673,Київська область
10316,320674,655,12,436,314,122,320674,Київська область
10317,320675,561,4,328,233,95,320675,Київська область
10318,320676,245,5,166,117,49,320676,Київська область
10319,320677,815,11,417,287,130,320677,Київська область
10320,320678,653,3,426,322,104,320678,Київська область
10321,320679,347,7,194,144,50,320679,Київська область
10322,320680,531,3,337,270,67,320680,Київська область
10323,320681,761,12,424,322,102,320681,Київська область
10324,320682,279,5,183,147,36,320682,Київська область
10325,320683,740,8,459,333,126,320683,Київська область
10326,320684,504,9,341,246,95,320684,Київська область
10327,320685,349,5,226,138,88,320685,Київська область
10328,320686,509,4,329,209,120,320686,Київська область
10329,320687,436,1,248,190,58,320687,Київська область
10330,320688,535,9,372,302,70,320688,Київська область
10331,320689,456,3,279,195,84,320689,Київська область
10332,320690,344,5,242,162,80,320690,Київська область
10333,320691,428,2,254,171,83,320691,Київська область
10334,320692,154,1,98,59,39,320692,Київська область
10335,320693,534,5,303,203,100,320693,Київська область
10336,320694,501,5,342,225,117,320694,Київська область
10337,320695,70,0,52,44,8,320695,Київська область
10338,320872,406,2,233,159,74,320872,Київська область
10339,320873,397,2,285,198,87,320873,Київська область
10340,320874,1665,23,972,683,289,320874,Київська область
10341,320878,521,0,356,225,131,320878,Київська область
10342,320879,237,0,188,129,59,320879,Київська область
10343,320883,274,1,198,132,66,320883,Київська область
10344,320884,772,15,539,400,139,320884,Київська область
10345,320885,168,1,132,101,31,320885,Київська область
10346,320887,254,2,145,82,63,320887,Київська область
10347,320888,271,1,186,148,38,320888,Київська область
10348,320889,368,6,225,182,43,320889,Київська область
10349,320893,1083,12,663,513,150,320893,Київська область
10350,320894,314,3,212,164,48,320894,Київська область
10351,320896,365,6,228,136,92,320896,Київська область
10352,320897,543,7,342,243,99,320897,Київська область
10353,320898,561,4,331,231,100,320898,Київська область
10354,320899,863,15,445,359,86,320899,Київська область
10355,320900,448,2,298,226,72,320900,Київська область
10356,320902,364,3,212,173,39,320902,Київська область
10357,320903,188,0,159,108,51,320903,Київська область
10358,321008,174,2,145,98,47,321008,Київська область
10359,321009,441,5,308,235,73,321009,Київська область
10360,321011,2107,35,1108,854,254,321011,Київська область
10361,321012,866,6,469,373,96,321012,Київська область
10362,321013,408,3,228,168,60,321013,Київська область
10363,321014,664,4,371,262,109,321014,Київська область
10364,321015,603,4,306,239,67,321015,Київська область
10365,321016,564,4,353,265,88,321016,Київська область
10366,321017,128,1,85,65,20,321017,Київська область
10367,321018,258,3,177,103,74,321018,Київська область
10368,321019,788,9,416,309,107,321019,Київська область
10369,321020,1127,12,604,475,129,321020,Київська область
10370,321021,557,5,316,253,63,321021,Київська область
10371,321022,474,6,286,233,53,321022,Київська область
10372,321023,471,4,261,216,45,321023,Київська область
10373,321024,481,8,381,128,253,321024,Київська область
10374,321025,657,8,393,301,92,321025,Київська область
10375,321027,232,2,131,108,23,321027,Київська область
10376,321028,558,8,348,270,78,321028,Київська область
10377,321029,529,2,347,253,94,321029,Київська область
10378,321030,584,7,282,202,80,321030,Київська область
10379,321031,857,6,445,334,111,321031,Київська область
10380,321032,902,5,547,416,131,321032,Київська область
10381,321033,251,1,175,150,25,321033,Київська область
10382,321034,423,3,283,157,126,321034,Київська область
10383,321035,1507,21,781,580,201,321035,Київська область
10384,321036,1030,8,585,439,146,321036,Київська область
10385,321037,780,12,399,282,117,321037,Київська область
10386,321038,188,2,134,104,30,321038,Київська область
10387,321039,375,6,194,144,50,321039,Київська область
10388,321040,1495,35,890,631,259,321040,Київська область
10389,321041,1491,25,864,618,246,321041,Київська область
10390,321042,1296,28,720,528,192,321042,Київська область
10391,321043,1668,29,1001,717,284,321043,Київська область
10392,321044,529,4,271,185,86,321044,Київська область
10393,321045,969,10,543,410,133,321045,Київська область
10394,321046,498,7,273,224,49,321046,Київська область
10395,321047,67,0,45,24,21,321047,Київська область
10396,321373,1587,25,965,744,221,321373,Київська область
10397,321374,1892,29,1167,891,276,321374,Київська область
10398,321375,1612,34,989,737,252,321375,Київська область
10399,321376,1737,25,1037,858,179,321376,Київська область
10400,321377,1547,21,923,691,232,321377,Київська область
10401,321378,1914,32,1107,875,232,321378,Київська область
10402,321379,1667,17,934,740,194,321379,Київська область
10403,321380,1996,21,1105,873,232,321380,Київська область
10404,321381,1494,22,850,643,207,321381,Київська область
10405,321382,1446,11,853,636,217,321382,Київська область
10406,321383,1583,34,829,607,222,321383,Київська область
10407,321384,1902,38,1065,781,284,321384,Київська область
10408,321385,1706,25,1016,761,255,321385,Київська область
10409,321386,1750,29,1174,775,399,321386,Київська область
10410,321387,1894,34,1128,796,332,321387,Київська область
10411,321388,1843,36,1160,838,322,321388,Київська область
10412,321389,2028,41,1236,869,367,321389,Київська область
10413,321390,1667,31,1059,721,338,321390,Київська область
10414,321391,1848,41,1079,757,322,321391,Київська область
10415,321392,1927,28,1261,909,352,321392,Київська область
10416,321393,1557,21,951,710,241,321393,Київська область
10417,321394,1683,26,1099,774,325,321394,Київська область
10418,321395,1590,22,920,679,241,321395,Київська область
10419,321396,107,4,100,80,20,321396,Київська область
10420,321418,1818,27,1124,705,419,321418,Київська область
10421,320037,997,11,515,399,116,320037,Київська область
10422,320038,1738,27,1033,824,209,320038,Київська область
10423,320039,651,9,332,267,65,320039,Київська область
10424,320040,1134,19,617,464,153,320040,Київська область
10425,320041,1586,18,863,627,236,320041,Київська область
10426,320042,1811,31,1007,780,227,320042,Київська область
10427,320043,1892,26,1131,845,286,320043,Київська область
10428,320044,1143,21,786,617,169,320044,Київська область
10429,320045,363,7,251,175,76,320045,Київська область
10430,320046,470,5,312,272,40,320046,Київська область
10431,320047,198,4,153,97,56,320047,Київська область
10432,320048,702,7,460,335,125,320048,Київська область
10433,320049,360,6,266,188,78,320049,Київська область
10434,320050,763,11,583,472,111,320050,Київська область
10435,320051,254,5,178,139,39,320051,Київська область
10436,320052,665,10,450,332,118,320052,Київська область
10437,320053,255,0,181,98,83,320053,Київська область
10438,320054,142,0,107,73,34,320054,Київська область
10439,320055,346,6,255,177,78,320055,Київська область
10440,320056,398,8,288,184,104,320056,Київська область
10441,320057,399,12,248,190,58,320057,Київська область
10442,320058,977,17,580,460,120,320058,Київська область
10443,320059,544,4,333,264,69,320059,Київська область
10444,320060,969,10,654,529,125,320060,Київська область
10445,320061,441,5,277,225,52,320061,Київська область
10446,320062,1333,24,687,519,168,320062,Київська область
10447,320063,962,21,492,371,121,320063,Київська область
10448,320064,217,4,135,98,37,320064,Київська область
10449,320065,389,3,307,218,89,320065,Київська область
10450,320066,691,4,434,337,97,320066,Київська область
10451,320067,540,6,344,248,96,320067,Київська область
10452,320068,933,8,623,428,195,320068,Київська область
10453,320069,872,10,547,379,168,320069,Київська область
10454,320070,433,6,298,227,71,320070,Київська область
10455,320071,320,7,224,155,69,320071,Київська область
10456,320072,583,5,409,253,156,320072,Київська область
10457,320073,485,4,307,220,87,320073,Київська область
10458,320074,180,2,116,86,30,320074,Київська область
10459,320075,325,4,291,159,132,320075,Київська область
10460,320076,491,7,299,225,74,320076,Київська область
10461,320077,793,14,538,448,90,320077,Київська область
10462,320078,610,5,376,314,62,320078,Київська область
10463,320079,583,7,386,284,102,320079,Київська область
10464,320080,897,15,599,404,195,320080,Київська область
10465,320081,1876,33,1266,1043,223,320081,Київська область
10466,320082,403,5,277,180,97,320082,Київська область
10467,320083,150,0,111,92,19,320083,Київська область
10468,320084,250,5,191,157,34,320084,Київська область
10469,320085,1824,25,1095,773,322,320085,Київська область
10470,320086,1367,17,803,615,188,320086,Київська область
10471,320087,342,2,257,178,79,320087,Київська область
10472,320088,399,6,264,170,94,320088,Київська область
10473,320089,574,12,345,252,93,320089,Київська область
10474,320090,378,4,228,164,64,320090,Київська область
10475,320091,1380,18,920,683,237,320091,Київська область
10476,320092,897,13,555,437,118,320092,Київська область
10477,320093,79,0,66,49,17,320093,Київська область
10478,320398,594,7,360,281,79,320398,Київська область
10479,320399,176,4,124,92,32,320399,Київська область
10480,320400,1304,21,743,585,158,320400,Київська область
10481,320401,1742,20,1077,785,292,320401,Київська область
10482,320402,1390,20,833,628,205,320402,Київська область
10483,320403,343,4,218,180,38,320403,Київська область
10484,320404,80,0,42,31,11,320404,Київська область
10485,320405,747,9,435,330,105,320405,Київська область
10486,320406,621,8,340,266,74,320406,Київська область
10487,320407,422,7,270,212,58,320407,Київська область
10488,320408,293,13,196,121,75,320408,Київська область
10489,320409,417,5,251,160,91,320409,Київська область
10490,320410,127,1,92,60,32,320410,Київська область
10491,320411,539,2,300,242,58,320411,Київська область
10492,320412,745,3,465,377,88,320412,Київська область
10493,320413,84,1,56,43,13,320413,Київська область
10494,320414,294,2,189,172,17,320414,Київська область
10495,320415,493,8,295,241,54,320415,Київська область
10496,320416,390,0,282,238,44,320416,Київська область
10497,320417,286,2,195,161,34,320417,Київська область
10498,320418,518,7,385,292,93,320418,Київська область
10499,320419,170,4,119,98,21,320419,Київська область
10500,320420,171,1,116,88,28,320420,Київська область
10501,320421,76,1,56,50,6,320421,Київська область
10502,320422,382,5,255,166,89,320422,Київська область
10503,320423,504,8,321,225,96,320423,Київська область
10504,320424,809,11,427,250,177,320424,Київська область
10505,320425,346,3,260,158,102,320425,Київська область
10506,320426,150,1,121,99,22,320426,Київська область
10507,320427,387,2,263,213,50,320427,Київська область
10508,320428,130,5,91,59,32,320428,Київська область
10509,320429,954,13,581,458,123,320429,Київська область
10510,320430,24,1,22,14,8,320430,Київська область
10511,320862,1661,22,928,743,185,320862,Київська область
10512,320863,1384,22,710,578,132,320863,Київська область
10513,320864,1811,42,1076,805,271,320864,Київська область
10514,320865,1409,21,818,606,212,320865,Київська область
10515,320866,1530,19,814,659,155,320866,Київська область
10516,320867,1044,10,606,500,106,320867,Київська область
10517,320868,2197,42,1150,925,225,320868,Київська область
10518,320869,2051,26,1159,926,233,320869,Київська область
10519,320870,249,1,132,99,33,320870,Київська область
10520,320871,505,10,294,241,53,320871,Київська область
10521,320875,719,12,481,329,152,320875,Київська область
10522,320876,217,5,170,130,40,320876,Київська область
10523,320877,392,4,221,163,58,320877,Київська область
10524,320880,265,2,158,92,66,320880,Київська область
10525,320881,384,2,267,217,50,320881,Київська область
10526,320886,236,4,153,102,51,320886,Київська область
10527,320890,271,0,171,123,48,320890,Київська область
10528,320891,113,2,68,55,13,320891,Київська область
10529,320892,391,5,229,170,59,320892,Київська область
10530,320895,724,5,415,314,101,320895,Київська область
10531,320901,580,5,304,243,61,320901,Київська область
10532,320904,252,1,201,150,51,320904,Київська область
10533,320905,111,0,95,73,22,320905,Київська область
10534,320906,1386,28,863,638,225,320906,Київська область
10535,320907,252,1,192,143,49,320907,Київська область
10536,320908,169,1,101,72,29,320908,Київська область
10537,320909,24,0,22,16,6,320909,Київська область
10538,320910,363,3,191,145,46,320910,Київська область
10539,320911,806,7,513,390,123,320911,Київська область
10540,320912,506,2,334,267,67,320912,Київська область
10541,320913,417,2,272,198,74,320913,Київська область
10542,320914,550,12,350,245,105,320914,Київська область
10543,320915,717,10,441,352,89,320915,Київська область
10544,320916,627,8,434,335,99,320916,Київська область
10545,320917,255,7,158,112,46,320917,Київська область
10546,320918,829,8,495,377,118,320918,Київська область
10547,320919,832,16,496,374,122,320919,Київська область
10548,320920,207,3,158,136,22,320920,Київська область
10549,320921,653,8,411,291,120,320921,Київська область
10550,320922,550,14,336,254,82,320922,Київська область
10551,320923,269,9,168,115,53,320923,Київська область
10552,320924,343,1,236,181,55,320924,Київська область
10553,320925,1237,19,675,523,152,320925,Київська область
10554,320926,1150,10,622,475,147,320926,Київська область
10555,320927,372,6,212,153,59,320927,Київська область
10556,320928,297,8,200,133,67,320928,Київська область
10557,320929,2048,29,1142,861,281,320929,Київська область
10558,320930,1991,32,1119,852,267,320930,Київська область
10559,320931,2048,31,1098,868,230,320931,Київська область
10560,320932,452,8,313,230,83,320932,Київська область
10561,320933,402,8,243,141,102,320933,Київська область
10562,320934,342,8,185,126,59,320934,Київська область
10563,320935,71,0,64,27,37,320935,Київська область
10564,320936,500,5,321,214,107,320936,Київська область
10565,320937,398,6,261,183,78,320937,Київська область
10566,320938,504,6,320,256,64,320938,Київська область
10567,320939,1808,27,1093,842,251,320939,Київська область
10568,320940,1841,28,1126,871,255,320940,Київська область
10569,320941,1868,29,1130,844,286,320941,Київська область
10570,320942,1878,21,1069,786,283,320942,Київська область
10571,320943,1990,36,1209,864,345,320943,Київська область
10572,320944,976,10,578,395,183,320944,Київська область
10573,320945,334,0,196,139,57,320945,Київська область
10574,320946,439,3,317,224,93,320946,Київська область
10575,320947,306,2,200,135,65,320947,Київська область
10576,320948,146,4,100,68,32,320948,Київська область
10577,320949,374,10,215,183,32,320949,Київська область
10578,320950,546,3,286,237,49,320950,Київська область
10579,320951,386,4,263,222,41,320951,Київська область
10580,320952,1661,22,996,798,198,320952,Київська область
10581,320953,497,6,290,209,81,320953,Київська область
10582,320954,207,4,148,88,60,320954,Київська область
10583,320955,454,7,250,197,53,320955,Київська область
10584,320956,926,14,584,467,117,320956,Київська область
10585,320957,273,3,198,137,61,320957,Київська область
10586,320958,579,2,394,319,75,320958,Київська область
10587,320959,1769,11,869,728,141,320959,Київська область
10588,320960,478,0,293,225,68,320960,Київська область
10589,320961,472,5,305,239,66,320961,Київська область
10590,320962,479,3,307,247,60,320962,Київська область
10591,320963,533,17,318,226,92,320963,Київська область
10592,320964,612,4,387,284,103,320964,Київська область
10593,320965,377,7,260,190,70,320965,Київська область
10594,320966,261,5,181,148,33,320966,Київська область
10595,320967,275,9,196,150,46,320967,Київська область
10596,320968,127,5,80,60,20,320968,Київська область
10597,320969,884,10,416,281,135,320969,Київська область
10598,320970,467,4,327,211,116,320970,Київська область
10599,320971,134,1,83,57,26,320971,Київська область
10600,320972,34,0,33,26,7,320972,Київська область
10601,320973,367,2,204,143,61,320973,Київська область
10602,320974,511,6,341,264,77,320974,Київська область
10603,320975,400,5,253,206,47,320975,Київська область
10604,320976,126,0,94,63,31,320976,Київська область
10605,320977,487,7,316,183,133,320977,Київська область
10606,320978,582,5,380,263,117,320978,Київська область
10607,320979,266,1,181,135,46,320979,Київська область
10608,320980,1435,22,840,674,166,320980,Київська область
10609,320981,822,15,518,384,134,320981,Київська область
10610,320982,279,5,155,82,73,320982,Київська область
10611,320983,946,10,484,385,99,320983,Київська область
10612,320984,1412,11,698,542,156,320984,Київська область
10613,320985,476,3,321,262,59,320985,Київська область
10614,320986,271,3,191,120,71,320986,Київська область
10615,320987,437,10,308,239,69,320987,Київська область
10616,320988,169,1,104,89,15,320988,Київська область
10617,320989,232,3,154,104,50,320989,Київська область
10618,320990,540,6,314,241,73,320990,Київська область
10619,320991,176,5,112,66,46,320991,Київська область
10620,320992,576,10,359,256,103,320992,Київська область
10621,320993,793,12,444,305,139,320993,Київська область
10622,320994,375,6,227,171,56,320994,Київська область
10623,320995,543,6,310,268,42,320995,Київська область
10624,320996,551,7,333,260,73,320996,Київська область
10625,320997,556,8,392,225,167,320997,Київська область
10626,320998,402,5,262,204,58,320998,Київська область
10627,320999,713,22,412,293,119,320999,Київська область
10628,321000,480,6,287,203,84,321000,Київська область
10629,321001,194,1,128,96,32,321001,Київська область
10630,321002,2286,22,1274,993,281,321002,Київська область
10631,321003,2221,48,1267,1012,255,321003,Київська область
10632,321004,2310,17,1351,1107,244,321004,Київська область
10633,321005,2380,26,1291,1032,259,321005,Київська область
10634,321006,1923,17,1092,866,226,321006,Київська область
10635,321007,89,1,84,62,22,321007,Київська область
10636,321426,1181,16,737,571,166,321426,Київська область
10637,320094,1906,23,1151,915,236,320094,Київська область
10638,320095,1721,21,999,812,187,320095,Київська область
10639,320097,1416,19,897,678,219,320097,Київська область
10640,320098,2178,22,1381,1059,322,320098,Київська область
10641,320100,1984,27,1212,903,309,320100,Київська область
10642,320101,1344,0,1037,761,276,320101,Київська область
10643,320102,325,6,248,189,59,320102,Київська область
10644,320103,655,6,467,356,111,320103,Київська область
10645,320104,202,4,146,93,53,320104,Київська область
10646,320105,734,9,519,405,114,320105,Київська область
10647,320106,157,3,116,78,38,320106,Київська область
10648,320107,700,16,498,426,72,320107,Київська область
10649,320108,717,7,541,389,152,320108,Київська область
10650,320109,142,2,106,70,36,320109,Київська область
10651,320110,430,5,309,235,74,320110,Київська область
10652,320111,205,0,158,112,46,320111,Київська область
10653,320112,454,4,309,249,60,320112,Київська область
10654,320113,293,0,238,176,62,320113,Київська область
10655,320114,112,2,77,56,21,320114,Київська область
10656,320115,537,2,320,245,75,320115,Київська область
10657,320116,518,3,317,265,52,320116,Київська область
10658,320117,809,9,483,349,134,320117,Київська область
10659,320118,511,7,302,197,105,320118,Київська область
10660,320119,350,5,235,159,76,320119,Київська область
10661,320120,295,5,225,159,66,320120,Київська область
10662,320121,148,3,120,73,47,320121,Київська область
10663,320122,416,6,281,182,99,320122,Київська область
10664,320123,466,0,419,209,210,320123,Київська область
10665,320125,150,1,80,51,29,320125,Київська область
10666,320126,229,6,167,134,33,320126,Київська область
10667,320127,118,2,91,53,38,320127,Київська область
10668,320128,448,9,285,210,75,320128,Київська область
10669,320129,208,1,144,91,53,320129,Київська область
10670,320130,299,1,203,162,41,320130,Київська область
10671,320131,1087,9,622,511,111,320131,Київська область
10672,320132,273,5,213,156,57,320132,Київська область
10673,320133,101,0,87,72,15,320133,Київська область
10674,320134,389,4,280,210,70,320134,Київська область
10675,320135,71,0,57,35,22,320135,Київська область
10676,320136,38,1,37,27,10,320136,Київська область
10677,320519,2195,19,1259,977,282,320519,Київська область
10678,320520,1600,24,898,697,201,320520,Київська область
10679,320521,2400,54,1481,1129,352,320521,Київська область
10680,320522,2337,42,1485,1096,389,320522,Київська область
10681,320523,2420,33,1503,1122,381,320523,Київська область
10682,320524,321,3,202,155,47,320524,Київська область
10683,320525,148,1,114,79,35,320525,Київська область
10684,320526,178,2,129,95,34,320526,Київська область
10685,320527,909,13,582,402,180,320527,Київська область
10686,320528,154,1,116,86,30,320528,Київська область
10687,320529,563,5,375,279,96,320529,Київська область
10688,320530,295,25,226,92,134,320530,Київська область
10689,320531,471,7,310,234,76,320531,Київська область
10690,320532,384,5,228,142,86,320532,Київська область
10691,320533,337,4,193,142,51,320533,Київська область
10692,320534,339,5,243,194,49,320534,Київська область
10693,320535,74,1,59,33,26,320535,Київська область
10694,320536,409,3,299,212,87,320536,Київська область
10695,320538,211,1,165,115,50,320538,Київська область
10696,320539,119,0,96,64,32,320539,Київська область
10697,320540,385,8,273,188,85,320540,Київська область
10698,320541,522,9,347,202,145,320541,Київська область
10699,320542,833,11,583,461,122,320542,Київська область
10700,320543,249,1,158,95,63,320543,Київська область
10701,320544,1118,17,662,490,172,320544,Київська область
10702,320545,286,9,179,130,49,320545,Київська область
10703,320546,111,1,96,66,30,320546,Київська область
10704,320547,1323,10,891,632,259,320547,Київська область
10705,320548,1022,19,660,490,170,320548,Київська область
10706,320549,1415,20,870,601,269,320549,Київська область
10707,320550,360,1,257,186,71,320550,Київська область
10708,320551,366,0,275,219,56,320551,Київська область
10709,320552,449,6,310,202,108,320552,Київська область
10710,320553,797,15,483,366,117,320553,Київська область
10711,320554,398,5,277,186,91,320554,Київська область
10712,320555,464,5,369,154,215,320555,Київська область
10713,320556,92,1,84,43,41,320556,Київська область
10714,320557,177,1,130,93,37,320557,Київська область
10715,320558,91,1,87,81,6,320558,Київська область
10716,320696,656,10,394,320,74,320696,Київська область
10717,320697,2320,33,1471,1170,301,320697,Київська область
10718,320698,2259,24,1430,1125,305,320698,Київська область
10719,320699,1022,15,637,496,141,320699,Київська область
10720,320700,1412,27,838,698,140,320700,Київська область
10721,320701,813,16,509,432,77,320701,Київська область
10722,320702,1998,21,1192,996,196,320702,Київська область
10723,320703,71,1,40,27,13,320703,Київська область
10724,320704,403,6,246,179,67,320704,Київська область
10725,320705,1375,11,894,760,134,320705,Київська область
10726,320706,380,3,246,187,59,320706,Київська область
10727,320707,147,0,114,81,33,320707,Київська область
10728,320708,71,0,39,28,11,320708,Київська область
10729,320709,341,2,252,187,65,320709,Київська область
10730,320710,932,12,512,413,99,320710,Київська область
10731,320711,499,5,284,244,40,320711,Київська область
10732,320712,2032,13,1254,827,427,320712,Київська область
10733,320713,633,8,378,276,102,320713,Київська область
10734,320714,944,5,611,536,75,320714,Київська область
10735,320715,176,2,114,93,21,320715,Київська область
10736,320716,153,2,102,74,28,320716,Київська область
10737,320717,572,14,335,222,113,320717,Київська область
10738,320718,129,1,83,64,19,320718,Київська область
10739,320720,540,1,336,285,51,320720,Київська область
10740,320721,579,6,359,307,52,320721,Київська область
10741,320722,375,3,266,193,73,320722,Київська область
10742,320723,770,5,438,345,93,320723,Київська область
10743,320724,178,3,113,80,33,320724,Київська область
10744,320725,396,3,242,192,50,320725,Київська область
10745,320726,774,9,520,432,88,320726,Київська область
10746,320727,871,10,523,411,112,320727,Київська область
10747,320728,1060,13,667,537,130,320728,Київська область
10748,320729,688,5,416,330,86,320729,Київська область
10749,320730,221,2,161,127,34,320730,Київська область
10750,320731,1514,32,902,693,209,320731,Київська область
10751,320733,504,5,316,258,58,320733,Київська область
10752,320734,604,4,370,301,69,320734,Київська область
10753,320735,198,0,141,103,38,320735,Київська область
10754,320736,32,0,32,27,5,320736,Київська область
10755,320832,2100,48,1270,1011,259,320832,Київська область
10756,320833,2211,36,1305,1046,259,320833,Київська область
10757,320834,2060,30,1161,934,227,320834,Київська область
10758,320835,1756,27,998,774,224,320835,Київська область
10759,320836,518,4,304,257,47,320836,Київська область
10760,320837,1292,14,741,578,163,320837,Київська область
10761,320838,418,8,279,194,85,320838,Київська область
10762,320839,226,3,145,87,58,320839,Київська область
10763,320840,550,5,354,277,77,320840,Київська область
10764,320841,1551,13,946,761,185,320841,Київська область
10765,320842,767,11,420,303,117,320842,Київська область
10766,320843,202,2,113,83,30,320843,Київська область
10767,320844,192,1,143,101,42,320844,Київська область
10768,320845,266,0,185,125,60,320845,Київська область
10769,320846,293,5,180,108,72,320846,Київська область
10770,320847,1344,21,651,480,171,320847,Київська область
10771,320848,781,13,440,344,96,320848,Київська область
10772,320849,1422,14,865,715,150,320849,Київська область
10773,320850,766,16,457,339,118,320850,Київська область
10774,320851,622,11,369,247,122,320851,Київська область
10775,320852,239,3,148,102,46,320852,Київська область
10776,320853,522,8,359,284,75,320853,Київська область
10777,320854,286,2,185,125,60,320854,Київська область
10778,320855,768,12,501,349,152,320855,Київська область
10779,320856,1232,14,756,587,169,320856,Київська область
10780,320857,1249,19,710,559,151,320857,Київська область
10781,320858,885,6,439,318,121,320858,Київська область
10782,320859,309,8,167,126,41,320859,Київська область
10783,320860,477,3,282,205,77,320860,Київська область
10784,320861,22,0,21,13,8,320861,Київська область
10785,321339,2189,23,1173,836,337,321339,Київська область
10786,321342,1465,18,902,650,252,321342,Київська область
10787,321343,976,20,631,462,169,321343,Київська область
10788,321344,909,19,540,394,146,321344,Київська область
10789,321345,2011,29,1267,965,302,321345,Київська область
10790,321346,852,1,544,420,124,321346,Київська область
10791,321347,1803,31,1131,862,269,321347,Київська область
10792,321349,829,11,478,361,117,321349,Київська область
10793,321350,1897,25,1199,919,280,321350,Київська область
10794,321354,855,15,556,386,170,321354,Київська область
10795,321355,1210,13,772,547,225,321355,Київська область
10796,321356,1051,13,651,488,163,321356,Київська область
10797,321357,676,18,423,319,104,321357,Київська область
10798,321358,543,0,387,288,99,321358,Київська область
10799,321359,122,1,119,89,30,321359,Київська область
10800,321360,2166,31,1292,973,319,321360,Київська область
10801,321361,1708,30,1078,775,303,321361,Київська область
10802,321362,1598,19,915,753,162,321362,Київська область
10803,321363,400,3,293,206,87,321363,Київська область
10804,321401,52,1,38,30,8,321401,Київська область
10805,320278,853,7,500,382,118,320278,Київська область
10806,320279,297,5,219,157,62,320279,Київська область
10807,320280,478,2,290,219,71,320280,Київська область
10808,320281,582,11,394,317,77,320281,Київська область
10809,320282,522,10,350,273,77,320282,Київська область
10810,320283,335,1,304,76,228,320283,Київська область
10811,320284,314,4,203,143,60,320284,Київська область
10812,320285,339,5,213,150,63,320285,Київська область
10813,320286,2377,38,1664,973,691,320286,Київська область
10814,320287,1784,38,1153,732,421,320287,Київська область
10815,320288,2154,30,1407,975,432,320288,Київська область
10816,320289,1823,38,1128,821,307,320289,Київська область
10817,320290,1406,19,888,724,164,320290,Київська область
10818,320291,1283,9,768,582,186,320291,Київська область
10819,320292,1261,15,798,561,237,320292,Київська область
10820,320293,1440,20,934,657,277,320293,Київська область
10821,320294,1489,25,1015,705,310,320294,Київська область
10822,320295,1251,8,689,517,172,320295,Київська область
10823,320296,265,4,196,148,48,320296,Київська область
10824,320297,1019,7,657,450,207,320297,Київська область
10825,320298,1662,33,1134,801,333,320298,Київська область
10826,320299,721,10,435,328,107,320299,Київська область
10827,320300,1081,14,619,503,116,320300,Київська область
10828,320301,656,9,444,318,126,320301,Київська область
10829,320302,959,11,630,398,232,320302,Київська область
10830,320303,1695,17,1110,757,353,320303,Київська область
10831,320304,1660,20,1113,754,359,320304,Київська область
10832,320305,1391,17,856,593,263,320305,Київська область
10833,320306,1138,21,958,394,564,320306,Київська область
10834,320307,986,8,668,510,158,320307,Київська область
10835,320308,1301,15,804,582,222,320308,Київська область
10836,320309,339,5,206,137,69,320309,Київська область
10837,320310,989,9,655,520,135,320310,Київська область
10838,320311,170,2,141,112,29,320311,Київська область
10839,320312,233,4,137,95,42,320312,Київська область
10840,320313,757,3,457,336,121,320313,Київська область
10841,320314,184,1,155,98,57,320314,Київська область
10842,320315,196,2,163,113,50,320315,Київська область
10843,320316,1215,23,679,520,159,320316,Київська область
10844,320317,717,50,526,256,270,320317,Київська область
10845,320318,1266,17,805,572,233,320318,Київська область
10846,320319,564,5,413,286,127,320319,Київська область
10847,320320,108,0,73,45,28,320320,Київська область
10848,320321,323,2,211,130,81,320321,Київська область
10849,320322,1244,13,677,482,195,320322,Київська область
10850,320323,748,14,375,283,92,320323,Київська область
10851,320324,679,8,332,230,102,320324,Київська область
10852,320325,466,10,292,220,72,320325,Київська область
10853,320326,868,10,679,556,123,320326,Київська область
10854,320327,314,0,223,166,57,320327,Київська область
10855,320328,2246,30,1361,978,383,320328,Київська область
10856,320329,429,8,306,193,113,320329,Київська область
10857,320330,275,5,223,86,137,320330,Київська область
10858,320331,1346,14,824,677,147,320331,Київська область
10859,320332,566,4,349,287,62,320332,Київська область
10860,320333,347,5,272,167,105,320333,Київська область
10861,320334,460,6,268,196,72,320334,Київська область
10862,320335,145,0,118,80,38,320335,Київська область
10863,320336,1326,15,951,622,329,320336,Київська область
10864,320337,1230,19,798,619,179,320337,Київська область
10865,320338,195,0,139,99,40,320338,Київська область
10866,320339,523,3,430,246,184,320339,Київська область
10867,320340,530,23,503,388,115,320340,Київська область
10868,320341,147,3,139,100,39,320341,Київська область
10869,320737,759,12,516,392,124,320737,Київська область
10870,320738,245,3,175,104,71,320738,Київська область
10871,320739,608,5,382,235,147,320739,Київська область
10872,320740,1327,19,841,593,248,320740,Київська область
10873,320741,1433,16,939,702,237,320741,Київська область
10874,320742,581,8,332,248,84,320742,Київська область
10875,320743,365,4,237,171,66,320743,Київська область
10876,320744,455,6,285,228,57,320744,Київська область
10877,320745,322,6,211,144,67,320745,Київська область
10878,320746,347,6,217,157,60,320746,Київська область
10879,320747,54,0,42,18,24,320747,Київська область
10880,320748,638,7,408,278,130,320748,Київська область
10881,320749,1990,37,1374,946,428,320749,Київська область
10882,320750,1280,15,801,582,219,320750,Київська область
10883,320751,410,7,242,175,67,320751,Київська область
10884,320752,510,9,332,247,85,320752,Київська область
10885,320753,1205,12,664,463,201,320753,Київська область
10886,320754,435,7,309,227,82,320754,Київська область
10887,320755,103,0,80,62,18,320755,Київська область
10888,320756,505,7,321,231,90,320756,Київська область
10889,320757,254,6,158,95,63,320757,Київська область
10890,320758,393,7,267,202,65,320758,Київська область
10891,320759,961,17,612,443,169,320759,Київська область
10892,320760,438,4,285,194,91,320760,Київська область
10893,320761,113,0,81,57,24,320761,Київська область
10894,320762,734,11,453,336,117,320762,Київська область
10895,320763,276,3,176,119,57,320763,Київська область
10896,320764,2261,27,1310,946,364,320764,Київська область
10897,320765,588,8,391,271,120,320765,Київська область
10898,320766,209,7,144,96,48,320766,Київська область
10899,320767,1748,35,1242,874,368,320767,Київська область
10900,320768,1961,33,1379,911,468,320768,Київська область
10901,320769,1475,28,988,724,264,320769,Київська область
10902,320770,2167,51,1485,980,505,320770,Київська область
10903,320771,2099,30,1339,931,408,320771,Київська область
10904,320772,1553,35,1035,715,320,320772,Київська область
10905,320773,2306,41,1525,1098,427,320773,Київська область
10906,320774,7,0,6,5,1,320774,Київська область
10907,321271,1977,32,1348,966,382,321271,Київська область
10908,321272,2406,21,1513,1087,426,321272,Київська область
10909,321273,2079,23,1130,864,266,321273,Київська область
10910,321274,2204,28,1364,963,401,321274,Київська область
10911,321275,1467,14,935,685,250,321275,Київська область
10912,321276,1830,28,1079,746,333,321276,Київська область
10913,321277,1664,24,1064,755,309,321277,Київська область
10914,321278,1524,23,1012,686,326,321278,Київська область
10915,321279,2136,32,1253,870,383,321279,Київська область
10916,321280,2154,30,1270,934,336,321280,Київська область
10917,321281,2291,27,1364,975,389,321281,Київська область
10918,321282,2091,26,1266,888,378,321282,Київська область
10919,321283,1433,24,855,639,216,321283,Київська область
10920,321284,1374,15,861,674,187,321284,Київська область
10921,321285,2302,42,1429,1050,379,321285,Київська область
10922,321286,1094,17,771,529,242,321286,Київська область
10923,321287,2200,44,1453,1041,412,321287,Київська область
10924,321288,99,1,95,61,34,321288,Київська область
10925,321323,2289,38,1576,1086,490,321323,Київська область
10926,321324,2119,34,1469,1005,464,321324,Київська область
10927,321325,2151,42,1500,1080,420,321325,Київська область
10928,321326,2305,48,1580,1054,526,321326,Київська область
10929,321327,2426,45,1610,1040,570,321327,Київська область
10930,321328,2215,34,1466,1020,446,321328,Київська область
10931,321329,2374,40,1604,1102,502,321329,Київська область
10932,321330,1957,35,1280,882,398,321330,Київська область
10933,321331,1844,33,1327,898,429,321331,Київська область
10934,321332,2476,40,1571,1099,472,321332,Київська область
10935,321333,2391,25,1471,986,485,321333,Київська область
10936,321334,2440,40,1511,1076,435,321334,Київська область
10937,321335,2255,40,1437,1060,377,321335,Київська область
10938,321336,91,1,60,46,14,321336,Київська область
10939,321337,410,2,298,211,87,321337,Київська область
10940,321417,1395,18,933,645,288,321417,Київська область
10941,320559,2170,21,1196,852,344,320559,Київська область
10942,320560,2103,24,1236,905,331,320560,Київська область
10943,320561,1577,23,968,646,322,320561,Київська область
10944,320563,465,7,316,199,117,320563,Київська область
10945,320564,1569,31,963,717,246,320564,Київська область
10946,320565,1267,21,709,506,203,320565,Київська область
10947,320566,1042,24,628,431,197,320566,Київська область
10948,320567,1378,22,885,535,350,320567,Київська область
10949,320568,1174,27,795,506,289,320568,Київська область
10950,320569,2133,33,1401,881,520,320569,Київська область
10951,320570,1719,29,1095,668,427,320570,Київська область
10952,320571,2085,44,1307,825,482,320571,Київська область
10953,320572,2005,38,1295,777,518,320572,Київська область
10954,320573,2110,37,1317,844,473,320573,Київська область
10955,320574,1899,40,1157,780,377,320574,Київська область
10956,320575,1968,42,1240,786,454,320575,Київська область
10957,320576,1803,26,1078,708,370,320576,Київська область
10958,320577,2198,53,1316,865,451,320577,Київська область
10959,320583,2090,47,1133,818,315,320583,Київська область
10960,320584,2050,51,1293,836,457,320584,Київська область
10961,320585,2091,44,1338,889,449,320585,Київська область
10962,320586,2080,40,1331,864,467,320586,Київська область
10963,320587,1931,42,1307,820,487,320587,Київська область
10964,320588,1943,38,1281,822,459,320588,Київська область
10965,320589,1957,33,1247,784,463,320589,Київська область
10966,320590,1855,28,1067,713,354,320590,Київська область
10967,320591,2382,41,1487,951,536,320591,Київська область
10968,320592,2269,35,1433,965,468,320592,Київська область
10969,320593,2068,22,1162,802,360,320593,Київська область
10970,320594,2504,40,1633,1052,581,320594,Київська область
10971,320595,2353,46,1521,960,561,320595,Київська область
10972,320596,2591,28,1566,1023,543,320596,Київська область
10973,320599,2346,21,1501,1013,488,320599,Київська область
10974,320600,815,4,473,339,134,320600,Київська область
10975,320601,384,4,231,165,66,320601,Київська область
10976,320602,2066,28,1199,886,313,320602,Київська область
10977,320603,1920,29,1039,752,287,320603,Київська область
10978,320604,585,4,340,252,88,320604,Київська область
10979,320605,2042,26,1365,943,422,320605,Київська область
10980,320606,1228,13,793,492,301,320606,Київська область
10981,320610,2137,20,1394,974,420,320610,Київська область
10982,320611,2401,30,1524,1013,511,320611,Київська область
10983,320615,915,11,574,430,144,320615,Київська область
10984,320616,2418,18,1322,952,370,320616,Київська область
10985,320619,2367,33,1474,933,541,320619,Київська область
10986,320620,2462,33,1512,960,552,320620,Київська область
10987,320621,2486,34,1541,1038,503,320621,Київська область
10988,320622,2405,35,1680,1054,626,320622,Київська область
10989,320623,2171,35,1492,789,703,320623,Київська область
10990,320625,2273,24,1394,907,487,320625,Київська область
10991,320626,1457,12,846,611,235,320626,Київська область
10992,320627,2079,31,1285,862,423,320627,Київська область
10993,320641,518,1,276,209,67,320641,Київська область
10994,320643,12,0,8,5,3,320643,Київська область
10995,320644,7,1,5,5,0,320644,Київська область
10996,321289,1960,42,1263,853,410,321289,Київська область
10997,321290,2605,46,1637,1046,591,321290,Київська область
10998,321291,2413,41,1546,1080,466,321291,Київська область
10999,321292,2511,44,1673,1112,561,321292,Київська область
11000,321293,2121,53,1349,825,524,321293,Київська область
11001,321294,2568,30,1617,1065,552,321294,Київська область
11002,321295,2535,46,1629,1125,504,321295,Київська область
11003,321296,2485,48,1655,1104,551,321296,Київська область
11004,321297,2545,51,1695,1096,599,321297,Київська область
11005,321298,2475,42,1551,967,584,321298,Київська область
11006,321299,2527,44,1615,1068,547,321299,Київська область
11007,321300,2665,33,1669,1105,564,321300,Київська область
11008,321301,2513,33,1661,1101,560,321301,Київська область
11009,321302,2481,36,1453,1022,431,321302,Київська область
11010,321303,2765,36,1841,1174,667,321303,Київська область
11011,321304,2635,36,1743,1101,642,321304,Київська область
11012,321305,899,10,551,364,187,321305,Київська область
11013,321306,2357,36,1539,979,560,321306,Київська область
11014,321307,1635,26,974,680,294,321307,Київська область
11015,321308,890,9,570,406,164,321308,Київська область
11016,321309,2152,40,1331,906,425,321309,Київська область
11017,321310,2035,38,1173,847,326,321310,Київська область
11018,321311,2323,32,1433,933,500,321311,Київська область
11019,321312,2284,23,1430,1046,384,321312,Київська область
11020,321313,970,13,557,391,166,321313,Київська область
11021,321314,2286,28,1397,847,550,321314,Київська область
11022,321315,1976,25,1291,796,495,321315,Київська область
11023,321316,1705,27,1093,660,433,321316,Київська область
11024,321317,2163,38,1466,920,546,321317,Київська область
11025,321318,2089,60,1320,890,430,321318,Київська область
11026,321319,2521,42,1717,1049,668,321319,Київська область
11027,321320,103,6,97,75,22,321320,Київська область
11028,321321,682,31,650,602,48,321321,Київська область
11029,321322,118,4,111,104,7,321322,Київська область
11030,321402,1527,20,985,623,362,321402,Київська область
11031,321403,1240,22,766,491,275,321403,Київська область
11032,321404,2069,43,1181,784,397,321404,Київська область
11033,321405,2452,38,1735,1065,670,321405,Київська область
11034,321406,2072,16,1335,790,545,321406,Київська область
11035,321407,2698,31,1810,1098,712,321407,Київська область
11036,321411,2333,50,1638,1137,501,321411,Київська область
11037,321412,2647,23,1723,1008,715,321412,Київська область
11038,321413,2011,44,1305,812,493,321413,Київська область
11039,321414,1078,13,711,450,261,321414,Київська область
11040,321415,1930,12,1285,775,510,321415,Київська область
11041,321416,1390,11,905,522,383,321416,Київська область
11042,321421,2496,19,1445,941,504,321421,Київська область
11043,321422,1121,16,717,486,231,321422,Київська область
11044,321423,2343,20,1596,936,660,321423,Київська область
11045,321424,2140,24,1414,881,533,321424,Київська область
11046,321427,2331,35,1589,965,624,321427,Київська область
11047,321428,1616,6,1047,682,365,321428,Київська область
11048,321429,1487,14,930,517,413,321429,Київська область
11049,1,6,0,6,5,1,1,Київська область
11050,320182,1079,13,579,467,112,320182,Київська область
11051,320183,1015,15,560,455,105,320183,Київська область
11052,320184,242,1,128,108,20,320184,Київська область
11053,320185,2201,37,1335,1013,322,320185,Київська область
11054,320186,2093,24,1244,948,296,320186,Київська область
11055,320187,2178,30,1360,1048,312,320187,Київська область
11056,320188,2144,33,1303,964,339,320188,Київська область
11057,320189,1668,28,1051,791,260,320189,Київська область
11058,320190,1652,12,968,714,254,320190,Київська область
11059,320191,2275,31,1357,952,405,320191,Київська область
11060,320192,1940,37,1313,875,438,320192,Київська область
11061,320193,1916,23,1230,877,353,320193,Київська область
11062,320194,1650,20,923,658,265,320194,Київська область
11063,320195,1937,23,1060,819,241,320195,Київська область
11064,320196,1685,28,962,755,207,320196,Київська область
11065,320197,86,0,62,44,18,320197,Київська область
11066,320198,861,10,564,452,112,320198,Київська область
11067,320199,1433,21,819,662,157,320199,Київська область
11068,320200,128,0,101,82,19,320200,Київська область
11069,320201,128,0,93,59,34,320201,Київська область
11070,320202,1555,16,804,656,148,320202,Київська область
11071,320203,602,5,363,266,97,320203,Київська область
11072,320204,159,2,111,80,31,320204,Київська область
11073,320205,790,5,531,407,124,320205,Київська область
11074,320206,385,4,211,170,41,320206,Київська область
11075,320207,183,0,104,62,42,320207,Київська область
11076,320208,66,0,45,36,9,320208,Київська область
11077,320209,810,19,555,403,152,320209,Київська область
11078,320210,295,1,193,105,88,320210,Київська область
11079,320211,940,15,608,427,181,320211,Київська область
11080,320212,570,6,321,242,79,320212,Київська область
11081,320213,883,10,563,431,132,320213,Київська область
11082,320214,2118,27,1327,1001,326,320214,Київська область
11083,320215,489,3,280,210,70,320215,Київська область
11084,320216,117,0,78,47,31,320216,Київська область
11085,320217,182,1,131,101,30,320217,Київська область
11086,320218,268,7,153,120,33,320218,Київська область
11087,320219,647,12,341,252,89,320219,Київська область
11088,320220,1061,6,837,694,143,320220,Київська область
11089,320221,394,5,308,237,71,320221,Київська область
11090,320222,677,9,501,406,95,320222,Київська область
11091,320223,1086,17,659,543,116,320223,Київська область
11092,320224,621,8,387,262,125,320224,Київська область
11093,320225,28,0,26,17,9,320225,Київська область
11094,320342,2546,47,1681,1060,621,320342,Київська область
11095,320343,2446,35,1680,1039,641,320343,Київська область
11096,320344,2427,44,1724,1087,637,320344,Київська область
11097,320345,2533,39,1785,1163,622,320345,Київська область
11098,320346,2364,48,1529,997,532,320346,Київська область
11099,320347,2598,32,1850,1151,699,320347,Київська область
11100,320348,2464,33,1647,1103,544,320348,Київська область
11101,320349,2309,42,1605,981,624,320349,Київська область
11102,320350,2251,47,1496,934,562,320350,Київська область
11103,320351,1893,39,1341,923,418,320351,Київська область
11104,320352,2260,36,1349,972,377,320352,Київська область
11105,320353,2131,35,1230,924,306,320353,Київська область
11106,320354,502,4,311,220,91,320354,Київська область
11107,320355,211,3,140,121,19,320355,Київська область
11108,320356,153,2,96,69,27,320356,Київська область
11109,320357,123,2,73,45,28,320357,Київська область
11110,320358,180,3,146,113,33,320358,Київська область
11111,320359,182,0,154,119,35,320359,Київська область
11112,320360,578,6,380,291,89,320360,Київська область
11113,320361,616,6,355,243,112,320361,Київська область
11114,320362,1334,19,800,617,183,320362,Київська область
11115,320363,335,3,195,159,36,320363,Київська область
11116,320364,691,12,414,339,75,320364,Київська область
11117,320365,1645,38,961,699,262,320365,Київська область
11118,320366,1214,14,723,535,188,320366,Київська область
11119,320367,644,13,409,313,96,320367,Київська область
11120,320368,1952,8,1109,813,296,320368,Київська область
11121,320369,1164,2,658,509,149,320369,Київська область
11122,320370,63,0,45,36,9,320370,Київська область
11123,320371,1326,13,762,592,170,320371,Київська область
11124,320372,1023,7,655,474,181,320372,Київська область
11125,320373,1035,11,661,498,163,320373,Київська область
11126,320374,299,2,196,141,55,320374,Київська область
11127,320375,340,4,172,132,40,320375,Київська область
11128,320376,2098,36,1390,986,404,320376,Київська область
11129,320377,146,1,121,66,55,320377,Київська область
11130,320378,1013,11,602,441,161,320378,Київська область
11131,320379,2274,42,1487,1013,474,320379,Київська область
11132,320380,2035,31,1299,930,369,320380,Київська область
11133,320381,1798,31,1206,872,334,320381,Київська область
11134,320382,1253,26,784,559,225,320382,Київська область
11135,320383,611,9,440,317,123,320383,Київська область
11136,320384,479,10,339,261,78,320384,Київська область
11137,320385,412,2,282,192,90,320385,Київська область
11138,320386,384,2,246,195,51,320386,Київська область
11139,320387,993,11,584,452,132,320387,Київська область
11140,320388,430,9,239,185,54,320388,Київська область
11141,320389,1658,25,1069,801,268,320389,Київська область
11142,320390,157,1,123,95,28,320390,Київська область
11143,320391,266,3,182,122,60,320391,Київська область
11144,320392,265,0,206,161,45,320392,Київська область
11145,320393,194,4,133,107,26,320393,Київська область
11146,320394,1054,12,747,562,185,320394,Київська область
11147,320395,303,6,187,134,53,320395,Київська область
11148,320396,43,0,43,26,17,320396,Київська область
11149,320397,54,4,42,31,11,320397,Київська область
11150,320461,2234,29,1369,954,415,320461,Київська область
11151,320462,2158,32,1310,930,380,320462,Київська область
11152,320463,2116,25,1278,923,355,320463,Київська область
11153,320464,1917,16,1197,776,421,320464,Київська область
11154,320465,990,8,518,368,150,320465,Київська область
11155,320466,843,18,470,345,125,320466,Київська область
11156,320467,317,7,224,172,52,320467,Київська область
11157,320468,1016,14,789,495,294,320468,Київська область
11158,320469,700,3,429,313,116,320469,Київська область
11159,320470,555,4,326,253,73,320470,Київська область
11160,320471,562,5,315,236,79,320471,Київська область
11161,320472,446,3,283,197,86,320472,Київська область
11162,320473,498,3,292,214,78,320473,Київська область
11163,320474,449,15,255,196,59,320474,Київська область
11164,320475,383,2,260,202,58,320475,Київська область
11165,320476,822,4,442,365,77,320476,Київська область
11166,320477,360,7,219,169,50,320477,Київська область
11167,320478,292,4,157,114,43,320478,Київська область
11168,320479,306,2,195,154,41,320479,Київська область
11169,320480,305,3,174,141,33,320480,Київська область
11170,320481,360,3,276,239,37,320481,Київська область
11171,320482,356,5,208,145,63,320482,Київська область
11172,320483,279,5,173,112,61,320483,Київська область
11173,320484,287,0,178,141,37,320484,Київська область
11174,320485,259,3,134,81,53,320485,Київська область
11175,320486,352,2,186,136,50,320486,Київська область
11176,320487,233,4,127,87,40,320487,Київська область
11177,320488,237,0,150,81,69,320488,Київська область
11178,320489,253,4,164,104,60,320489,Київська область
11179,320490,243,2,157,110,47,320490,Київська область
11180,320491,205,5,105,80,25,320491,Київська область
11181,320492,69,1,46,30,16,320492,Київська область
11182,320493,208,0,151,87,64,320493,Київська область
11183,320494,181,0,101,67,34,320494,Київська область
11184,320495,143,2,94,60,34,320495,Київська область
11185,320496,221,1,142,114,28,320496,Київська область
11186,320497,132,0,94,45,49,320497,Київська область
11187,320498,190,3,107,69,38,320498,Київська область
11188,320499,141,1,91,65,26,320499,Київська область
11189,320500,125,7,83,42,41,320500,Київська область
11190,320501,119,0,76,58,18,320501,Київська область
11191,320502,114,1,82,43,39,320502,Київська область
11192,320503,117,2,74,48,26,320503,Київська область
11193,320504,151,0,67,48,19,320504,Київська область
11194,320505,161,2,102,83,19,320505,Київська область
11195,320506,108,1,66,48,18,320506,Київська область
11196,320507,89,1,56,40,16,320507,Київська область
11197,320508,77,1,55,34,21,320508,Київська область
11198,320509,146,2,115,58,57,320509,Київська область
11199,320510,141,0,96,61,35,320510,Київська область
11200,320511,94,0,69,50,19,320511,Київська область
11201,320512,78,0,56,41,15,320512,Київська область
11202,320513,73,0,46,31,15,320513,Київська область
11203,320514,81,1,56,26,30,320514,Київська область
11204,320515,60,0,30,25,5,320515,Київська область
11205,320516,53,0,29,21,8,320516,Київська область
11206,320517,52,1,33,25,8,320517,Київська область
11207,320518,35,1,33,19,14,320518,Київська область
11208,320817,609,6,342,238,104,320817,Київська область
11209,320818,292,1,165,145,20,320818,Київська область
11210,320819,350,0,181,134,47,320819,Київська область
11211,320820,335,5,234,153,81,320820,Київська область
11212,320821,209,4,141,105,36,320821,Київська область
11213,320822,386,3,237,186,51,320822,Київська область
11214,320823,420,9,235,168,67,320823,Київська область
11215,320824,291,3,207,149,58,320824,Київська область
11216,320825,290,2,215,172,43,320825,Київська область
11217,320826,141,3,96,74,22,320826,Київська область
11218,320827,301,7,170,121,49,320827,Київська область
11219,320828,682,4,389,290,99,320828,Київська область
11220,320829,133,2,88,58,30,320829,Київська область
11221,320830,104,1,64,44,20,320830,Київська область
11222,320831,15,0,12,6,6,320831,Київська область
11223,321259,832,20,550,340,210,321259,Київська область
11224,321260,2361,26,1592,1027,565,321260,Київська область
11225,321261,2118,37,1345,894,451,321261,Київська область
11226,321262,1516,29,1008,646,362,321262,Київська область
11227,321263,2207,31,1519,1003,516,321263,Київська область
11228,321264,2319,50,1509,1024,485,321264,Київська область
11229,321265,1444,18,933,610,323,321265,Київська область
11230,321266,2169,41,1435,946,489,321266,Київська область
11231,321267,2382,33,1583,1077,506,321267,Київська область
11232,321268,2187,42,1348,926,422,321268,Київська область
11233,321269,2214,41,1401,930,471,321269,Київська область
11234,321270,2468,48,1666,1092,574,321270,Київська область
11235,321364,2244,42,1375,1106,269,321364,Київська область
11236,321365,2298,38,1365,1149,216,321365,Київська область
11237,321366,2258,44,1401,1095,306,321366,Київська область
11238,321367,2147,27,1289,1072,217,321367,Київська область
11239,321368,2214,24,1342,1107,235,321368,Київська область
11240,321369,2376,30,1454,1202,252,321369,Київська область
11241,321370,2239,25,1335,1115,220,321370,Київська область
11242,321371,2078,34,1225,1027,198,321371,Київська область
11243,321372,22,0,21,20,1,321372,Київська область
11244,321399,2284,35,1389,851,538,321399,Київська область
11245,321400,1040,27,679,499,180,321400,Київська область
11246,321408,1363,21,909,612,297,321408,Київська область
11247,321409,2118,26,1430,959,471,321409,Київська область
11248,321410,2140,33,1446,895,551,321410,Київська область
11249,321420,965,20,714,535,179,321420,Київська область
11250,321430,907,18,605,404,201,321430,Київська область
11251,320001,1920,30,1166,840,326,320001,Київська область
11252,320002,1905,26,1160,829,331,320002,Київська область
11253,320003,2216,34,1452,995,457,320003,Київська область
11254,320004,1074,14,672,469,203,320004,Київська область
11255,320005,1983,36,1149,937,212,320005,Київська область
11256,320006,602,13,371,257,114,320006,Київська область
11257,320007,662,3,417,321,96,320007,Київська область
11258,320008,847,12,421,333,88,320008,Київська область
11259,320009,1191,11,644,475,169,320009,Київська область
11260,320010,325,1,204,152,52,320010,Київська область
11261,320011,677,13,424,298,126,320011,Київська область
11262,320012,378,10,238,196,42,320012,Київська область
11263,320013,1213,8,756,567,189,320013,Київська область
11264,320014,758,5,393,294,99,320014,Київська область
11265,320015,1045,20,554,429,125,320015,Київська область
11266,320016,908,15,509,390,119,320016,Київська область
11267,320017,513,6,332,227,105,320017,Київська область
11268,320018,221,1,139,92,47,320018,Київська область
11269,320019,1875,39,1093,805,288,320019,Київська область
11270,320020,962,11,568,459,109,320020,Київська область
11271,320021,432,3,234,168,66,320021,Київська область
11272,320022,317,0,192,120,72,320022,Київська область
11273,320023,999,11,604,383,221,320023,Київська область
11274,320024,579,4,365,263,102,320024,Київська область
11275,320025,548,4,331,242,89,320025,Київська область
11276,320026,1235,12,771,646,125,320026,Київська область
11277,320027,472,6,292,227,65,320027,Київська область
11278,320028,163,4,113,87,26,320028,Київська область
11279,320029,886,8,557,421,136,320029,Київська область
11280,320030,715,12,441,334,107,320030,Київська область
11281,320031,953,8,594,483,111,320031,Київська область
11282,320032,303,4,182,149,33,320032,Київська область
11283,320033,905,7,492,394,98,320033,Київська область
11284,320034,123,0,90,81,9,320034,Київська область
11285,320035,99,1,63,52,11,320035,Київська область
11286,320036,603,7,370,279,91,320036,Київська область
11287,320226,1522,19,865,716,149,320226,Київська область
11288,320227,90,2,72,51,21,320227,Київська область
11289,320228,2313,32,1339,1034,305,320228,Київська область
11290,320229,450,5,268,223,45,320229,Київська область
11291,320230,1825,24,1044,819,225,320230,Київська область
11292,320231,1679,3,919,760,159,320231,Київська область
11293,320232,2252,26,1298,1089,209,320232,Київська область
11294,320233,2289,30,1333,1107,226,320233,Київська область
11295,320234,1713,9,997,761,236,320234,Київська область
11296,320235,1085,16,507,385,122,320235,Київська область
11297,320236,898,14,493,403,90,320236,Київська область
11298,320237,203,2,109,92,17,320237,Київська область
11299,320238,1446,17,850,642,208,320238,Київська область
11300,320239,260,0,156,120,36,320239,Київська область
11301,320240,84,0,46,35,11,320240,Київська область
11302,320241,108,1,83,58,25,320241,Київська область
11303,320242,555,6,317,253,64,320242,Київська область
11304,320243,952,27,499,353,146,320243,Київська область
11305,320244,1940,27,1246,885,361,320244,Київська область
11306,320245,1985,36,1255,965,290,320245,Київська область
11307,320246,1651,22,1086,854,232,320246,Київська область
11308,320247,1006,14,658,508,150,320247,Київська область
11309,320248,2170,31,1229,961,268,320248,Київська область
11310,320249,1759,18,1038,792,246,320249,Київська область
11311,320250,141,2,84,62,22,320250,Київська область
11312,320253,1264,14,780,598,182,320253,Київська область
11313,320254,1658,16,956,732,224,320254,Київська область
11314,320255,202,1,116,96,20,320255,Київська область
11315,320256,1185,8,740,531,209,320256,Київська область
11316,320257,749,11,472,344,128,320257,Київська область
11317,320258,342,5,255,180,75,320258,Київська область
11318,320259,119,0,82,58,24,320259,Київська область
11319,320260,689,3,405,305,100,320260,Київська область
11320,320261,133,0,78,62,16,320261,Київська область
11321,320262,1620,16,953,766,187,320262,Київська область
11322,320263,1954,19,1292,889,403,320263,Київська область
11323,320264,1479,29,924,692,232,320264,Київська область
11324,320265,418,5,308,191,117,320265,Київська область
11325,320266,1039,12,652,465,187,320266,Київська область
11326,320267,1649,28,998,806,192,320267,Київська область
11327,320268,1293,9,677,517,160,320268,Київська область
11328,320269,802,18,445,335,110,320269,Київська область
11329,320270,984,6,508,401,107,320270,Київська область
11330,320271,1018,9,517,408,109,320271,Київська область
11331,320272,1187,6,749,527,222,320272,Київська область
11332,320276,1360,10,809,642,167,320276,Київська область
11333,320277,1226,12,744,591,153,320277,Київська область
11334,321086,1803,28,1055,836,219,321086,Київська область
11335,321087,1117,10,670,519,151,321087,Київська область
11336,321088,597,9,396,290,106,321088,Київська область
11337,321089,1362,14,860,646,214,321089,Київська область
11338,321090,1383,33,807,623,184,321090,Київська область
11339,321091,729,9,427,343,84,321091,Київська область
11340,321092,520,6,337,272,65,321092,Київська область
11341,321093,1869,28,1072,868,204,321093,Київська область
11342,321094,1584,21,918,686,232,321094,Київська область
11343,321095,1541,22,923,712,211,321095,Київська область
11344,321218,2168,51,1371,882,489,321218,Київська область
11345,321219,2298,40,1455,1030,425,321219,Київська область
11346,321220,2186,29,1381,921,460,321220,Київська область
11347,321221,2100,20,1373,956,417,321221,Київська область
11348,321222,1747,26,1123,704,419,321222,Київська область
11349,321223,2111,49,1369,929,440,321223,Київська область
11350,321224,2071,30,1336,920,416,321224,Київська область
11351,321225,2425,37,1735,1144,591,321225,Київська область
11352,321226,2050,28,1390,930,460,321226,Київська область
11353,321227,1921,38,1279,879,400,321227,Київська область
11354,321228,1612,17,1154,736,418,321228,Київська область
11355,321229,2233,32,1417,979,438,321229,Київська область
11356,321230,1986,24,1396,837,559,321230,Київська область
11357,321231,1631,35,1057,739,318,321231,Київська область
11358,321232,1953,36,1169,834,335,321232,Київська область
11359,321233,1778,36,1174,814,360,321233,Київська область
11360,321234,1779,25,1206,816,390,321234,Київська область
11361,321235,1846,34,1196,823,373,321235,Київська область
11362,321236,2082,55,1373,920,453,321236,Київська область
11363,321237,1970,30,1281,935,346,321237,Київська область
11364,321238,2462,38,1642,1124,518,321238,Київська область
11365,321239,2138,60,1365,933,432,321239,Київська область
11366,321240,2066,23,1417,907,510,321240,Київська область
11367,321241,1850,38,1183,770,413,321241,Київська область
11368,321242,1934,21,1271,865,406,321242,Київська область
11369,321243,2069,23,1408,1006,402,321243,Київська область
11370,321244,2324,38,1628,1110,518,321244,Київська область
11371,321245,1922,36,1324,892,432,321245,Київська область
11372,321246,2127,30,1426,982,444,321246,Київська область
11373,321247,2169,30,1464,997,467,321247,Київська область
11374,321248,2102,32,1445,986,459,321248,Київська область
11375,321249,2109,33,1391,975,416,321249,Київська область
11376,321250,2099,35,1366,988,378,321250,Київська область
11377,321251,2071,32,1393,993,400,321251,Київська область
11378,321252,2528,44,1625,1130,495,321252,Київська область
11379,321253,1778,24,1130,784,346,321253,Київська область
11380,321254,2079,38,1295,890,405,321254,Київська область
11381,321255,2053,35,1259,919,340,321255,Київська область
11382,321256,1921,38,1252,846,406,321256,Київська область
11383,321257,2213,36,1395,952,443,321257,Київська область
11384,321258,146,3,140,101,39,321258,Київська область
11385,321419,1753,35,1199,855,344,321419,Київська область
11386,320137,1936,30,1264,904,360,320137,Київська область
11387,320138,655,5,408,291,117,320138,Київська область
11388,320139,1824,29,1314,792,522,320139,Київська область
11389,320140,1315,12,843,586,257,320140,Київська область
11390,320141,1232,21,778,533,245,320141,Київська область
11391,320142,692,10,490,334,156,320142,Київська область
11392,320143,1483,15,939,678,261,320143,Київська область
11393,320144,1593,33,1031,768,263,320144,Київська область
11394,320145,96,5,63,46,17,320145,Київська область
11395,320146,1808,24,1224,770,454,320146,Київська область
11396,320147,1637,25,1102,739,363,320147,Київська область
11397,320148,1818,26,1076,827,249,320148,Київська область
11398,320149,263,1,203,133,70,320149,Київська область
11399,320150,2317,39,1583,986,597,320150,Київська область
11400,320151,1074,25,671,453,218,320151,Київська область
11401,320152,385,5,258,159,99,320152,Київська область
11402,320153,1943,18,1164,874,290,320153,Київська область
11403,320154,1419,19,856,653,203,320154,Київська область
11404,320155,1364,15,846,623,223,320155,Київська область
11405,320156,1257,9,803,636,167,320156,Київська область
11406,320157,273,3,183,132,51,320157,Київська область
11407,320158,896,13,572,420,152,320158,Київська область
11408,320159,148,2,97,65,32,320159,Київська область
11409,320160,134,1,109,70,39,320160,Київська область
11410,320161,1565,9,954,623,331,320161,Київська область
11411,320162,86,0,72,34,38,320162,Київська область
11412,320163,823,18,538,382,156,320163,Київська область
11413,320164,1424,24,910,652,258,320164,Київська область
11414,320165,248,0,140,108,32,320165,Київська область
11415,320166,788,12,548,392,156,320166,Київська область
11416,320167,1325,11,813,582,231,320167,Київська область
11417,320168,164,6,94,48,46,320168,Київська область
11418,320169,2193,41,1374,893,481,320169,Київська область
11419,320170,48,0,35,21,14,320170,Київська область
11420,320171,892,16,560,363,197,320171,Київська область
11421,320172,511,8,317,215,102,320172,Київська область
11422,320173,132,0,94,62,32,320173,Київська область
11423,320174,265,1,174,137,37,320174,Київська область
11424,320175,1172,10,683,535,148,320175,Київська область
11425,320176,1532,19,843,576,267,320176,Київська область
11426,320177,247,0,146,115,31,320177,Київська область
11427,320178,1723,33,1182,803,379,320178,Київська область
11428,320179,1656,26,1142,735,407,320179,Київська область
11429,320180,1590,23,1062,675,387,320180,Київська область
11430,320181,488,21,458,438,20,320181,Київська область
11431,320251,2312,24,1349,968,381,320251,Київська область
11432,320252,2506,32,1572,1141,431,320252,Київська область
11433,320273,1792,25,1062,841,221,320273,Київська область
11434,320274,1943,35,1171,854,317,320274,Київська область
11435,320275,1698,31,1024,776,248,320275,Київська область
11436,320431,1742,24,1017,759,258,320431,Київська область
11437,320432,1735,35,931,667,264,320432,Київська область
11438,320433,1244,15,758,562,196,320433,Київська область
11439,320434,141,0,85,71,14,320434,Київська область
11440,320435,219,5,153,108,45,320435,Київська область
11441,320436,589,9,328,249,79,320436,Київська область
11442,320437,201,1,130,99,31,320437,Київська область
11443,320438,143,2,114,81,33,320438,Київська область
11444,320439,454,4,333,237,96,320439,Київська область
11445,320440,183,3,129,93,36,320440,Київська область
11446,320441,638,8,402,271,131,320441,Київська область
11447,320442,145,0,84,64,20,320442,Київська область
11448,320443,294,1,195,156,39,320443,Київська область
11449,320444,552,1,340,267,73,320444,Київська область
11450,320445,318,6,196,158,38,320445,Київська область
11451,320446,75,0,56,45,11,320446,Київська область
11452,320447,367,6,248,176,72,320447,Київська область
11453,320448,349,4,201,134,67,320448,Київська область
11454,320449,289,4,190,120,70,320449,Київська область
11455,320450,1086,8,624,509,115,320450,Київська область
11456,320451,245,1,148,109,39,320451,Київська область
11457,320452,458,0,259,190,69,320452,Київська область
11458,320453,576,6,345,270,75,320453,Київська область
11459,320454,487,2,297,230,67,320454,Київська область
11460,320455,593,7,359,312,47,320455,Київська область
11461,320456,415,4,235,154,81,320456,Київська область
11462,320457,742,6,461,374,87,320457,Київська область
11463,320458,331,2,219,152,67,320458,Київська область
11464,320459,356,4,195,132,63,320459,Київська область
11465,320775,1003,9,655,543,112,320775,Київська область
11466,320776,345,5,303,177,126,320776,Київська область
11467,320777,496,4,274,187,87,320777,Київська область
11468,320778,934,8,565,440,125,320778,Київська область
11469,320779,590,15,407,298,109,320779,Київська область
11470,320780,483,7,339,232,107,320780,Київська область
11471,320781,150,0,113,70,43,320781,Київська область
11472,320782,871,13,578,463,115,320782,Київська область
11473,320783,282,2,157,116,41,320783,Київська область
11474,320784,331,10,223,129,94,320784,Київська область
11475,320785,544,6,375,202,173,320785,Київська область
11476,320786,1032,12,598,402,196,320786,Київська область
11477,320787,816,6,456,342,114,320787,Київська область
11478,320788,940,13,651,445,206,320788,Київська область
11479,320789,283,3,191,140,51,320789,Київська область
11480,320790,674,7,397,277,120,320790,Київська область
11481,320791,339,0,271,205,66,320791,Київська область
11482,320792,901,7,582,424,158,320792,Київська область
11483,320793,189,2,143,81,62,320793,Київська область
11484,320794,536,14,315,244,71,320794,Київська область
11485,320795,324,1,248,139,109,320795,Київська область
11486,320796,155,2,115,69,46,320796,Київська область
11487,320797,994,11,594,437,157,320797,Київська область
11488,320798,638,6,398,292,106,320798,Київська область
11489,320799,134,1,82,76,6,320799,Київська область
11490,320800,445,11,291,193,98,320800,Київська область
11491,320801,554,6,327,239,88,320801,Київська область
11492,320802,1199,11,618,452,166,320802,Київська область
11493,320803,495,9,323,252,71,320803,Київська область
11494,320804,306,3,195,127,68,320804,Київська область
11495,320805,550,12,344,219,125,320805,Київська область
11496,320806,660,4,395,297,98,320806,Київська область
11497,320807,537,8,336,243,93,320807,Київська область
11498,320808,261,4,208,131,77,320808,Київська область
11499,320809,403,0,335,205,130,320809,Київська область
11500,320810,172,1,136,112,24,320810,Київська область
11501,320811,424,2,269,186,83,320811,Київська область
11502,320812,184,1,155,116,39,320812,Київська область
11503,320813,1000,10,598,464,134,320813,Київська область
11504,320814,2063,39,1364,1071,293,320814,Київська область
11505,320815,299,5,198,149,49,320815,Київська область
11506,320816,414,16,372,281,91,320816,Київська область
11507,321048,990,21,563,434,129,321048,Київська область
11508,321049,1453,14,878,651,227,321049,Київська область
11509,321050,1256,20,722,531,191,321050,Київська область
11510,321051,670,8,465,337,128,321051,Київська область
11511,321052,1279,21,761,603,158,321052,Київська область
11512,321053,1365,12,772,574,198,321053,Київська область
11513,321054,996,14,578,430,148,321054,Київська область
11514,321055,1264,17,780,612,168,321055,Київська область
11515,321056,1247,16,665,514,151,321056,Київська область
11516,321057,563,6,338,270,68,321057,Київська область
11517,321058,1228,14,688,511,177,321058,Київська область
11518,321059,1747,19,974,781,193,321059,Київська область
11519,321060,992,12,582,448,134,321060,Київська область
11520,321061,857,12,517,359,158,321061,Київська область
11521,321062,1014,13,633,436,197,321062,Київська область
11522,321063,1572,19,980,704,276,321063,Київська область
11523,321064,732,6,407,308,99,321064,Київська область
11524,321065,380,2,287,182,105,321065,Київська область
11525,321066,460,2,282,171,111,321066,Київська область
11526,321067,487,3,296,205,91,321067,Київська область
11527,321068,566,10,366,235,131,321068,Київська область
11528,321069,597,13,377,246,131,321069,Київська область
11529,321070,307,3,197,136,61,321070,Київська область
11530,321071,318,14,250,128,122,321071,Київська область
11531,321072,655,5,433,340,93,321072,Київська область
11532,321073,242,3,172,136,36,321073,Київська область
11533,321074,539,15,338,200,138,321074,Київська область
11534,321075,785,12,498,381,117,321075,Київська область
11535,321076,232,3,159,111,48,321076,Київська область
11536,321077,724,15,449,333,116,321077,Київська область
11537,321078,449,8,306,189,117,321078,Київська область
11538,321079,706,7,390,316,74,321079,Київська область
11539,321080,654,18,510,265,245,321080,Київська область
11540,321081,684,9,424,312,112,321081,Київська область
11541,321082,664,11,483,312,171,321082,Київська область
11542,321083,390,3,282,158,124,321083,Київська область
11543,321084,773,8,451,283,168,321084,Київська область
11544,321085,158,4,128,48,80,321085,Київська область
11545,321193,2463,43,1660,1142,518,321193,Київська область
11546,321194,2215,42,1436,1021,415,321194,Київська область
11547,321195,2084,41,1324,910,414,321195,Київська область
11548,321196,2240,39,1288,899,389,321196,Київська область
11549,321197,1961,22,1150,819,331,321197,Київська область
11550,321198,2370,24,1407,1005,402,321198,Київська область
11551,321199,1980,49,1266,863,403,321199,Київська область
11552,321200,1885,43,1232,844,388,321200,Київська область
11553,321201,1673,36,1076,707,369,321201,Київська область
11554,321202,2334,29,1509,1096,413,321202,Київська область
11555,321203,1938,38,1352,896,456,321203,Київська область
11556,321204,2132,38,1389,918,471,321204,Київська область
11557,321205,2078,41,1409,987,422,321205,Київська область
11558,321206,1951,40,1284,873,411,321206,Київська область
11559,321207,1831,44,1149,837,312,321207,Київська область
11560,321208,1794,36,1123,778,345,321208,Київська область
11561,321209,1972,44,1259,918,341,321209,Київська область
11562,321210,2212,31,1470,1039,431,321210,Київська область
11563,321211,2224,48,1368,934,434,321211,Київська область
11564,321212,2045,28,1296,932,364,321212,Київська область
11565,321213,2352,33,1434,1037,397,321213,Київська область
11566,321214,2083,29,1361,988,373,321214,Київська область
11567,321215,2102,29,1327,921,406,321215,Київська область
11568,321216,1832,24,1184,845,339,321216,Київська область
11569,321217,69,0,54,42,12,321217,Київська область
11570,321425,907,4,563,460,103,321425,Київська область
11571,321431,1601,27,1088,713,375,321431,Київська область
11572,1,577,56,520,466,54,1,Кіровоградська область
11573,350814,1756,20,1012,814,198,350814,Кіровоградська область
11574,350815,1968,25,1075,905,170,350815,Кіровоградська область
11575,350816,2029,27,1262,1002,260,350816,Кіровоградська область
11576,350817,1265,27,801,607,194,350817,Кіровоградська область
11577,350818,1132,13,398,322,76,350818,Кіровоградська область
11578,350819,1384,26,863,683,180,350819,Кіровоградська область
11579,350820,1625,20,1017,807,210,350820,Кіровоградська область
11580,350821,1319,9,809,639,170,350821,Кіровоградська область
11581,350822,1259,13,789,644,145,350822,Кіровоградська область
11582,350823,2367,38,1445,1145,300,350823,Кіровоградська область
11583,350824,2370,33,1375,1091,284,350824,Кіровоградська область
11584,350825,2372,44,1413,1122,291,350825,Кіровоградська область
11585,350826,2008,31,1166,919,247,350826,Кіровоградська область
11586,350827,1312,16,861,625,236,350827,Кіровоградська область
11587,350828,1472,16,826,655,171,350828,Кіровоградська область
11588,350829,2005,43,1294,1029,265,350829,Кіровоградська область
11589,350830,2246,33,1500,1136,364,350830,Кіровоградська область
11590,350831,1196,14,721,533,188,350831,Кіровоградська область
11591,350832,1405,14,751,599,152,350832,Кіровоградська область
11592,350833,1718,29,993,769,224,350833,Кіровоградська область
11593,350834,1771,18,1101,823,278,350834,Кіровоградська область
11594,350835,861,12,531,423,108,350835,Кіровоградська область
11595,350836,1814,20,1135,898,237,350836,Кіровоградська область
11596,350837,1248,18,785,626,159,350837,Кіровоградська область
11597,350838,2065,36,1336,1072,264,350838,Кіровоградська область
11598,350839,1590,23,954,785,169,350839,Кіровоградська область
11599,350840,2202,32,1319,1054,265,350840,Кіровоградська область
11600,350841,2106,22,1262,963,299,350841,Кіровоградська область
11601,350842,728,9,458,370,88,350842,Кіровоградська область
11602,350843,1512,18,940,740,200,350843,Кіровоградська область
11603,350844,1767,25,1115,887,228,350844,Кіровоградська область
11604,350845,1994,22,1203,933,270,350845,Кіровоградська область
11605,350846,2100,40,1242,939,303,350846,Кіровоградська область
11606,350847,2222,34,1375,1061,314,350847,Кіровоградська область
11607,350848,1384,24,927,751,176,350848,Кіровоградська область
11608,350849,1201,13,770,576,194,350849,Кіровоградська область
11609,350850,1712,27,1085,819,266,350850,Кіровоградська область
11610,350851,1600,25,1023,772,251,350851,Кіровоградська область
11611,350852,1857,37,1189,934,255,350852,Кіровоградська область
11612,350853,1750,31,1129,871,258,350853,Кіровоградська область
11613,350854,1672,22,1002,802,200,350854,Кіровоградська область
11614,350855,1585,27,1070,803,267,350855,Кіровоградська область
11615,350856,1728,31,1182,873,309,350856,Кіровоградська область
11616,350857,2146,28,1379,1074,305,350857,Кіровоградська область
11617,350858,2002,23,1236,951,285,350858,Кіровоградська область
11618,350859,1585,24,1043,789,254,350859,Кіровоградська область
11619,350860,1783,21,1096,864,232,350860,Кіровоградська область
11620,350861,2078,33,1333,1053,280,350861,Кіровоградська область
11621,350862,2319,36,1448,1134,314,350862,Кіровоградська область
11622,350863,2164,26,1457,1142,315,350863,Кіровоградська область
11623,350864,2092,24,1357,1023,334,350864,Кіровоградська область
11624,350865,2284,24,1418,1115,303,350865,Кіровоградська область
11625,350866,1907,23,1210,932,278,350866,Кіровоградська область
11626,350867,2275,35,1385,1060,325,350867,Кіровоградська область
11627,350868,1552,8,622,532,90,350868,Кіровоградська область
11628,350869,2227,26,1220,990,230,350869,Кіровоградська область
11629,350874,1447,10,864,703,161,350874,Кіровоградська область
11630,350875,2240,39,1379,1099,280,350875,Кіровоградська область
11631,350882,182,4,167,120,47,350882,Кіровоградська область
11632,350883,105,0,96,85,11,350883,Кіровоградська область
11633,350884,40,0,37,33,4,350884,Кіровоградська область
11634,350885,63,1,55,44,11,350885,Кіровоградська область
11635,350886,87,1,82,68,14,350886,Кіровоградська область
11636,350887,296,9,248,213,35,350887,Кіровоградська область
11637,350888,34,1,28,26,2,350888,Кіровоградська область
11638,350889,43,1,39,28,11,350889,Кіровоградська область
11639,350890,29,1,28,18,10,350890,Кіровоградська область
11640,350894,2200,32,1318,1054,264,350894,Кіровоградська область
11641,350895,2017,25,1161,979,182,350895,Кіровоградська область
11642,350896,1540,21,921,744,177,350896,Кіровоградська область
11643,350897,956,10,579,472,107,350897,Кіровоградська область
11644,350898,2252,30,1431,1122,309,350898,Кіровоградська область
11645,350899,1650,16,967,747,220,350899,Кіровоградська область
11646,350900,2105,27,1317,1023,294,350900,Кіровоградська область
11647,350901,985,14,540,451,89,350901,Кіровоградська область
11648,350902,2395,30,1415,1207,208,350902,Кіровоградська область
11649,350903,1857,13,1054,835,219,350903,Кіровоградська область
11650,350904,2324,29,1281,1052,229,350904,Кіровоградська область
11651,350905,2211,30,1311,1077,234,350905,Кіровоградська область
11652,350906,1162,15,726,583,143,350906,Кіровоградська область
11653,350907,1689,16,1012,791,221,350907,Кіровоградська область
11654,350908,1694,26,937,738,199,350908,Кіровоградська область
11655,350909,1276,21,759,570,189,350909,Кіровоградська область
11656,350910,1160,23,720,569,151,350910,Кіровоградська область
11657,350911,2286,25,1396,1169,227,350911,Кіровоградська область
11658,350912,924,20,582,431,151,350912,Кіровоградська область
11659,350913,1454,36,885,628,257,350913,Кіровоградська область
11660,350914,1256,15,704,563,141,350914,Кіровоградська область
11661,350915,1412,28,885,646,239,350915,Кіровоградська область
11662,350916,1280,22,787,583,204,350916,Кіровоградська область
11663,350917,748,8,447,355,92,350917,Кіровоградська область
11664,350918,1627,24,894,603,291,350918,Кіровоградська область
11665,350919,1416,27,786,623,163,350919,Кіровоградська область
11666,350920,850,17,503,371,132,350920,Кіровоградська область
11667,350921,666,4,375,276,99,350921,Кіровоградська область
11668,350922,1427,30,876,656,220,350922,Кіровоградська область
11669,350923,2146,40,1319,1071,248,350923,Кіровоградська область
11670,350924,1823,37,1135,826,309,350924,Кіровоградська область
11671,350925,1882,21,1067,885,182,350925,Кіровоградська область
11672,350926,1477,30,910,652,258,350926,Кіровоградська область
11673,350927,1711,31,931,712,219,350927,Кіровоградська область
11674,350928,2031,31,1283,951,332,350928,Кіровоградська область
11675,350929,1216,8,700,572,128,350929,Кіровоградська область
11676,350930,200,5,192,78,114,350930,Кіровоградська область
11677,350931,14,0,14,9,5,350931,Кіровоградська область
11678,350933,48,0,46,32,14,350933,Кіровоградська область
11679,350934,21,0,14,12,2,350934,Кіровоградська область
11680,350935,177,1,162,141,21,350935,Кіровоградська область
11681,350936,492,29,463,434,29,350936,Кіровоградська область
11682,350001,1801,28,972,818,154,350001,Кіровоградська область
11683,350002,1772,26,1025,833,192,350002,Кіровоградська область
11684,350003,1755,16,1110,918,192,350003,Кіровоградська область
11685,350004,1935,24,1096,932,164,350004,Кіровоградська область
11686,350005,1300,30,639,563,76,350005,Кіровоградська область
11687,350006,231,2,137,121,16,350006,Кіровоградська область
11688,350007,249,3,135,113,22,350007,Кіровоградська область
11689,350008,378,6,246,220,26,350008,Кіровоградська область
11690,350009,248,4,153,87,66,350009,Кіровоградська область
11691,350010,36,0,21,15,6,350010,Кіровоградська область
11692,350011,314,1,177,148,29,350011,Кіровоградська область
11693,350012,317,2,219,161,58,350012,Кіровоградська область
11694,350013,682,6,373,268,105,350013,Кіровоградська область
11695,350014,95,0,62,44,18,350014,Кіровоградська область
11696,350015,177,2,118,103,15,350015,Кіровоградська область
11697,350016,476,1,306,210,96,350016,Кіровоградська область
11698,350017,364,4,241,188,53,350017,Кіровоградська область
11699,350018,323,7,219,190,29,350018,Кіровоградська область
11700,350019,121,0,78,71,7,350019,Кіровоградська область
11701,350020,412,5,244,165,79,350020,Кіровоградська область
11702,350021,127,5,88,50,38,350021,Кіровоградська область
11703,350022,195,2,97,66,31,350022,Кіровоградська область
11704,350023,395,3,241,216,25,350023,Кіровоградська область
11705,350024,90,2,62,51,11,350024,Кіровоградська область
11706,350025,554,0,329,279,50,350025,Кіровоградська область
11707,350026,194,2,127,81,46,350026,Кіровоградська область
11708,350027,15,0,8,5,3,350027,Кіровоградська область
11709,350028,417,3,293,258,35,350028,Кіровоградська область
11710,350029,252,3,143,111,32,350029,Кіровоградська область
11711,350030,312,2,215,171,44,350030,Кіровоградська область
11712,350031,444,4,278,209,69,350031,Кіровоградська область
11713,350032,78,2,42,33,9,350032,Кіровоградська область
11714,350033,153,3,100,65,35,350033,Кіровоградська область
11715,350034,303,5,180,135,45,350034,Кіровоградська область
11716,350035,409,3,254,209,45,350035,Кіровоградська область
11717,350036,379,5,250,231,19,350036,Кіровоградська область
11718,350037,383,3,280,197,83,350037,Кіровоградська область
11719,350038,545,4,334,276,58,350038,Кіровоградська область
11720,350039,196,2,128,95,33,350039,Кіровоградська область
11721,350040,53,0,28,21,7,350040,Кіровоградська область
11722,350041,231,1,115,95,20,350041,Кіровоградська область
11723,350042,218,2,144,121,23,350042,Кіровоградська область
11724,350043,1092,12,582,479,103,350043,Кіровоградська область
11725,350044,1447,9,857,669,188,350044,Кіровоградська область
11726,350045,538,5,303,260,43,350045,Кіровоградська область
11727,350046,886,11,496,420,76,350046,Кіровоградська область
11728,350047,325,1,178,136,42,350047,Кіровоградська область
11729,350048,194,4,114,76,38,350048,Кіровоградська область
11730,350049,341,4,203,156,47,350049,Кіровоградська область
11731,350050,237,1,156,127,29,350050,Кіровоградська область
11732,350051,303,1,170,136,34,350051,Кіровоградська область
11733,350052,538,2,371,311,60,350052,Кіровоградська область
11734,350053,710,7,427,360,67,350053,Кіровоградська область
11735,350054,407,7,251,186,65,350054,Кіровоградська область
11736,350055,356,1,225,209,16,350055,Кіровоградська область
11737,350056,159,2,99,86,13,350056,Кіровоградська область
11738,350057,243,3,149,130,19,350057,Кіровоградська область
11739,350058,259,1,152,133,19,350058,Кіровоградська область
11740,350059,96,0,72,61,11,350059,Кіровоградська область
11741,350060,219,3,146,118,28,350060,Кіровоградська область
11742,350061,360,2,231,195,36,350061,Кіровоградська область
11743,350062,270,5,175,149,26,350062,Кіровоградська область
11744,350063,496,12,244,158,86,350063,Кіровоградська область
11745,350064,218,2,109,92,17,350064,Кіровоградська область
11746,350130,1661,12,902,754,148,350130,Кіровоградська область
11747,350131,1505,12,739,653,86,350131,Кіровоградська область
11748,350132,1656,24,934,797,137,350132,Кіровоградська область
11749,350133,1608,14,891,763,128,350133,Кіровоградська область
11750,350134,1098,12,599,513,86,350134,Кіровоградська область
11751,350135,2009,26,1218,964,254,350135,Кіровоградська область
11752,350136,1761,23,1026,857,169,350136,Кіровоградська область
11753,350137,1176,4,662,574,88,350137,Кіровоградська область
11754,350138,355,3,251,192,59,350138,Кіровоградська область
11755,350139,410,0,239,191,48,350139,Кіровоградська область
11756,350140,435,7,233,196,37,350140,Кіровоградська область
11757,350141,445,2,283,212,71,350141,Кіровоградська область
11758,350142,332,1,193,157,36,350142,Кіровоградська область
11759,350143,114,2,69,52,17,350143,Кіровоградська область
11760,350144,155,0,94,73,21,350144,Кіровоградська область
11761,350145,265,1,196,163,33,350145,Кіровоградська область
11762,350146,955,8,543,442,101,350146,Кіровоградська область
11763,350147,580,5,317,237,80,350147,Кіровоградська область
11764,350148,663,0,249,198,51,350148,Кіровоградська область
11765,350149,264,1,157,112,45,350149,Кіровоградська область
11766,350150,199,4,116,84,32,350150,Кіровоградська область
11767,350151,299,2,182,164,18,350151,Кіровоградська область
11768,350152,343,4,223,192,31,350152,Кіровоградська область
11769,350153,384,5,226,193,33,350153,Кіровоградська область
11770,350154,914,6,500,418,82,350154,Кіровоградська область
11771,350155,463,3,275,221,54,350155,Кіровоградська область
11772,350156,766,8,456,389,67,350156,Кіровоградська область
11773,350157,636,5,395,304,91,350157,Кіровоградська область
11774,350158,370,10,236,197,39,350158,Кіровоградська область
11775,350159,147,2,92,74,18,350159,Кіровоградська область
11776,350160,114,0,72,58,14,350160,Кіровоградська область
11777,350161,189,0,144,122,22,350161,Кіровоградська область
11778,350162,94,0,61,51,10,350162,Кіровоградська область
11779,350163,133,0,67,45,22,350163,Кіровоградська область
11780,350164,834,9,441,374,67,350164,Кіровоградська область
11781,350165,660,6,386,336,50,350165,Кіровоградська область
11782,350166,562,5,313,248,65,350166,Кіровоградська область
11783,350167,203,3,111,75,36,350167,Кіровоградська область
11784,350168,277,4,178,143,35,350168,Кіровоградська область
11785,350169,76,0,46,20,26,350169,Кіровоградська область
11786,350170,428,8,234,194,40,350170,Кіровоградська область
11787,350171,298,2,183,133,50,350171,Кіровоградська область
11788,350249,1051,11,607,499,108,350249,Кіровоградська область
11789,350250,1116,13,679,582,97,350250,Кіровоградська область
11790,350251,704,8,387,344,43,350251,Кіровоградська область
11791,350252,1852,24,1106,932,174,350252,Кіровоградська область
11792,350253,772,6,430,358,72,350253,Кіровоградська область
11793,350254,824,10,520,424,96,350254,Кіровоградська область
11794,350255,1058,11,704,565,139,350255,Кіровоградська область
11795,350256,123,4,86,63,23,350256,Кіровоградська область
11796,350257,680,6,345,298,47,350257,Кіровоградська область
11797,350258,298,3,156,129,27,350258,Кіровоградська область
11798,350259,713,13,466,343,123,350259,Кіровоградська область
11799,350260,399,5,227,170,57,350260,Кіровоградська область
11800,350261,285,2,175,153,22,350261,Кіровоградська область
11801,350262,898,9,484,414,70,350262,Кіровоградська область
11802,350263,409,2,224,180,44,350263,Кіровоградська область
11803,350264,314,0,205,165,40,350264,Кіровоградська область
11804,350265,204,5,117,97,20,350265,Кіровоградська область
11805,350266,630,8,398,358,40,350266,Кіровоградська область
11806,350267,659,3,398,356,42,350267,Кіровоградська область
11807,350268,233,3,122,80,42,350268,Кіровоградська область
11808,350269,497,7,266,198,68,350269,Кіровоградська область
11809,350270,203,2,130,109,21,350270,Кіровоградська область
11810,350271,306,2,215,180,35,350271,Кіровоградська область
11811,350272,267,3,216,192,24,350272,Кіровоградська область
11812,350273,268,2,180,154,26,350273,Кіровоградська область
11813,350274,346,9,242,199,43,350274,Кіровоградська область
11814,350275,448,7,322,277,45,350275,Кіровоградська область
11815,350276,80,4,34,26,8,350276,Кіровоградська область
11816,350277,221,2,133,96,37,350277,Кіровоградська область
11817,350278,215,1,114,96,18,350278,Кіровоградська область
11818,350279,677,4,378,299,79,350279,Кіровоградська область
11819,350280,683,7,421,348,73,350280,Кіровоградська область
11820,350281,307,5,171,144,27,350281,Кіровоградська область
11821,350282,389,2,241,205,36,350282,Кіровоградська область
11822,350283,98,4,54,46,8,350283,Кіровоградська область
11823,350284,132,0,67,54,13,350284,Кіровоградська область
11824,350285,807,5,481,412,69,350285,Кіровоградська область
11825,350286,1985,25,1147,955,192,350286,Кіровоградська область
11826,350287,786,6,505,455,50,350287,Кіровоградська область
11827,350288,1579,29,975,817,158,350288,Кіровоградська область
11828,350289,2264,21,1405,1087,318,350289,Кіровоградська область
11829,350290,777,1,493,416,77,350290,Кіровоградська область
11830,350291,283,3,167,140,27,350291,Кіровоградська область
11831,350292,475,4,322,279,43,350292,Кіровоградська область
11832,350293,541,4,359,287,72,350293,Кіровоградська область
11833,350294,520,1,362,320,42,350294,Кіровоградська область
11834,350295,158,1,100,86,14,350295,Кіровоградська область
11835,350296,2297,26,1472,1255,217,350296,Кіровоградська область
11836,350297,1492,15,872,760,112,350297,Кіровоградська область
11837,350298,409,6,216,194,22,350298,Кіровоградська область
11838,350299,296,2,188,123,65,350299,Кіровоградська область
11839,350300,215,4,126,80,46,350300,Кіровоградська область
11840,350301,335,1,209,180,29,350301,Кіровоградська область
11841,350302,125,2,84,65,19,350302,Кіровоградська область
11842,350303,292,10,188,146,42,350303,Кіровоградська область
11843,350304,450,3,287,211,76,350304,Кіровоградська область
11844,350305,284,0,142,110,32,350305,Кіровоградська область
11845,350306,512,1,310,268,42,350306,Кіровоградська область
11846,350307,704,8,453,372,81,350307,Кіровоградська область
11847,350308,277,0,139,121,18,350308,Кіровоградська область
11848,350309,416,8,226,181,45,350309,Кіровоградська область
11849,350311,444,7,271,225,46,350311,Кіровоградська область
11850,350313,203,0,126,91,35,350313,Кіровоградська область
11851,350314,74,0,44,26,18,350314,Кіровоградська область
11852,350315,517,3,314,243,71,350315,Кіровоградська область
11853,350317,392,3,222,165,57,350317,Кіровоградська область
11854,350318,322,5,202,163,39,350318,Кіровоградська область
11855,350319,644,3,373,301,72,350319,Кіровоградська область
11856,350320,497,1,267,213,54,350320,Кіровоградська область
11857,350321,276,1,162,140,22,350321,Кіровоградська область
11858,350458,1041,15,556,480,76,350458,Кіровоградська область
11859,350459,1200,29,655,563,92,350459,Кіровоградська область
11860,350460,955,19,542,461,81,350460,Кіровоградська область
11861,350461,1724,24,968,815,153,350461,Кіровоградська область
11862,350462,1546,19,907,786,121,350462,Кіровоградська область
11863,350463,1186,8,672,582,90,350463,Кіровоградська область
11864,350464,1312,10,758,658,100,350464,Кіровоградська область
11865,350465,827,9,443,377,66,350465,Кіровоградська область
11866,350466,2122,19,1038,899,139,350466,Кіровоградська область
11867,350467,1473,15,832,706,126,350467,Кіровоградська область
11868,350468,689,5,334,285,49,350468,Кіровоградська область
11869,350469,430,9,245,198,47,350469,Кіровоградська область
11870,350470,717,6,430,352,78,350470,Кіровоградська область
11871,350471,807,5,424,352,72,350471,Кіровоградська область
11872,350472,277,2,201,145,56,350472,Кіровоградська область
11873,350473,346,4,205,174,31,350473,Кіровоградська область
11874,350474,447,6,276,225,51,350474,Кіровоградська область
11875,350475,490,3,241,192,49,350475,Кіровоградська область
11876,350476,786,17,438,374,64,350476,Кіровоградська область
11877,350477,361,1,164,113,51,350477,Кіровоградська область
11878,350478,826,5,451,388,63,350478,Кіровоградська область
11879,350479,252,3,166,136,30,350479,Кіровоградська область
11880,350480,374,4,232,182,50,350480,Кіровоградська область
11881,350481,249,5,150,121,29,350481,Кіровоградська область
11882,350482,451,1,257,203,54,350482,Кіровоградська область
11883,350483,454,2,245,184,61,350483,Кіровоградська область
11884,350484,383,3,244,211,33,350484,Кіровоградська область
11885,350485,391,4,222,202,20,350485,Кіровоградська область
11886,350486,259,19,141,116,25,350486,Кіровоградська область
11887,350487,460,4,307,268,39,350487,Кіровоградська область
11888,350488,256,7,142,109,33,350488,Кіровоградська область
11889,350489,141,4,91,65,26,350489,Кіровоградська область
11890,350490,810,7,473,409,64,350490,Кіровоградська область
11891,350491,656,5,384,320,64,350491,Кіровоградська область
11892,350492,1038,9,585,523,62,350492,Кіровоградська область
11893,350493,1296,8,722,622,100,350493,Кіровоградська область
11894,350494,731,3,473,431,42,350494,Кіровоградська область
11895,350495,572,2,328,286,42,350495,Кіровоградська область
11896,350496,399,9,206,160,46,350496,Кіровоградська область
11897,350497,126,3,58,35,23,350497,Кіровоградська область
11898,350498,252,2,139,123,16,350498,Кіровоградська область
11899,350499,352,4,186,157,29,350499,Кіровоградська область
11900,350500,401,4,258,220,38,350500,Кіровоградська область
11901,350870,1533,21,966,761,205,350870,Кіровоградська область
11902,350871,2100,16,1285,1099,186,350871,Кіровоградська область
11903,350872,1263,21,616,502,114,350872,Кіровоградська область
11904,350873,1653,15,1053,856,197,350873,Кіровоградська область
11905,350876,2254,39,1333,1084,249,350876,Кіровоградська область
11906,350877,1651,29,994,776,218,350877,Кіровоградська область
11907,350878,1658,17,985,792,193,350878,Кіровоградська область
11908,350879,1815,17,1130,914,216,350879,Кіровоградська область
11909,350880,2437,35,1326,1110,216,350880,Кіровоградська область
11910,350881,2374,23,1383,1129,254,350881,Кіровоградська область
11911,350891,376,7,353,277,76,350891,Кіровоградська область
11912,350892,1375,17,894,742,152,350892,Кіровоградська область
11913,350893,1691,19,1052,805,247,350893,Кіровоградська область
11914,350065,1368,10,810,719,91,350065,Кіровоградська область
11915,350066,982,15,525,415,110,350066,Кіровоградська область
11916,350067,1439,10,805,639,166,350067,Кіровоградська область
11917,350068,2258,34,1205,898,307,350068,Кіровоградська область
11918,350069,1581,15,802,582,220,350069,Кіровоградська область
11919,350070,2101,32,1136,876,260,350070,Кіровоградська область
11920,350071,1807,13,983,743,240,350071,Кіровоградська область
11921,350072,1481,10,753,628,125,350072,Кіровоградська область
11922,350073,1442,24,738,573,165,350073,Кіровоградська область
11923,350074,484,5,272,223,49,350074,Кіровоградська область
11924,350075,1187,10,615,479,136,350075,Кіровоградська область
11925,350076,1164,8,604,473,131,350076,Кіровоградська область
11926,350077,308,5,180,130,50,350077,Кіровоградська область
11927,350078,513,12,313,231,82,350078,Кіровоградська область
11928,350079,618,15,349,238,111,350079,Кіровоградська область
11929,350080,234,0,130,99,31,350080,Кіровоградська область
11930,350081,681,5,370,270,100,350081,Кіровоградська область
11931,350082,225,1,127,96,31,350082,Кіровоградська область
11932,350083,444,4,332,223,109,350083,Кіровоградська область
11933,350084,573,4,277,215,62,350084,Кіровоградська область
11934,350085,828,1,435,346,89,350085,Кіровоградська область
11935,350086,452,3,279,214,65,350086,Кіровоградська область
11936,350087,1037,13,631,459,172,350087,Кіровоградська область
11937,350088,324,9,177,132,45,350088,Кіровоградська область
11938,350089,1151,12,601,488,113,350089,Кіровоградська область
11939,350090,312,1,205,134,71,350090,Кіровоградська область
11940,350091,1537,21,833,666,167,350091,Кіровоградська область
11941,350092,636,11,365,258,107,350092,Кіровоградська область
11942,350093,213,2,108,88,20,350093,Кіровоградська область
11943,350094,721,1,450,339,111,350094,Кіровоградська область
11944,350095,1414,23,796,610,186,350095,Кіровоградська область
11945,350096,1836,29,1084,805,279,350096,Кіровоградська область
11946,350097,1420,21,822,621,201,350097,Кіровоградська область
11947,350098,518,9,300,220,80,350098,Кіровоградська область
11948,350099,2133,25,1232,1031,201,350099,Кіровоградська область
11949,350100,2154,31,1184,1013,171,350100,Кіровоградська область
11950,350101,324,3,199,127,72,350101,Кіровоградська область
11951,350102,603,6,337,252,85,350102,Кіровоградська область
11952,350103,414,5,234,180,54,350103,Кіровоградська область
11953,350104,368,2,223,161,62,350104,Кіровоградська область
11954,350105,388,6,228,163,65,350105,Кіровоградська область
11955,350106,944,6,511,437,74,350106,Кіровоградська область
11956,350107,538,7,333,263,70,350107,Кіровоградська область
11957,350108,476,7,289,195,94,350108,Кіровоградська область
11958,350109,416,4,248,216,32,350109,Кіровоградська область
11959,350110,354,7,223,151,72,350110,Кіровоградська область
11960,350111,388,2,211,181,30,350111,Кіровоградська область
11961,350112,344,4,201,130,71,350112,Кіровоградська область
11962,350113,847,12,454,379,75,350113,Кіровоградська область
11963,350114,122,1,67,58,9,350114,Кіровоградська область
11964,350115,394,2,234,183,51,350115,Кіровоградська область
11965,350116,385,2,259,222,37,350116,Кіровоградська область
11966,350117,790,7,455,377,78,350117,Кіровоградська область
11967,350118,1425,15,700,571,129,350118,Кіровоградська область
11968,350119,175,0,99,55,44,350119,Кіровоградська область
11969,350120,130,4,77,61,16,350120,Кіровоградська область
11970,350121,315,6,201,181,20,350121,Кіровоградська область
11971,350122,345,4,225,185,40,350122,Кіровоградська область
11972,350123,176,2,113,85,28,350123,Кіровоградська область
11973,350124,98,0,49,38,11,350124,Кіровоградська область
11974,350125,261,6,144,108,36,350125,Кіровоградська область
11975,350126,524,6,310,231,79,350126,Кіровоградська область
11976,350127,230,1,141,119,22,350127,Кіровоградська область
11977,350128,522,8,287,241,46,350128,Кіровоградська область
11978,350129,486,2,297,248,49,350129,Кіровоградська область
11979,350322,1535,19,825,677,148,350322,Кіровоградська область
11980,350323,1985,19,1113,930,183,350323,Кіровоградська область
11981,350324,1651,24,959,761,198,350324,Кіровоградська область
11982,350325,862,4,504,401,103,350325,Кіровоградська область
11983,350326,1303,16,646,570,76,350326,Кіровоградська область
11984,350327,1413,15,663,573,90,350327,Кіровоградська область
11985,350328,107,0,54,37,17,350328,Кіровоградська область
11986,350329,237,0,132,103,29,350329,Кіровоградська область
11987,350330,191,1,88,66,22,350330,Кіровоградська область
11988,350331,776,10,471,430,41,350331,Кіровоградська область
11989,350332,738,6,430,387,43,350332,Кіровоградська область
11990,350333,1999,37,1121,1022,99,350333,Кіровоградська область
11991,350334,1804,15,1019,918,101,350334,Кіровоградська область
11992,350335,691,12,402,352,50,350335,Кіровоградська область
11993,350336,1603,8,915,761,154,350336,Кіровоградська область
11994,350337,767,5,404,362,42,350337,Кіровоградська область
11995,350338,1001,2,554,507,47,350338,Кіровоградська область
11996,350339,581,0,361,317,44,350339,Кіровоградська область
11997,350340,487,3,270,241,29,350340,Кіровоградська область
11998,350341,394,5,242,218,24,350341,Кіровоградська область
11999,350342,125,0,84,64,20,350342,Кіровоградська область
12000,350343,296,5,196,166,30,350343,Кіровоградська область
12001,350344,523,6,309,259,50,350344,Кіровоградська область
12002,350345,62,1,45,28,17,350345,Кіровоградська область
12003,350346,481,6,312,265,47,350346,Кіровоградська область
12004,350347,117,0,68,57,11,350347,Кіровоградська область
12005,350348,1155,19,636,540,96,350348,Кіровоградська область
12006,350349,144,0,81,72,9,350349,Кіровоградська область
12007,350350,280,3,160,126,34,350350,Кіровоградська область
12008,350351,709,7,369,325,44,350351,Кіровоградська область
12009,350352,459,10,299,278,21,350352,Кіровоградська область
12010,350353,1087,17,683,585,98,350353,Кіровоградська область
12011,350354,796,6,488,418,70,350354,Кіровоградська область
12012,350355,166,2,100,86,14,350355,Кіровоградська область
12013,350356,827,3,451,387,64,350356,Кіровоградська область
12014,350357,260,2,153,134,19,350357,Кіровоградська область
12015,350358,364,4,226,202,24,350358,Кіровоградська область
12016,350359,489,2,273,235,38,350359,Кіровоградська область
12017,350360,1046,9,556,454,102,350360,Кіровоградська область
12018,350361,55,0,43,28,15,350361,Кіровоградська область
12019,350362,231,1,164,130,34,350362,Кіровоградська область
12020,350363,310,0,189,148,41,350363,Кіровоградська область
12021,350386,1411,25,817,602,215,350386,Кіровоградська область
12022,350387,1997,16,1075,865,210,350387,Кіровоградська область
12023,350389,2291,23,1248,990,258,350389,Кіровоградська область
12024,350390,355,2,186,152,34,350390,Кіровоградська область
12025,350391,48,0,28,22,6,350391,Кіровоградська область
12026,350392,325,2,205,146,59,350392,Кіровоградська область
12027,350393,84,4,48,34,14,350393,Кіровоградська область
12028,350394,336,1,184,163,21,350394,Кіровоградська область
12029,350395,417,0,255,205,50,350395,Кіровоградська область
12030,350396,884,9,461,407,54,350396,Кіровоградська область
12031,350397,1032,8,608,497,111,350397,Кіровоградська область
12032,350398,549,7,363,282,81,350398,Кіровоградська область
12033,350399,76,2,40,23,17,350399,Кіровоградська область
12034,350400,176,5,110,96,14,350400,Кіровоградська область
12035,350401,280,2,185,151,34,350401,Кіровоградська область
12036,350402,1102,5,580,460,120,350402,Кіровоградська область
12037,350403,197,1,99,78,21,350403,Кіровоградська область
12038,350404,353,4,261,211,50,350404,Кіровоградська область
12039,350405,762,10,517,399,118,350405,Кіровоградська область
12040,350406,1380,12,781,612,169,350406,Кіровоградська область
12041,350407,441,5,267,228,39,350407,Кіровоградська область
12042,350408,134,3,100,64,36,350408,Кіровоградська область
12043,350409,158,3,108,68,40,350409,Кіровоградська область
12044,350410,255,2,161,125,36,350410,Кіровоградська область
12045,350411,376,4,240,206,34,350411,Кіровоградська область
12046,350412,385,13,201,143,58,350412,Кіровоградська область
12047,350413,62,2,29,27,2,350413,Кіровоградська область
12048,350414,516,11,344,284,60,350414,Кіровоградська область
12049,350415,460,9,310,240,70,350415,Кіровоградська область
12050,350416,1645,15,922,742,180,350416,Кіровоградська область
12051,350417,148,0,98,67,31,350417,Кіровоградська область
12052,350418,248,2,212,176,36,350418,Кіровоградська область
12053,350419,1516,15,725,591,134,350419,Кіровоградська область
12054,350420,1123,14,647,568,79,350420,Кіровоградська область
12055,350421,1983,16,1101,893,208,350421,Кіровоградська область
12056,350422,1400,14,735,603,132,350422,Кіровоградська область
12057,350423,1653,18,818,651,167,350423,Кіровоградська область
12058,350424,1474,14,701,605,96,350424,Кіровоградська область
12059,350425,63,1,45,25,20,350425,Кіровоградська область
12060,350426,65,2,40,31,9,350426,Кіровоградська область
12061,350427,946,12,474,405,69,350427,Кіровоградська область
12062,350428,954,5,460,393,67,350428,Кіровоградська область
12063,350429,261,2,132,103,29,350429,Кіровоградська область
12064,350430,154,3,98,65,33,350430,Кіровоградська область
12065,350431,213,3,132,119,13,350431,Кіровоградська область
12066,350432,75,0,48,39,9,350432,Кіровоградська область
12067,350434,57,0,38,28,10,350434,Кіровоградська область
12068,350435,211,2,87,71,16,350435,Кіровоградська область
12069,350436,384,10,246,200,46,350436,Кіровоградська область
12070,350437,103,0,65,45,20,350437,Кіровоградська область
12071,350438,112,4,72,47,25,350438,Кіровоградська область
12072,350439,444,5,237,189,48,350439,Кіровоградська область
12073,350440,644,4,380,269,111,350440,Кіровоградська область
12074,350441,623,3,342,298,44,350441,Кіровоградська область
12075,350442,611,3,333,273,60,350442,Кіровоградська область
12076,350443,827,18,544,448,96,350443,Кіровоградська область
12077,350444,142,1,78,41,37,350444,Кіровоградська область
12078,350445,148,2,90,74,16,350445,Кіровоградська область
12079,350446,670,3,401,313,88,350446,Кіровоградська область
12080,350447,341,4,194,167,27,350447,Кіровоградська область
12081,350448,526,9,342,290,52,350448,Кіровоградська область
12082,350449,225,3,148,128,20,350449,Кіровоградська область
12083,350450,1143,5,646,537,109,350450,Кіровоградська область
12084,350451,368,4,188,142,46,350451,Кіровоградська область
12085,350452,355,4,231,175,56,350452,Кіровоградська область
12086,350453,398,5,288,241,47,350453,Кіровоградська область
12087,350454,649,6,334,286,48,350454,Кіровоградська область
12088,350455,894,14,587,478,109,350455,Кіровоградська область
12089,350456,212,4,116,102,14,350456,Кіровоградська область
12090,350669,347,4,204,157,47,350669,Кіровоградська область
12091,350670,821,9,516,366,150,350670,Кіровоградська область
12092,350671,766,11,440,352,88,350671,Кіровоградська область
12093,350672,955,10,518,421,97,350672,Кіровоградська область
12094,350673,82,0,56,49,7,350673,Кіровоградська область
12095,350674,541,4,302,229,73,350674,Кіровоградська область
12096,350675,136,0,89,74,15,350675,Кіровоградська область
12097,350676,1061,16,644,506,138,350676,Кіровоградська область
12098,350677,552,5,302,246,56,350677,Кіровоградська область
12099,350678,122,3,74,57,17,350678,Кіровоградська область
12100,350679,687,6,362,272,90,350679,Кіровоградська область
12101,350680,796,15,452,367,85,350680,Кіровоградська область
12102,350681,202,1,120,82,38,350681,Кіровоградська область
12103,350682,435,8,210,174,36,350682,Кіровоградська область
12104,350683,181,2,106,77,29,350683,Кіровоградська область
12105,350684,522,12,367,319,48,350684,Кіровоградська область
12106,350685,998,5,561,449,112,350685,Кіровоградська область
12107,350686,545,6,328,276,52,350686,Кіровоградська область
12108,350687,711,3,359,275,84,350687,Кіровоградська область
12109,350688,247,4,136,101,35,350688,Кіровоградська область
12110,350689,668,10,365,258,107,350689,Кіровоградська область
12111,350690,1889,34,1066,833,233,350690,Кіровоградська область
12112,350691,1527,22,838,683,155,350691,Кіровоградська область
12113,350692,2001,26,1143,903,240,350692,Кіровоградська область
12114,350693,1282,13,741,624,117,350693,Кіровоградська область
12115,350214,1691,23,976,800,176,350214,Кіровоградська область
12116,350215,1696,8,1007,859,148,350215,Кіровоградська область
12117,350217,807,6,431,343,88,350217,Кіровоградська область
12118,350218,356,1,212,178,34,350218,Кіровоградська область
12119,350219,184,2,111,88,23,350219,Кіровоградська область
12120,350220,971,12,525,456,69,350220,Кіровоградська область
12121,350221,930,9,569,482,87,350221,Кіровоградська область
12122,350222,822,8,502,409,93,350222,Кіровоградська область
12123,350223,393,5,190,171,19,350223,Кіровоградська область
12124,350224,717,7,453,397,56,350224,Кіровоградська область
12125,350225,164,0,96,83,13,350225,Кіровоградська область
12126,350226,97,4,60,52,8,350226,Кіровоградська область
12127,350227,172,5,94,86,8,350227,Кіровоградська область
12128,350228,603,3,397,359,38,350228,Кіровоградська область
12129,350229,120,5,63,51,12,350229,Кіровоградська область
12130,350230,438,10,329,256,73,350230,Кіровоградська область
12131,350231,188,0,160,115,45,350231,Кіровоградська область
12132,350232,306,2,192,151,41,350232,Кіровоградська область
12133,350233,1165,11,671,574,97,350233,Кіровоградська область
12134,350234,117,0,91,82,9,350234,Кіровоградська область
12135,350235,600,6,382,328,54,350235,Кіровоградська область
12136,350236,1237,14,705,634,71,350236,Кіровоградська область
12137,350239,1037,10,586,522,64,350239,Кіровоградська область
12138,350240,1285,15,771,676,95,350240,Кіровоградська область
12139,350241,259,0,161,128,33,350241,Кіровоградська область
12140,350243,1043,12,653,554,99,350243,Кіровоградська область
12141,350244,138,0,83,74,9,350244,Кіровоградська область
12142,350245,220,1,142,121,21,350245,Кіровоградська область
12143,350246,132,0,73,59,14,350246,Кіровоградська область
12144,350247,48,0,27,25,2,350247,Кіровоградська область
12145,350248,920,7,499,376,123,350248,Кіровоградська область
12146,350364,314,2,186,149,37,350364,Кіровоградська область
12147,350365,686,9,369,304,65,350365,Кіровоградська область
12148,350366,586,6,399,356,43,350366,Кіровоградська область
12149,350367,1688,19,1131,949,182,350367,Кіровоградська область
12150,350368,910,8,578,502,76,350368,Кіровоградська область
12151,350369,516,11,274,245,29,350369,Кіровоградська область
12152,350370,436,6,300,257,43,350370,Кіровоградська область
12153,350371,1327,21,783,714,69,350371,Кіровоградська область
12154,350372,211,2,132,94,38,350372,Кіровоградська область
12155,350373,369,4,226,195,31,350373,Кіровоградська область
12156,350374,116,1,71,54,17,350374,Кіровоградська область
12157,350375,674,4,410,339,71,350375,Кіровоградська область
12158,350376,415,6,264,226,38,350376,Кіровоградська область
12159,350377,580,8,298,262,36,350377,Кіровоградська область
12160,350378,556,8,313,264,49,350378,Кіровоградська область
12161,350379,510,6,304,261,43,350379,Кіровоградська область
12162,350380,440,2,259,225,34,350380,Кіровоградська область
12163,350381,137,5,81,55,26,350381,Кіровоградська область
12164,350382,376,1,229,206,23,350382,Кіровоградська область
12165,350383,410,1,226,176,50,350383,Кіровоградська область
12166,350384,329,2,239,184,55,350384,Кіровоградська область
12167,350385,112,2,71,46,25,350385,Кіровоградська область
12168,350501,1755,24,934,803,131,350501,Кіровоградська область
12169,350502,1655,15,909,746,163,350502,Кіровоградська область
12170,350503,2239,34,1286,1051,235,350503,Кіровоградська область
12171,350504,1466,23,786,616,170,350504,Кіровоградська область
12172,350505,871,14,390,327,63,350505,Кіровоградська область
12173,350506,79,2,49,33,16,350506,Кіровоградська область
12174,350507,497,2,287,249,38,350507,Кіровоградська область
12175,350508,534,6,301,250,51,350508,Кіровоградська область
12176,350509,327,4,179,135,44,350509,Кіровоградська область
12177,350511,853,16,494,411,83,350511,Кіровоградська область
12178,350512,341,2,195,161,34,350512,Кіровоградська область
12179,350513,246,3,136,105,31,350513,Кіровоградська область
12180,350514,225,1,154,129,25,350514,Кіровоградська область
12181,350515,118,0,54,40,14,350515,Кіровоградська область
12182,350516,162,2,97,83,14,350516,Кіровоградська область
12183,350517,411,5,269,182,87,350517,Кіровоградська область
12184,350518,184,3,150,108,42,350518,Кіровоградська область
12185,350519,270,2,182,137,45,350519,Кіровоградська область
12186,350520,138,0,70,53,17,350520,Кіровоградська область
12187,350521,633,7,340,255,85,350521,Кіровоградська область
12188,350522,126,2,78,57,21,350522,Кіровоградська область
12189,350523,488,3,338,265,73,350523,Кіровоградська область
12190,350524,158,1,142,95,47,350524,Кіровоградська область
12191,350525,843,3,493,429,64,350525,Кіровоградська область
12192,350527,736,7,393,348,45,350527,Кіровоградська область
12193,350528,502,8,250,229,21,350528,Кіровоградська область
12194,350529,602,9,377,299,78,350529,Кіровоградська область
12195,350530,614,10,359,288,71,350530,Кіровоградська область
12196,350531,391,6,233,164,69,350531,Кіровоградська область
12197,350532,62,0,38,28,10,350532,Кіровоградська область
12198,350533,406,1,324,262,62,350533,Кіровоградська область
12199,350534,303,5,187,159,28,350534,Кіровоградська область
12200,350535,92,1,44,37,7,350535,Кіровоградська область
12201,350536,255,1,166,126,40,350536,Кіровоградська область
12202,350537,853,10,499,424,75,350537,Кіровоградська область
12203,350538,514,1,330,275,55,350538,Кіровоградська область
12204,350539,212,0,162,140,22,350539,Кіровоградська область
12205,350540,79,1,52,35,17,350540,Кіровоградська область
12206,350541,200,1,109,92,17,350541,Кіровоградська область
12207,350543,626,0,341,295,46,350543,Кіровоградська область
12208,350544,271,3,204,135,69,350544,Кіровоградська область
12209,350545,824,1,451,377,74,350545,Кіровоградська область
12210,350546,84,12,72,57,15,350546,Кіровоградська область
12211,350595,767,3,545,475,70,350595,Кіровоградська область
12212,350596,440,5,278,245,33,350596,Кіровоградська область
12213,350597,459,1,272,233,39,350597,Кіровоградська область
12214,350598,696,0,402,330,72,350598,Кіровоградська область
12215,350599,86,0,52,47,5,350599,Кіровоградська область
12216,350600,1493,16,799,698,101,350600,Кіровоградська область
12217,350601,1674,18,991,833,158,350601,Кіровоградська область
12218,350602,487,4,260,218,42,350602,Кіровоградська область
12219,350603,104,0,70,56,14,350603,Кіровоградська область
12220,350604,762,6,427,393,34,350604,Кіровоградська область
12221,350605,889,9,571,481,90,350605,Кіровоградська область
12222,350606,585,1,320,240,80,350606,Кіровоградська область
12223,350607,508,7,304,225,79,350607,Кіровоградська область
12224,350608,676,10,420,360,60,350608,Кіровоградська область
12225,350609,455,4,293,257,36,350609,Кіровоградська область
12226,350610,1744,30,1005,873,132,350610,Кіровоградська область
12227,350611,1498,18,814,691,123,350611,Кіровоградська область
12228,350612,517,8,279,226,53,350612,Кіровоградська область
12229,350613,98,1,73,58,15,350613,Кіровоградська область
12230,350614,183,0,100,74,26,350614,Кіровоградська область
12231,350649,1060,6,548,464,84,350649,Кіровоградська область
12232,350650,285,4,160,135,25,350650,Кіровоградська область
12233,350651,364,1,236,214,22,350651,Кіровоградська область
12234,350652,955,5,487,400,87,350652,Кіровоградська область
12235,350655,774,9,438,376,62,350655,Кіровоградська область
12236,350656,626,9,339,279,60,350656,Кіровоградська область
12237,350657,310,2,209,184,25,350657,Кіровоградська область
12238,350658,712,3,457,435,22,350658,Кіровоградська область
12239,350659,422,6,238,222,16,350659,Кіровоградська область
12240,350660,461,5,281,217,64,350660,Кіровоградська область
12241,350661,448,3,282,236,46,350661,Кіровоградська область
12242,350662,70,2,25,20,5,350662,Кіровоградська область
12243,350663,1559,15,864,731,133,350663,Кіровоградська область
12244,350664,316,4,186,158,28,350664,Кіровоградська область
12245,350665,1256,15,666,566,100,350665,Кіровоградська область
12246,350666,190,1,105,75,30,350666,Кіровоградська область
12247,350667,265,5,219,162,57,350667,Кіровоградська область
12248,350668,47,0,36,26,10,350668,Кіровоградська область
12249,350718,1233,15,754,649,105,350718,Кіровоградська область
12250,350719,1410,16,943,788,155,350719,Кіровоградська область
12251,350720,1220,19,770,669,101,350720,Кіровоградська область
12252,350721,1429,22,914,772,142,350721,Кіровоградська область
12253,350722,1110,8,696,609,87,350722,Кіровоградська область
12254,350723,1207,18,734,647,87,350723,Кіровоградська область
12255,350724,905,12,550,474,76,350724,Кіровоградська область
12256,350725,1004,10,573,493,80,350725,Кіровоградська область
12257,350726,1037,19,658,585,73,350726,Кіровоградська область
12258,350727,1069,15,693,602,91,350727,Кіровоградська область
12259,350728,1572,22,959,862,97,350728,Кіровоградська область
12260,350729,716,6,463,402,61,350729,Кіровоградська область
12261,350730,1085,16,633,557,76,350730,Кіровоградська область
12262,350731,1036,12,642,580,62,350731,Кіровоградська область
12263,350732,1077,9,578,529,49,350732,Кіровоградська область
12264,350733,1694,20,1018,895,123,350733,Кіровоградська область
12265,350734,1694,27,971,873,98,350734,Кіровоградська область
12266,350735,1240,17,678,634,44,350735,Кіровоградська область
12267,350736,1529,14,877,806,71,350736,Кіровоградська область
12268,350737,1155,7,672,610,62,350737,Кіровоградська область
12269,350738,200,1,160,124,36,350738,Кіровоградська область
12270,350739,48,0,40,36,4,350739,Кіровоградська область
12271,350740,51,0,48,41,7,350740,Кіровоградська область
12272,350785,1145,14,701,539,162,350785,Кіровоградська область
12273,350786,1370,26,859,701,158,350786,Кіровоградська область
12274,350787,1159,12,732,619,113,350787,Кіровоградська область
12275,350788,1417,15,896,747,149,350788,Кіровоградська область
12276,350789,1391,16,868,752,116,350789,Кіровоградська область
12277,350790,961,8,567,444,123,350790,Кіровоградська область
12278,350791,1525,20,904,729,175,350791,Кіровоградська область
12279,350792,1779,30,1110,913,197,350792,Кіровоградська область
12280,350793,1707,29,991,809,182,350793,Кіровоградська область
12281,350794,1783,29,1076,883,193,350794,Кіровоградська область
12282,350795,1908,26,1136,923,213,350795,Кіровоградська область
12283,350796,1305,11,753,618,135,350796,Кіровоградська область
12284,350797,1528,31,932,758,174,350797,Кіровоградська область
12285,350798,1582,27,950,784,166,350798,Кіровоградська область
12286,350799,1391,29,867,703,164,350799,Кіровоградська область
12287,350800,1354,16,823,678,145,350800,Кіровоградська область
12288,350801,2080,36,1277,1064,213,350801,Кіровоградська область
12289,350802,2045,30,1188,994,194,350802,Кіровоградська область
12290,350803,1900,27,1099,945,154,350803,Кіровоградська область
12291,350804,1888,32,1041,876,165,350804,Кіровоградська область
12292,350805,1350,24,865,706,159,350805,Кіровоградська область
12293,350807,1146,17,651,555,96,350807,Кіровоградська область
12294,350808,1608,34,979,846,133,350808,Кіровоградська область
12295,350809,1536,17,947,835,112,350809,Кіровоградська область
12296,350810,1201,23,746,634,112,350810,Кіровоградська область
12297,350811,152,5,139,115,24,350811,Кіровоградська область
12298,350812,31,0,30,25,5,350812,Кіровоградська область
12299,350813,52,1,51,46,5,350813,Кіровоградська область
12300,350172,1399,19,846,720,126,350172,Кіровоградська область
12301,350173,1514,16,958,796,162,350173,Кіровоградська область
12302,350174,1956,25,1177,1023,154,350174,Кіровоградська область
12303,350175,1339,9,809,724,85,350175,Кіровоградська область
12304,350176,740,7,436,363,73,350176,Кіровоградська область
12305,350177,1137,18,697,593,104,350177,Кіровоградська область
12306,350178,512,2,287,247,40,350178,Кіровоградська область
12307,350179,545,8,338,301,37,350179,Кіровоградська область
12308,350180,960,8,609,523,86,350180,Кіровоградська область
12309,350181,1118,3,579,508,71,350181,Кіровоградська область
12310,350182,1071,24,639,555,84,350182,Кіровоградська область
12311,350183,1028,7,581,506,75,350183,Кіровоградська область
12312,350184,953,17,669,604,65,350184,Кіровоградська область
12313,350185,156,2,102,81,21,350185,Кіровоградська область
12314,350186,147,4,98,90,8,350186,Кіровоградська область
12315,350187,256,3,157,132,25,350187,Кіровоградська область
12316,350188,417,0,245,203,42,350188,Кіровоградська область
12317,350189,589,8,351,286,65,350189,Кіровоградська область
12318,350190,530,5,389,325,64,350190,Кіровоградська область
12319,350191,476,1,296,252,44,350191,Кіровоградська область
12320,350192,378,2,247,202,45,350192,Кіровоградська область
12321,350193,913,8,510,449,61,350193,Кіровоградська область
12322,350194,72,0,32,25,7,350194,Кіровоградська область
12323,350195,485,3,297,262,35,350195,Кіровоградська область
12324,350196,418,0,260,242,18,350196,Кіровоградська область
12325,350197,573,7,341,286,55,350197,Кіровоградська область
12326,350198,476,0,295,238,57,350198,Кіровоградська область
12327,350199,147,0,76,48,28,350199,Кіровоградська область
12328,350200,856,6,488,412,76,350200,Кіровоградська область
12329,350201,336,1,189,170,19,350201,Кіровоградська область
12330,350202,233,0,164,144,20,350202,Кіровоградська область
12331,350203,572,3,313,265,48,350203,Кіровоградська область
12332,350204,220,0,168,138,30,350204,Кіровоградська область
12333,350205,207,0,117,109,8,350205,Кіровоградська область
12334,350206,158,1,112,83,29,350206,Кіровоградська область
12335,350207,486,1,313,281,32,350207,Кіровоградська область
12336,350208,223,1,134,117,17,350208,Кіровоградська область
12337,350209,301,0,177,150,27,350209,Кіровоградська область
12338,350210,209,2,133,115,18,350210,Кіровоградська область
12339,350211,157,0,93,81,12,350211,Кіровоградська область
12340,350212,344,1,188,144,44,350212,Кіровоградська область
12341,350213,68,2,33,26,7,350213,Кіровоградська область
12342,350547,72,1,42,27,15,350547,Кіровоградська область
12343,350548,488,3,245,201,44,350548,Кіровоградська область
12344,350549,570,4,306,254,52,350549,Кіровоградська область
12345,350550,1281,10,696,570,126,350550,Кіровоградська область
12346,350551,984,10,516,434,82,350551,Кіровоградська область
12347,350552,812,12,496,423,73,350552,Кіровоградська область
12348,350553,1118,8,671,562,109,350553,Кіровоградська область
12349,350554,1138,21,684,533,151,350554,Кіровоградська область
12350,350555,560,4,349,304,45,350555,Кіровоградська область
12351,350556,347,3,209,147,62,350556,Кіровоградська область
12352,350557,97,2,60,39,21,350557,Кіровоградська область
12353,350558,377,0,210,172,38,350558,Кіровоградська область
12354,350559,784,5,509,430,79,350559,Кіровоградська область
12355,350560,759,3,466,398,68,350560,Кіровоградська область
12356,350561,788,5,505,356,149,350561,Кіровоградська область
12357,350562,631,7,414,269,145,350562,Кіровоградська область
12358,350563,335,2,217,164,53,350563,Кіровоградська область
12359,350564,644,4,442,391,51,350564,Кіровоградська область
12360,350565,141,2,83,60,23,350565,Кіровоградська область
12361,350566,393,3,232,178,54,350566,Кіровоградська область
12362,350567,218,2,130,107,23,350567,Кіровоградська область
12363,350568,691,7,480,385,95,350568,Кіровоградська область
12364,350569,798,4,487,427,60,350569,Кіровоградська область
12365,350570,255,1,133,108,25,350570,Кіровоградська область
12366,350571,359,5,235,197,38,350571,Кіровоградська область
12367,350572,604,7,426,372,54,350572,Кіровоградська область
12368,350573,533,2,238,208,30,350573,Кіровоградська область
12369,350574,114,0,95,44,51,350574,Кіровоградська область
12370,350575,185,1,144,58,86,350575,Кіровоградська область
12371,350576,129,3,95,59,36,350576,Кіровоградська область
12372,350577,532,1,326,278,48,350577,Кіровоградська область
12373,350578,495,4,296,262,34,350578,Кіровоградська область
12374,350579,79,3,48,41,7,350579,Кіровоградська область
12375,350580,677,6,458,381,77,350580,Кіровоградська область
12376,350582,283,2,162,124,38,350582,Кіровоградська область
12377,350583,615,2,301,278,23,350583,Кіровоградська область
12378,350584,981,13,520,445,75,350584,Кіровоградська область
12379,350585,403,0,247,220,27,350585,Кіровоградська область
12380,350586,134,3,85,81,4,350586,Кіровоградська область
12381,350587,448,10,255,214,41,350587,Кіровоградська область
12382,350588,104,0,54,50,4,350588,Кіровоградська область
12383,350589,1177,16,739,629,110,350589,Кіровоградська область
12384,350590,133,1,70,62,8,350590,Кіровоградська область
12385,350591,503,6,335,276,59,350591,Кіровоградська область
12386,350592,177,0,110,55,55,350592,Кіровоградська область
12387,350593,185,2,114,84,30,350593,Кіровоградська область
12388,350594,477,5,310,282,28,350594,Кіровоградська область
12389,350615,1372,13,843,715,128,350615,Кіровоградська область
12390,350616,1653,9,1053,916,137,350616,Кіровоградська область
12391,350617,1581,22,983,874,109,350617,Кіровоградська область
12392,350618,1159,14,696,622,74,350618,Кіровоградська область
12393,350619,297,7,186,153,33,350619,Кіровоградська область
12394,350620,624,11,370,333,37,350620,Кіровоградська область
12395,350621,327,4,212,194,18,350621,Кіровоградська область
12396,350622,257,3,170,134,36,350622,Кіровоградська область
12397,350623,684,9,410,370,40,350623,Кіровоградська область
12398,350624,740,6,486,417,69,350624,Кіровоградська область
12399,350625,248,2,186,158,28,350625,Кіровоградська область
12400,350626,286,6,206,186,20,350626,Кіровоградська область
12401,350627,390,2,227,185,42,350627,Кіровоградська область
12402,350628,141,3,98,73,25,350628,Кіровоградська область
12403,350629,695,14,362,309,53,350629,Кіровоградська область
12404,350630,178,2,116,86,30,350630,Кіровоградська область
12405,350631,923,17,555,497,58,350631,Кіровоградська область
12406,350632,173,2,116,102,14,350632,Кіровоградська область
12407,350633,274,3,180,141,39,350633,Кіровоградська область
12408,350634,532,4,294,243,51,350634,Кіровоградська область
12409,350635,812,4,472,406,66,350635,Кіровоградська область
12410,350636,540,6,295,262,33,350636,Кіровоградська область
12411,350637,553,3,277,228,49,350637,Кіровоградська область
12412,350640,97,0,67,50,17,350640,Кіровоградська область
12413,350641,180,0,104,85,19,350641,Кіровоградська область
12414,350642,735,4,518,457,61,350642,Кіровоградська область
12415,350643,512,4,352,293,59,350643,Кіровоградська область
12416,350644,314,0,195,167,28,350644,Кіровоградська область
12417,350645,510,1,300,225,75,350645,Кіровоградська область
12418,350646,340,0,233,202,31,350646,Кіровоградська область
12419,350647,42,0,37,32,5,350647,Кіровоградська область
12420,350648,357,13,338,273,65,350648,Кіровоградська область
12421,350694,1130,5,711,614,97,350694,Кіровоградська область
12422,350695,654,6,384,323,61,350695,Кіровоградська область
12423,350696,985,5,560,494,66,350696,Кіровоградська область
12424,350697,394,14,203,133,70,350697,Кіровоградська область
12425,350698,265,4,185,168,17,350698,Кіровоградська область
12426,350699,241,0,111,84,27,350699,Кіровоградська область
12427,350700,341,4,196,132,64,350700,Кіровоградська область
12428,350701,712,7,471,372,99,350701,Кіровоградська область
12429,350702,169,1,98,85,13,350702,Кіровоградська область
12430,350703,97,1,62,54,8,350703,Кіровоградська область
12431,350704,770,11,442,370,72,350704,Кіровоградська область
12432,350705,148,0,87,80,7,350705,Кіровоградська область
12433,350706,329,0,220,187,33,350706,Кіровоградська область
12434,350707,401,2,263,206,57,350707,Кіровоградська область
12435,350708,89,1,58,47,11,350708,Кіровоградська область
12436,350709,760,4,499,417,82,350709,Кіровоградська область
12437,350710,200,0,132,103,29,350710,Кіровоградська область
12438,350711,391,3,265,222,43,350711,Кіровоградська область
12439,350712,234,3,139,127,12,350712,Кіровоградська область
12440,350713,264,2,162,120,42,350713,Кіровоградська область
12441,350714,504,2,295,248,47,350714,Кіровоградська область
12442,350715,160,0,103,77,26,350715,Кіровоградська область
12443,350716,387,2,250,204,46,350716,Кіровоградська область
12444,350717,22,0,22,20,2,350717,Кіровоградська область
12445,350741,1900,38,1197,1021,176,350741,Кіровоградська область
12446,350743,2288,32,1310,1116,194,350743,Кіровоградська область
12447,350744,1674,21,949,847,102,350744,Кіровоградська область
12448,350745,1619,29,979,836,143,350745,Кіровоградська область
12449,350746,1809,23,1139,963,176,350746,Кіровоградська область
12450,350747,1965,27,1235,1038,197,350747,Кіровоградська область
12451,350748,1623,18,937,779,158,350748,Кіровоградська область
12452,350749,1509,27,871,756,115,350749,Кіровоградська область
12453,350750,1558,17,956,817,139,350750,Кіровоградська область
12454,350751,2271,41,1368,1200,168,350751,Кіровоградська область
12455,350752,2369,17,1444,1275,169,350752,Кіровоградська область
12456,350753,1756,33,1052,913,139,350753,Кіровоградська область
12457,350754,2033,23,1215,1042,173,350754,Кіровоградська область
12458,350755,1878,29,1085,948,137,350755,Кіровоградська область
12459,350756,1805,31,1123,988,135,350756,Кіровоградська область
12460,350757,2018,36,1219,1066,153,350757,Кіровоградська область
12461,350758,1880,33,1176,994,182,350758,Кіровоградська область
12462,350759,2307,27,1332,1175,157,350759,Кіровоградська область
12463,350760,2277,26,1265,1102,163,350760,Кіровоградська область
12464,350761,2255,32,1369,1158,211,350761,Кіровоградська область
12465,350762,2212,36,1340,1147,193,350762,Кіровоградська область
12466,350763,1546,19,936,799,137,350763,Кіровоградська область
12467,350764,2286,29,1326,1167,159,350764,Кіровоградська область
12468,350765,2194,29,1320,1145,175,350765,Кіровоградська область
12469,350766,1417,19,878,788,90,350766,Кіровоградська область
12470,350768,1323,19,679,588,91,350768,Кіровоградська область
12471,350769,1456,25,840,749,91,350769,Кіровоградська область
12472,350770,2091,29,1229,1073,156,350770,Кіровоградська область
12473,350771,2083,28,1183,1041,142,350771,Кіровоградська область
12474,350772,1997,25,1094,965,129,350772,Кіровоградська область
12475,350773,1113,14,629,526,103,350773,Кіровоградська область
12476,350774,1243,20,662,580,82,350774,Кіровоградська область
12477,350775,1507,20,782,697,85,350775,Кіровоградська область
12478,350776,1437,11,780,712,68,350776,Кіровоградська область
12479,350777,517,10,263,233,30,350777,Кіровоградська область
12480,350778,843,6,495,447,48,350778,Кіровоградська область
12481,350779,784,11,474,434,40,350779,Кіровоградська область
12482,350780,1707,18,985,867,118,350780,Кіровоградська область
12483,350781,181,7,166,126,40,350781,Кіровоградська область
12484,350782,55,0,49,44,5,350782,Кіровоградська область
12485,350783,55,2,51,43,8,350783,Кіровоградська область
12486,350784,36,2,33,25,8,350784,Кіровоградська область
12487,1,553,16,500,248,252,1,Луганська область
12488,441404,1919,26,818,746,72,441404,Луганська область
12489,441405,1760,17,786,720,66,441405,Луганська область
12490,441406,1822,14,861,784,77,441406,Луганська область
12491,441407,1707,17,782,734,48,441407,Луганська область
12492,441408,1776,25,807,745,62,441408,Луганська область
12493,441413,15,0,15,13,2,441413,Луганська область
12494,1,205,23,182,130,52,1,Луганська область
12495,2,1646,47,1351,711,640,2,Луганська область
12496,3,549,31,482,280,202,3,Луганська область
12497,4,783,23,600,276,324,4,Луганська область
12498,440393,686,4,359,337,22,440393,Луганська область
12499,440394,372,5,235,225,10,440394,Луганська область
12500,440395,457,5,257,248,9,440395,Луганська область
12501,440396,621,3,324,266,58,440396,Луганська область
12502,440398,747,4,377,349,28,440398,Луганська область
12503,440399,73,0,51,48,3,440399,Луганська область
12504,440400,334,1,182,173,9,440400,Луганська область
12505,440405,1304,13,625,586,39,440405,Луганська область
12506,440406,503,2,292,280,12,440406,Луганська область
12507,440407,133,0,101,85,16,440407,Луганська область
12508,440408,119,0,59,56,3,440408,Луганська область
12509,440409,1015,14,463,442,21,440409,Луганська область
12510,440410,272,3,146,136,10,440410,Луганська область
12511,440411,282,1,160,152,8,440411,Луганська область
12512,440412,305,2,157,151,6,440412,Луганська область
12513,440413,216,2,125,117,8,440413,Луганська область
12514,440415,220,0,78,72,6,440415,Луганська область
12515,440419,285,2,174,167,7,440419,Луганська область
12516,440420,369,4,127,120,7,440420,Луганська область
12517,440421,357,5,156,148,8,440421,Луганська область
12518,441162,1822,27,1110,976,134,441162,Луганська область
12519,441163,1608,35,992,883,109,441163,Луганська область
12520,441164,2174,29,1313,1190,123,441164,Луганська область
12521,441165,1354,16,739,683,56,441165,Луганська область
12522,441166,2026,24,1217,1089,128,441166,Луганська область
12523,441167,2374,25,1356,1254,102,441167,Луганська область
12524,441168,2355,26,1394,1279,115,441168,Луганська область
12525,441169,2410,31,1433,1324,109,441169,Луганська область
12526,441170,2128,32,1312,1210,102,441170,Луганська область
12527,441171,1570,20,902,826,76,441171,Луганська область
12528,441172,1882,25,986,914,72,441172,Луганська область
12529,441173,2453,46,1535,1339,196,441173,Луганська область
12530,441174,1688,22,1066,937,129,441174,Луганська область
12531,441175,2125,18,1194,1104,90,441175,Луганська область
12532,441176,1741,20,1035,947,88,441176,Луганська область
12533,441177,2290,29,1325,1211,114,441177,Луганська область
12534,441178,1881,24,1104,1008,96,441178,Луганська область
12535,441179,1705,19,1058,963,95,441179,Луганська область
12536,441180,2141,38,1344,1217,127,441180,Луганська область
12537,441181,1634,25,970,883,87,441181,Луганська область
12538,441182,1481,38,933,857,76,441182,Луганська область
12539,441183,2157,30,1313,1184,129,441183,Луганська область
12540,441184,1365,18,728,669,59,441184,Луганська область
12541,441185,453,8,273,245,28,441185,Луганська область
12542,441186,2238,22,1347,1206,141,441186,Луганська область
12543,441187,2332,35,1382,1249,133,441187,Луганська область
12544,441188,2388,34,1525,1404,121,441188,Луганська область
12545,441189,2360,46,1410,1291,119,441189,Луганська область
12546,441190,2234,30,1443,1304,139,441190,Луганська область
12547,441191,2361,29,1472,1339,133,441191,Луганська область
12548,441192,2110,36,1388,1260,128,441192,Луганська область
12549,441193,2226,40,1424,1271,153,441193,Луганська область
12550,441194,2092,27,1295,1185,110,441194,Луганська область
12551,441195,2373,32,1398,1285,113,441195,Луганська область
12552,441196,1964,23,1216,1077,139,441196,Луганська область
12553,441197,2102,28,1286,1165,121,441197,Луганська область
12554,441198,1714,16,1069,955,114,441198,Луганська область
12555,441199,2041,14,1255,1125,130,441199,Луганська область
12556,441200,2371,33,1500,1356,144,441200,Луганська область
12557,441201,2387,45,1517,1382,135,441201,Луганська область
12558,441202,2204,21,1421,1273,148,441202,Луганська область
12559,441203,617,4,389,355,34,441203,Луганська область
12560,441204,581,5,327,311,16,441204,Луганська область
12561,441205,622,7,297,280,17,441205,Луганська область
12562,441206,1115,5,664,625,39,441206,Луганська область
12563,441207,1778,17,848,823,25,441207,Луганська область
12564,441208,1943,24,995,975,20,441208,Луганська область
12565,441209,160,0,78,75,3,441209,Луганська область
12566,441210,517,4,305,286,19,441210,Луганська область
12567,441211,52,0,51,46,5,441211,Луганська область
12568,1,1036,64,903,399,504,1,Луганська область
12569,2,621,27,578,256,322,2,Луганська область
12570,440381,1141,10,535,490,45,440381,Луганська область
12571,440382,1130,7,516,472,44,440382,Луганська область
12572,440383,1406,22,714,669,45,440383,Луганська область
12573,440384,1216,10,516,491,25,440384,Луганська область
12574,440385,1374,10,596,556,40,440385,Луганська область
12575,440386,1205,8,564,537,27,440386,Луганська область
12576,440387,2262,23,1082,999,83,440387,Луганська область
12577,440388,1721,16,753,703,50,440388,Луганська область
12578,440389,1763,18,899,810,89,440389,Луганська область
12579,440390,2018,18,900,834,66,440390,Луганська область
12580,440391,1499,11,734,699,35,440391,Луганська область
12581,440392,147,7,121,59,62,440392,Луганська область
12582,440422,36,0,35,25,10,440422,Луганська область
12583,440423,16,0,14,11,3,440423,Луганська область
12584,440927,2049,15,1052,980,72,440927,Луганська область
12585,440928,1786,14,974,906,68,440928,Луганська область
12586,440929,1816,13,961,873,88,440929,Луганська область
12587,440930,1979,25,1048,977,71,440930,Луганська область
12588,440931,2018,23,1084,1015,69,440931,Луганська область
12589,440932,2053,20,951,890,61,440932,Луганська область
12590,440933,2083,29,1022,964,58,440933,Луганська область
12591,440934,2184,32,997,936,61,440934,Луганська область
12592,440935,2000,18,992,922,70,440935,Луганська область
12593,440936,1541,14,816,754,62,440936,Луганська область
12594,440937,1674,21,923,854,69,440937,Луганська область
12595,440938,1672,35,801,748,53,440938,Луганська область
12596,440939,2168,30,1061,999,62,440939,Луганська область
12597,440940,1878,23,947,884,63,440940,Луганська область
12598,440941,1630,19,759,714,45,440941,Луганська область
12599,440942,1554,18,753,694,59,440942,Луганська область
12600,440943,877,9,418,395,23,440943,Луганська область
12601,440944,987,8,401,386,15,440944,Луганська область
12602,440945,1861,29,876,817,59,440945,Луганська область
12603,440946,2132,27,1034,953,81,440946,Луганська область
12604,440947,2037,27,995,925,70,440947,Луганська область
12605,440948,2100,39,1029,952,77,440948,Луганська область
12606,440949,2229,29,1099,1013,86,440949,Луганська область
12607,440950,1581,30,932,854,78,440950,Луганська область
12608,440951,1567,14,922,854,68,440951,Луганська область
12609,440952,2167,23,1209,1091,118,440952,Луганська область
12610,440953,2186,32,1162,1022,140,440953,Луганська область
12611,440954,2165,32,1246,1131,115,440954,Луганська область
12612,440955,2063,31,1247,1121,126,440955,Луганська область
12613,440956,2103,28,1172,1061,111,440956,Луганська область
12614,440957,2037,21,1044,959,85,440957,Луганська область
12615,440958,2118,34,1123,1023,100,440958,Луганська область
12616,440959,2097,29,1031,958,73,440959,Луганська область
12617,440960,2075,26,1072,992,80,440960,Луганська область
12618,440962,2435,31,1056,999,57,440962,Луганська область
12619,440963,2417,29,1232,1139,93,440963,Луганська область
12620,440964,2043,29,1077,1025,52,440964,Луганська область
12621,440965,1776,25,805,750,55,440965,Луганська область
12622,440966,1951,25,869,816,53,440966,Луганська область
12623,440967,1781,23,867,830,37,440967,Луганська область
12624,440968,1874,15,881,852,29,440968,Луганська область
12625,440969,2069,30,953,910,43,440969,Луганська область
12626,440970,2062,25,988,940,48,440970,Луганська область
12627,440971,1327,14,590,568,22,440971,Луганська область
12628,440972,82,5,73,59,14,440972,Луганська область
12629,440973,83,5,76,69,7,440973,Луганська область
12630,440974,190,4,167,155,12,440974,Луганська область
12631,1,710,31,542,257,285,1,Луганська область
12632,2,452,12,430,128,302,2,Луганська область
12633,440787,1572,6,507,480,27,440787,Луганська область
12634,440997,733,7,381,359,22,440997,Луганська область
12635,440998,897,6,311,298,13,440998,Луганська область
12636,440999,675,4,322,312,10,440999,Луганська область
12637,441000,2127,22,971,933,38,441000,Луганська область
12638,441001,1254,9,604,589,15,441001,Луганська область
12639,441002,795,6,382,358,24,441002,Луганська область
12640,441003,1012,4,419,401,18,441003,Луганська область
12641,441005,1218,12,595,572,23,441005,Луганська область
12642,441006,1298,12,571,538,33,441006,Луганська область
12643,441007,1388,6,726,691,35,441007,Луганська область
12644,441008,1543,17,824,779,45,441008,Луганська область
12645,441009,715,9,372,363,9,441009,Луганська область
12646,441010,1675,22,752,720,32,441010,Луганська область
12647,441011,960,7,433,420,13,441011,Луганська область
12648,441012,1232,14,612,523,89,441012,Луганська область
12649,441013,539,6,240,227,13,441013,Луганська область
12650,441069,1940,34,1103,1028,75,441069,Луганська область
12651,441070,2070,29,1215,1138,77,441070,Луганська область
12652,441071,2108,32,1177,1103,74,441071,Луганська область
12653,441072,2214,33,1357,1260,97,441072,Луганська область
12654,441073,2100,33,1156,1081,75,441073,Луганська область
12655,441074,2299,32,1252,1187,65,441074,Луганська область
12656,441075,2275,29,1250,1171,79,441075,Луганська область
12657,441076,2254,35,1187,1128,59,441076,Луганська область
12658,441077,2213,22,1175,1131,44,441077,Луганська область
12659,441078,1515,19,860,786,74,441078,Луганська область
12660,441079,1474,18,792,744,48,441079,Луганська область
12661,441080,1967,25,1125,1062,63,441080,Луганська область
12662,441081,2127,30,1279,1160,119,441081,Луганська область
12663,441082,1923,37,1091,1015,76,441082,Луганська область
12664,441083,1972,27,1077,995,82,441083,Луганська область
12665,441084,2349,28,1286,1181,105,441084,Луганська область
12666,441085,2259,36,1216,1138,78,441085,Луганська область
12667,441086,2177,22,1146,1081,65,441086,Луганська область
12668,441087,2168,23,1115,1045,70,441087,Луганська область
12669,441088,2168,31,1172,1093,79,441088,Луганська область
12670,441089,1532,20,886,806,80,441089,Луганська область
12671,441090,1451,18,686,659,27,441090,Луганська область
12672,441091,42,1,35,34,1,441091,Луганська область
12673,1,379,14,365,344,21,1,Луганська область
12674,2,544,12,514,181,333,2,Луганська область
12675,3,471,9,434,280,154,3,Луганська область
12676,440065,2185,14,1290,1167,123,440065,Луганська область
12677,440066,1341,23,863,799,64,440066,Луганська область
12678,440067,1823,10,1060,984,76,440067,Луганська область
12679,440068,486,4,316,294,22,440068,Луганська область
12680,440069,425,4,258,236,22,440069,Луганська область
12681,440070,158,3,112,103,9,440070,Луганська область
12682,440071,309,5,218,169,49,440071,Луганська область
12683,440072,894,5,552,517,35,440072,Луганська область
12684,440073,381,5,254,230,24,440073,Луганська область
12685,440074,256,3,182,167,15,440074,Луганська область
12686,440075,342,3,220,183,37,440075,Луганська область
12687,440076,294,7,196,178,18,440076,Луганська область
12688,440077,292,3,181,164,17,440077,Луганська область
12689,440079,491,2,299,273,26,440079,Луганська область
12690,440080,206,2,128,114,14,440080,Луганська область
12691,440081,698,5,418,382,36,440081,Луганська область
12692,440082,138,1,96,72,24,440082,Луганська область
12693,440083,540,7,325,311,14,440083,Луганська область
12694,440084,217,2,134,127,7,440084,Луганська область
12695,440085,493,4,310,288,22,440085,Луганська область
12696,440086,242,2,149,135,14,440086,Луганська область
12697,440087,359,2,199,182,17,440087,Луганська область
12698,440089,323,2,206,200,6,440089,Луганська область
12699,440090,90,2,48,47,1,440090,Луганська область
12700,440091,519,6,249,240,9,440091,Луганська область
12701,440092,375,3,223,209,14,440092,Луганська область
12702,440093,136,2,85,79,6,440093,Луганська область
12703,440094,841,7,495,462,33,440094,Луганська область
12704,440095,72,3,41,35,6,440095,Луганська область
12705,440096,359,4,232,218,14,440096,Луганська область
12706,440134,1558,16,914,842,72,440134,Луганська область
12707,440135,1478,16,782,725,57,440135,Луганська область
12708,440136,1422,12,840,786,54,440136,Луганська область
12709,440137,1446,18,859,762,97,440137,Луганська область
12710,440138,1303,11,751,676,75,440138,Луганська область
12711,440139,1492,14,823,773,50,440139,Луганська область
12712,440140,1369,16,732,667,65,440140,Луганська область
12713,440141,1173,10,675,619,56,440141,Луганська область
12714,440142,1781,26,860,821,39,440142,Луганська область
12715,440143,1531,14,811,753,58,440143,Луганська область
12716,440144,1439,9,823,786,37,440144,Луганська область
12717,440145,591,10,320,302,18,440145,Луганська область
12718,440146,715,5,435,397,38,440146,Луганська область
12719,440147,289,1,171,162,9,440147,Луганська область
12720,440148,1806,14,964,913,51,440148,Луганська область
12721,440149,1610,10,896,875,21,440149,Луганська область
12722,440151,204,3,110,103,7,440151,Луганська область
12723,440152,406,4,238,213,25,440152,Луганська область
12724,440153,323,2,218,200,18,440153,Луганська область
12725,440154,438,1,278,223,55,440154,Луганська область
12726,440155,1247,8,540,524,16,440155,Луганська область
12727,440156,483,4,280,249,31,440156,Луганська область
12728,440158,353,4,189,166,23,440158,Луганська область
12729,440159,1308,11,804,773,31,440159,Луганська область
12730,440160,726,11,450,431,19,440160,Луганська область
12731,440161,579,7,346,318,28,440161,Луганська область
12732,440162,342,2,202,192,10,440162,Луганська область
12733,440163,1055,13,605,582,23,440163,Луганська область
12734,440164,853,14,446,427,19,440164,Луганська область
12735,440165,733,4,508,484,24,440165,Луганська область
12736,440166,639,4,431,399,32,440166,Луганська область
12737,440167,317,1,197,180,17,440167,Луганська область
12738,440168,968,21,569,523,46,440168,Луганська область
12739,440169,25,0,24,21,3,440169,Луганська область
12740,440257,1868,17,1094,969,125,440257,Луганська область
12741,440258,1073,13,597,563,34,440258,Луганська область
12742,440259,774,3,382,354,28,440259,Луганська область
12743,440260,1628,19,928,833,95,440260,Луганська область
12744,440261,261,4,137,125,12,440261,Луганська область
12745,440262,709,7,362,332,30,440262,Луганська область
12746,440263,752,12,358,329,29,440263,Луганська область
12747,440264,418,4,229,202,27,440264,Луганська область
12748,440265,838,2,451,415,36,440265,Луганська область
12749,440266,123,2,82,77,5,440266,Луганська область
12750,440267,712,5,415,399,16,440267,Луганська область
12751,440268,587,8,312,286,26,440268,Луганська область
12752,440269,508,7,322,303,19,440269,Луганська область
12753,440270,321,5,198,168,30,440270,Луганська область
12754,440271,376,1,190,163,27,440271,Луганська область
12755,440272,107,0,61,56,5,440272,Луганська область
12756,440273,674,11,333,309,24,440273,Луганська область
12757,440274,651,9,342,317,25,440274,Луганська область
12758,440275,324,6,199,185,14,440275,Луганська область
12759,440276,354,1,187,156,31,440276,Луганська область
12760,440277,1331,9,530,498,32,440277,Луганська область
12761,440278,740,10,445,421,24,440278,Луганська область
12762,440279,322,2,200,187,13,440279,Луганська область
12763,440280,384,8,186,176,10,440280,Луганська область
12764,440281,228,0,137,130,7,440281,Луганська область
12765,440282,862,9,452,411,41,440282,Луганська область
12766,440283,206,14,181,132,49,440283,Луганська область
12767,440425,178,2,149,126,23,440425,Луганська область
12768,440426,1308,15,812,776,36,440426,Луганська область
12769,440427,1030,12,670,636,34,440427,Луганська область
12770,440428,1474,19,916,857,59,440428,Луганська область
12771,440429,1664,16,993,923,70,440429,Луганська область
12772,440430,1746,10,1089,1013,76,440430,Луганська область
12773,440431,1712,15,1078,1010,68,440431,Луганська область
12774,440432,1243,11,764,729,35,440432,Луганська область
12775,440433,1950,18,1243,1141,102,440433,Луганська область
12776,440434,1988,22,1190,1126,64,440434,Луганська область
12777,440435,563,4,387,371,16,440435,Луганська область
12778,440436,123,0,103,100,3,440436,Луганська область
12779,440437,513,3,325,296,29,440437,Луганська область
12780,440438,205,0,135,131,4,440438,Луганська область
12781,440439,276,2,161,148,13,440439,Луганська область
12782,440440,909,9,554,525,29,440440,Луганська область
12783,440441,379,3,254,245,9,440441,Луганська область
12784,440442,87,0,55,53,2,440442,Луганська область
12785,440443,387,5,248,220,28,440443,Луганська область
12786,440444,386,1,260,253,7,440444,Луганська область
12787,440445,77,1,47,43,4,440445,Луганська область
12788,440446,383,1,261,230,31,440446,Луганська область
12789,440447,289,4,169,161,8,440447,Луганська область
12790,440448,396,2,253,225,28,440448,Луганська область
12791,440449,389,3,221,197,24,440449,Луганська область
12792,440450,1582,10,934,880,54,440450,Луганська область
12793,440451,761,6,583,518,65,440451,Луганська область
12794,440452,794,18,485,440,45,440452,Луганська область
12795,440453,139,7,98,94,4,440453,Луганська область
12796,440454,1476,9,878,811,67,440454,Луганська область
12797,440455,242,3,132,127,5,440455,Луганська область
12798,440456,413,6,284,250,34,440456,Луганська область
12799,440457,114,0,79,71,8,440457,Луганська область
12800,440458,296,1,176,161,15,440458,Луганська область
12801,440459,513,4,329,306,23,440459,Луганська область
12802,440460,388,0,257,232,25,440460,Луганська область
12803,440461,292,0,195,176,19,440461,Луганська область
12804,440557,1044,21,654,599,55,440557,Луганська область
12805,440558,765,12,450,402,48,440558,Луганська область
12806,440559,887,6,543,490,53,440559,Луганська область
12807,440560,1580,14,941,767,174,440560,Луганська область
12808,440561,1785,13,1055,967,88,440561,Луганська область
12809,440562,1345,15,761,726,35,440562,Луганська область
12810,440563,1619,11,907,850,57,440563,Луганська область
12811,440564,1647,12,1053,958,95,440564,Луганська область
12812,440565,1816,23,1066,971,95,440565,Луганська область
12813,440566,1475,21,943,861,82,440566,Луганська область
12814,440567,1698,14,1013,955,58,440567,Луганська область
12815,440568,798,6,495,452,43,440568,Луганська область
12816,440569,2058,12,1210,1144,66,440569,Луганська область
12817,440570,579,6,342,324,18,440570,Луганська область
12818,440571,1010,13,528,488,40,440571,Луганська область
12819,440572,518,3,319,290,29,440572,Луганська область
12820,440573,461,3,248,233,15,440573,Луганська область
12821,440574,356,4,237,217,20,440574,Луганська область
12822,440575,739,4,479,457,22,440575,Луганська область
12823,440576,989,4,642,602,40,440576,Луганська область
12824,440577,1589,18,955,910,45,440577,Луганська область
12825,440578,545,6,278,250,28,440578,Луганська область
12826,440579,608,2,329,313,16,440579,Луганська область
12827,440580,337,10,236,223,13,440580,Луганська область
12828,440582,1730,17,1083,1034,49,440582,Луганська область
12829,440583,901,3,549,533,16,440583,Луганська область
12830,440584,2098,25,1340,1233,107,440584,Луганська область
12831,440585,365,6,251,235,16,440585,Луганська область
12832,440586,409,0,214,205,9,440586,Луганська область
12833,440587,406,4,295,283,12,440587,Луганська область
12834,440588,352,4,199,192,7,440588,Луганська область
12835,440589,322,3,228,212,16,440589,Луганська область
12836,440590,293,5,209,194,15,440590,Луганська область
12837,440591,204,4,144,133,11,440591,Луганська область
12838,440592,1863,11,1082,1023,59,440592,Луганська область
12839,440593,1585,10,963,928,35,440593,Луганська область
12840,440594,389,2,259,241,18,440594,Луганська область
12841,440595,1618,15,948,902,46,440595,Луганська область
12842,440596,36,0,31,27,4,440596,Луганська область
12843,440597,2043,25,1311,1221,90,440597,Луганська область
12844,440598,1200,8,709,657,52,440598,Луганська область
12845,440599,1341,21,725,677,48,440599,Луганська область
12846,440600,737,7,434,411,23,440600,Луганська область
12847,440601,261,4,190,169,21,440601,Луганська область
12848,440602,310,6,208,196,12,440602,Луганська область
12849,440603,74,0,55,53,2,440603,Луганська область
12850,440604,324,2,212,195,17,440604,Луганська область
12851,440605,333,8,232,212,20,440605,Луганська область
12852,440606,150,0,90,84,6,440606,Луганська область
12853,440607,460,6,255,248,7,440607,Луганська область
12854,440608,321,2,209,199,10,440608,Луганська область
12855,440609,757,5,523,484,39,440609,Луганська область
12856,440610,410,9,260,238,22,440610,Луганська область
12857,440611,232,1,147,142,5,440611,Луганська область
12858,440612,609,9,445,411,34,440612,Луганська область
12859,440613,248,1,174,161,13,440613,Луганська область
12860,440614,126,2,95,88,7,440614,Луганська область
12861,440615,803,14,462,439,23,440615,Луганська область
12862,440616,965,14,495,468,27,440616,Луганська область
12863,440617,432,8,274,249,25,440617,Луганська область
12864,440618,234,5,160,155,5,440618,Луганська область
12865,440619,426,4,348,334,14,440619,Луганська область
12866,440620,324,4,227,199,28,440620,Луганська область
12867,440621,301,2,212,208,4,440621,Луганська область
12868,440622,359,4,206,197,9,440622,Луганська область
12869,440623,263,7,156,139,17,440623,Луганська область
12870,440624,161,0,114,111,3,440624,Луганська область
12871,440625,166,1,109,106,3,440625,Луганська область
12872,440626,109,3,95,92,3,440626,Луганська область
12873,1,779,20,747,207,540,1,Луганська область
12874,2,372,9,357,222,135,2,Луганська область
12875,3,712,45,647,389,258,3,Луганська область
12876,440035,1056,16,693,651,42,440035,Луганська область
12877,440036,1437,11,867,823,44,440036,Луганська область
12878,440037,1444,21,892,845,47,440037,Луганська область
12879,440038,1417,20,855,792,63,440038,Луганська область
12880,440039,1154,15,661,623,38,440039,Луганська область
12881,440040,887,3,466,440,26,440040,Луганська область
12882,440041,527,7,327,298,29,440041,Луганська область
12883,440042,399,7,269,240,29,440042,Луганська область
12884,440043,1016,7,555,522,33,440043,Луганська область
12885,440044,619,8,367,338,29,440044,Луганська область
12886,440045,655,13,420,387,33,440045,Луганська область
12887,440046,181,0,127,113,14,440046,Луганська область
12888,440047,348,0,221,202,19,440047,Луганська область
12889,440048,124,2,83,78,5,440048,Луганська область
12890,440049,308,4,195,189,6,440049,Луганська область
12891,440050,588,8,360,336,24,440050,Луганська область
12892,440051,423,2,244,223,21,440051,Луганська область
12893,440052,253,1,164,161,3,440052,Луганська область
12894,440053,183,0,127,116,11,440053,Луганська область
12895,440054,204,1,144,131,13,440054,Луганська область
12896,440055,620,6,422,404,18,440055,Луганська область
12897,440056,347,2,255,249,6,440056,Луганська область
12898,440057,653,3,362,340,22,440057,Луганська область
12899,440058,209,0,113,103,10,440058,Луганська область
12900,440059,617,5,366,322,44,440059,Луганська область
12901,440060,407,6,240,221,19,440060,Луганська область
12902,440061,104,0,72,66,6,440061,Луганська область
12903,440062,871,8,572,551,21,440062,Луганська область
12904,440063,419,1,299,276,23,440063,Луганська область
12905,440064,241,1,157,153,4,440064,Луганська область
12906,440216,678,4,428,416,12,440216,Луганська область
12907,440217,1478,15,916,845,71,440217,Луганська область
12908,440218,755,7,464,421,43,440218,Луганська область
12909,440219,968,5,581,552,29,440219,Луганська область
12910,440220,730,12,469,450,19,440220,Луганська область
12911,440221,671,5,420,401,19,440221,Луганська область
12912,440222,1141,7,691,655,36,440222,Луганська область
12913,440223,369,1,231,205,26,440223,Луганська область
12914,440224,542,9,306,293,13,440224,Луганська область
12915,440225,171,2,128,117,11,440225,Луганська область
12916,440226,534,3,238,225,13,440226,Луганська область
12917,440227,522,4,321,297,24,440227,Луганська область
12918,440229,138,5,91,81,10,440229,Луганська область
12919,440230,198,2,115,104,11,440230,Луганська область
12920,440231,468,1,280,269,11,440231,Луганська область
12921,440232,356,3,257,243,14,440232,Луганська область
12922,440233,232,2,126,119,7,440233,Луганська область
12923,440234,147,2,83,75,8,440234,Луганська область
12924,440235,77,0,48,44,4,440235,Луганська область
12925,440236,319,4,191,176,15,440236,Луганська область
12926,440237,194,0,131,116,15,440237,Луганська область
12927,440238,585,2,364,354,10,440238,Луганська область
12928,440239,263,3,171,159,12,440239,Луганська область
12929,440240,1705,19,741,687,54,440240,Луганська область
12930,440242,284,0,147,137,10,440242,Луганська область
12931,440243,1147,18,571,554,17,440243,Луганська область
12932,440244,468,6,298,292,6,440244,Луганська область
12933,440245,260,2,183,180,3,440245,Луганська область
12934,440246,572,1,327,314,13,440246,Луганська область
12935,440247,279,2,177,171,6,440247,Луганська область
12936,440248,211,5,114,107,7,440248,Луганська область
12937,440249,602,8,357,342,15,440249,Луганська область
12938,440250,218,0,94,93,1,440250,Луганська область
12939,440251,160,1,110,102,8,440251,Луганська область
12940,440252,518,1,345,333,12,440252,Луганська область
12941,440253,809,10,357,342,15,440253,Луганська область
12942,440254,309,0,207,189,18,440254,Луганська область
12943,440255,240,4,135,130,5,440255,Луганська область
12944,440256,367,2,259,249,10,440256,Луганська область
12945,440286,222,0,106,93,13,440286,Луганська область
12946,440287,1191,16,590,549,41,440287,Луганська область
12947,440288,855,9,458,439,19,440288,Луганська область
12948,440289,1015,17,522,477,45,440289,Луганська область
12949,440292,1302,23,701,658,43,440292,Луганська область
12950,440297,457,2,252,239,13,440297,Луганська область
12951,440298,1121,21,662,630,32,440298,Луганська область
12952,440299,859,10,452,420,32,440299,Луганська область
12953,440300,805,6,461,432,29,440300,Луганська область
12954,440301,188,1,120,114,6,440301,Луганська область
12955,440302,2193,20,1252,1132,120,440302,Луганська область
12956,440303,2261,40,1289,1183,106,440303,Луганська область
12957,440304,2150,24,1214,1107,107,440304,Луганська область
12958,440305,945,17,605,591,14,440305,Луганська область
12959,440306,562,4,401,373,28,440306,Луганська область
12960,440308,222,0,132,126,6,440308,Луганська область
12961,440309,984,4,659,638,21,440309,Луганська область
12962,440310,569,3,366,333,33,440310,Луганська область
12963,440311,1335,24,817,755,62,440311,Луганська область
12964,440312,913,11,516,506,10,440312,Луганська область
12965,440313,1044,6,620,598,22,440313,Луганська область
12966,440314,370,7,195,176,19,440314,Луганська область
12967,440467,197,5,78,70,8,440467,Луганська область
12968,440501,1489,12,665,639,26,440501,Луганська область
12969,440502,716,14,328,302,26,440502,Луганська область
12970,440513,1350,14,322,258,64,440513,Луганська область
12971,440514,1346,4,291,238,53,440514,Луганська область
12972,440515,1260,7,332,268,64,440515,Луганська область
12973,440516,1938,22,453,405,48,440516,Луганська область
12974,440520,1007,8,183,163,20,440520,Луганська область
12975,440523,1130,16,273,246,27,440523,Луганська область
12976,440524,1926,14,411,380,31,440524,Луганська область
12977,440525,1434,12,313,282,31,440525,Луганська область
12978,440526,867,7,238,215,23,440526,Луганська область
12979,440527,1397,10,350,312,38,440527,Луганська область
12980,440528,427,1,69,58,11,440528,Луганська область
12981,440529,662,6,211,179,32,440529,Луганська область
12982,440531,479,2,149,140,9,440531,Луганська область
12983,440532,515,13,221,198,23,440532,Луганська область
12984,440533,655,8,247,233,14,440533,Луганська область
12985,440534,1307,19,482,441,41,440534,Луганська область
12986,440535,251,2,122,96,26,440535,Луганська область
12987,440536,104,2,49,40,9,440536,Луганська область
12988,440537,757,7,316,302,14,440537,Луганська область
12989,440538,221,0,96,71,25,440538,Луганська область
12990,440539,366,5,156,147,9,440539,Луганська область
12991,440540,808,13,278,249,29,440540,Луганська область
12992,440541,273,4,106,93,13,440541,Луганська область
12993,440542,218,1,104,100,4,440542,Луганська область
12994,440544,442,2,216,185,31,440544,Луганська область
12995,440545,1376,17,609,595,14,440545,Луганська область
12996,440546,514,6,236,229,7,440546,Луганська область
12997,440547,1707,17,701,670,31,440547,Луганська область
12998,440548,2139,27,942,897,45,440548,Луганська область
12999,440550,721,4,306,277,29,440550,Луганська область
13000,440551,183,2,65,50,15,440551,Луганська область
13001,440552,703,9,323,312,11,440552,Луганська область
13002,440553,163,4,46,41,5,440553,Луганська область
13003,440554,958,9,430,417,13,440554,Луганська область
13004,440555,429,2,194,174,20,440555,Луганська область
13005,440556,26,1,22,15,7,440556,Луганська область
13006,461925,1105,30,761,223,538,461925,Львівська область
13007,461926,1982,40,1225,388,837,461926,Львівська область
13008,461927,1269,13,877,245,632,461927,Львівська область
13009,461928,1361,29,902,334,568,461928,Львівська область
13010,461931,1721,27,1134,392,742,461931,Львівська область
13011,461935,1634,31,1085,344,741,461935,Львівська область
13012,461936,1607,25,978,256,722,461936,Львівська область
13013,461940,1668,27,1065,311,754,461940,Львівська область
13014,461941,2209,32,1399,463,936,461941,Львівська область
13015,461942,2141,49,1486,402,1084,461942,Львівська область
13016,461947,1753,33,1153,365,788,461947,Львівська область
13017,461948,1642,31,1077,398,679,461948,Львівська область
13018,461949,2304,56,1507,414,1093,461949,Львівська область
13019,461950,1507,20,958,328,630,461950,Львівська область
13020,461954,1783,37,1205,356,849,461954,Львівська область
13021,461955,1588,29,1067,353,714,461955,Львівська область
13022,461956,1264,22,732,336,396,461956,Львівська область
13023,461957,1519,31,1029,363,666,461957,Львівська область
13024,461958,1588,27,1071,323,748,461958,Львівська область
13025,461959,1153,30,739,263,476,461959,Львівська область
13026,461962,2355,39,1598,467,1131,461962,Львівська область
13027,461963,2185,42,1470,391,1079,461963,Львівська область
13028,461964,1573,27,1080,196,884,461964,Львівська область
13029,461965,2099,29,1315,377,938,461965,Львівська область
13030,461966,1857,27,1244,312,932,461966,Львівська область
13031,461967,1674,25,1060,336,724,461967,Львівська область
13032,461968,2325,32,1535,400,1135,461968,Львівська область
13033,461969,1308,11,884,197,687,461969,Львівська область
13034,461970,28,1,26,7,19,461970,Львівська область
13035,461971,43,1,34,9,25,461971,Львівська область
13036,461972,157,1,133,41,92,461972,Львівська область
13037,461973,38,2,35,10,25,461973,Львівська область
13038,461974,158,6,133,34,99,461974,Львівська область
13039,461975,203,3,191,53,138,461975,Львівська область
13040,461976,1897,50,1319,385,934,461976,Львівська область
13041,461977,1947,42,1280,354,926,461977,Львівська область
13042,461978,1859,22,1197,322,875,461978,Львівська область
13043,461979,1682,18,1090,301,789,461979,Львівська область
13044,461980,2379,46,1587,407,1180,461980,Львівська область
13045,461981,1226,14,609,209,400,461981,Львівська область
13046,461982,2233,40,1429,491,938,461982,Львівська область
13047,461983,2174,45,1452,521,931,461983,Львівська область
13048,461984,2373,50,1456,392,1064,461984,Львівська область
13049,461985,2555,47,1807,427,1380,461985,Львівська область
13050,461986,2006,54,1334,307,1027,461986,Львівська область
13051,461987,1264,26,862,256,606,461987,Львівська область
13052,461988,2011,35,1417,353,1064,461988,Львівська область
13053,461989,1957,35,1310,439,871,461989,Львівська область
13054,461990,1984,37,1345,357,988,461990,Львівська область
13055,461991,1458,25,1011,252,759,461991,Львівська область
13056,461992,2165,31,1407,368,1039,461992,Львівська область
13057,461993,1705,37,1174,359,815,461993,Львівська область
13058,461994,1894,31,1388,268,1120,461994,Львівська область
13059,461995,1743,41,1191,327,864,461995,Львівська область
13060,461996,2162,33,1485,416,1069,461996,Львівська область
13061,461997,2106,31,1478,407,1071,461997,Львівська область
13062,461998,2327,49,1582,388,1194,461998,Львівська область
13063,461999,2064,36,1407,383,1024,461999,Львівська область
13064,462000,1936,35,1341,393,948,462000,Львівська область
13065,462001,2297,52,1552,417,1135,462001,Львівська область
13066,462002,2270,50,1592,440,1152,462002,Львівська область
13067,462003,2404,51,1628,474,1154,462003,Львівська область
13068,462004,2286,37,1600,431,1169,462004,Львівська область
13069,462005,2220,48,1485,454,1031,462005,Львівська область
13070,462006,2055,31,1503,378,1125,462006,Львівська область
13071,462007,2137,35,1483,432,1051,462007,Львівська область
13072,462008,2066,28,1408,392,1016,462008,Львівська область
13073,462009,2381,49,1625,449,1176,462009,Львівська область
13074,462010,2354,48,1451,527,924,462010,Львівська область
13075,462011,2364,40,1614,447,1167,462011,Львівська область
13076,462012,2237,42,1502,449,1053,462012,Львівська область
13077,462013,2087,33,1363,370,993,462013,Львівська область
13078,462014,1372,27,943,313,630,462014,Львівська область
13079,462015,2050,35,1424,393,1031,462015,Львівська область
13080,462016,2016,41,1448,370,1078,462016,Львівська область
13081,462017,2288,32,1541,409,1132,462017,Львівська область
13082,462018,2464,42,1725,418,1307,462018,Львівська область
13083,462019,2337,44,1602,404,1198,462019,Львівська область
13084,462020,1855,32,1289,375,914,462020,Львівська область
13085,462021,1948,34,1393,395,998,462021,Львівська область
13086,462022,2413,45,1698,429,1269,462022,Львівська область
13087,462023,2442,40,1790,418,1372,462023,Львівська область
13088,462024,2338,38,1703,437,1266,462024,Львівська область
13089,462025,2285,41,1630,410,1220,462025,Львівська область
13090,462026,2404,34,1720,480,1240,462026,Львівська область
13091,462027,2232,30,1472,516,956,462027,Львівська область
13092,462028,2292,33,1535,526,1009,462028,Львівська область
13093,462029,2510,42,1659,529,1130,462029,Львівська область
13094,462030,2441,41,1519,497,1022,462030,Львівська область
13095,462031,154,3,134,53,81,462031,Львівська область
13096,462032,200,4,164,59,105,462032,Львівська область
13097,462033,59,1,51,18,33,462033,Львівська область
13098,462034,63,1,57,18,39,462034,Львівська область
13099,462159,1644,24,1094,290,804,462159,Львівська область
13100,461876,2295,51,1517,416,1101,461876,Львівська область
13101,461877,1366,27,931,178,753,461877,Львівська область
13102,461878,2309,49,1597,497,1100,461878,Львівська область
13103,461879,2293,52,1619,381,1238,461879,Львівська область
13104,461880,1964,48,1245,357,888,461880,Львівська область
13105,461881,2113,31,1394,419,975,461881,Львівська область
13106,461882,1954,42,1225,372,853,461882,Львівська область
13107,461883,2176,46,1317,439,878,461883,Львівська область
13108,461884,2432,51,1613,504,1109,461884,Львівська область
13109,461885,2340,52,1425,505,920,461885,Львівська область
13110,461886,2331,58,1493,507,986,461886,Львівська область
13111,461887,2160,32,1527,433,1094,461887,Львівська область
13112,461888,2094,39,1422,399,1023,461888,Львівська область
13113,461889,2106,63,1418,408,1010,461889,Львівська область
13114,461890,2213,40,1535,434,1101,461890,Львівська область
13115,461891,1962,31,1310,353,957,461891,Львівська область
13116,461892,1996,52,1347,364,983,461892,Львівська область
13117,461893,2162,53,1477,481,996,461893,Львівська область
13118,461894,2222,36,1486,406,1080,461894,Львівська область
13119,461895,2316,50,1490,478,1012,461895,Львівська область
13120,461896,2313,39,1507,455,1052,461896,Львівська область
13121,461897,2015,36,1349,369,980,461897,Львівська область
13122,461898,2227,35,1478,469,1009,461898,Львівська область
13123,461899,2232,48,1458,508,950,461899,Львівська область
13124,461900,2227,42,1452,440,1012,461900,Львівська область
13125,461901,2281,71,1493,494,999,461901,Львівська область
13126,461902,2104,45,1344,403,941,461902,Львівська область
13127,461903,2159,47,1478,417,1061,461903,Львівська область
13128,461904,2237,47,1551,428,1123,461904,Львівська область
13129,461905,2383,35,1499,460,1039,461905,Львівська область
13130,461906,2112,33,1451,359,1092,461906,Львівська область
13131,461907,2381,55,1642,450,1192,461907,Львівська область
13132,461908,2249,29,1438,377,1061,461908,Львівська область
13133,461909,1718,33,1267,335,932,461909,Львівська область
13134,461910,2029,46,1410,406,1004,461910,Львівська область
13135,461911,2143,49,1377,386,991,461911,Львівська область
13136,461912,2089,41,1368,425,943,461912,Львівська область
13137,461913,2133,43,1344,417,927,461913,Львівська область
13138,461914,2209,41,1311,366,945,461914,Львівська область
13139,461915,2042,50,1399,374,1025,461915,Львівська область
13140,461916,2269,48,1541,397,1144,461916,Львівська область
13141,461917,2192,47,1471,413,1058,461917,Львівська область
13142,461918,2291,48,1607,462,1145,461918,Львівська область
13143,461919,1987,32,1382,403,979,461919,Львівська область
13144,461920,2298,30,1513,411,1102,461920,Львівська область
13145,461921,2237,51,1522,412,1110,461921,Львівська область
13146,461922,1884,40,1244,242,1002,461922,Львівська область
13147,461923,1801,28,1255,287,968,461923,Львівська область
13148,461924,2134,35,1476,340,1136,461924,Львівська область
13149,462109,2182,39,1244,425,819,462109,Львівська область
13150,462110,2411,60,1656,355,1301,462110,Львівська область
13151,462111,2448,43,1552,420,1132,462111,Львівська область
13152,462112,2446,47,1613,431,1182,462112,Львівська область
13153,462113,2187,45,1396,414,982,462113,Львівська область
13154,462119,2239,45,1421,444,977,462119,Львівська область
13155,462120,2422,48,1614,396,1218,462120,Львівська область
13156,462121,1984,43,1414,306,1108,462121,Львівська область
13157,462122,2431,36,1608,533,1075,462122,Львівська область
13158,462123,2213,50,1401,396,1005,462123,Львівська область
13159,462124,2169,28,1406,399,1007,462124,Львівська область
13160,462125,2207,36,1497,410,1087,462125,Львівська область
13161,462126,1903,34,1303,322,981,462126,Львівська область
13162,462127,2170,57,1481,367,1114,462127,Львівська область
13163,462128,2379,47,1535,403,1132,462128,Львівська область
13164,462129,2070,37,1409,312,1097,462129,Львівська область
13165,462137,2360,51,1538,348,1190,462137,Львівська область
13166,462138,2169,42,1446,364,1082,462138,Львівська область
13167,462139,2048,39,1276,341,935,462139,Львівська область
13168,462140,2330,49,1621,323,1298,462140,Львівська область
13169,462141,1575,28,1069,255,814,462141,Львівська область
13170,462142,2206,36,1393,354,1039,462142,Львівська область
13171,462143,2245,44,1568,348,1220,462143,Львівська область
13172,462144,2346,44,1566,405,1161,462144,Львівська область
13173,462145,2171,38,1414,390,1024,462145,Львівська область
13174,462146,2206,33,1531,364,1167,462146,Львівська область
13175,462147,1806,31,1250,279,971,462147,Львівська область
13176,462148,2019,41,1275,343,932,462148,Львівська область
13177,462149,1974,40,1307,394,913,462149,Львівська область
13178,462150,1906,37,1181,289,892,462150,Львівська область
13179,462154,1312,21,875,224,651,462154,Львівська область
13180,462164,534,14,365,118,247,462164,Львівська область
13181,1,822,93,729,626,103,1,Львівська область
13182,461848,2019,32,1272,472,800,461848,Львівська область
13183,461849,2052,42,1309,422,887,461849,Львівська область
13184,461850,1490,25,995,422,573,461850,Львівська область
13185,461851,1653,38,1021,359,662,461851,Львівська область
13186,461852,1415,37,852,285,567,461852,Львівська область
13187,461853,1623,25,999,347,652,461853,Львівська область
13188,461854,1980,29,1256,422,834,461854,Львівська область
13189,461855,2075,36,1258,357,901,461855,Львівська область
13190,461856,2196,38,1300,444,856,461856,Львівська область
13191,461857,2169,27,1313,412,901,461857,Львівська область
13192,461858,1477,33,933,271,662,461858,Львівська область
13193,461859,923,19,557,188,369,461859,Львівська область
13194,461860,1461,24,958,284,674,461860,Львівська область
13195,461861,1833,38,1231,380,851,461861,Львівська область
13196,461862,1659,34,1091,348,743,461862,Львівська область
13197,461863,2036,38,1310,499,811,461863,Львівська область
13198,461864,1487,33,961,363,598,461864,Львівська область
13199,461865,1698,32,1126,373,753,461865,Львівська область
13200,461866,2011,40,1302,451,851,461866,Львівська область
13201,461867,2074,53,1372,474,898,461867,Львівська область
13202,461868,1859,43,1241,414,827,461868,Львівська область
13203,461869,1949,62,1267,491,776,461869,Львівська область
13204,461870,1298,39,858,325,533,461870,Львівська область
13205,461871,1419,23,883,247,636,461871,Львівська область
13206,461872,73,0,70,22,48,461872,Львівська область
13207,461873,177,4,145,59,86,461873,Львівська область
13208,461874,101,1,96,34,62,461874,Львівська область
13209,461875,24,0,24,6,18,461875,Львівська область
13210,462036,2104,51,1410,460,950,462036,Львівська область
13211,462037,1783,30,1125,442,683,462037,Львівська область
13212,462038,2096,38,1405,491,914,462038,Львівська область
13213,462039,2053,41,1417,517,900,462039,Львівська область
13214,462040,1793,29,1053,414,639,462040,Львівська область
13215,462041,1828,50,1252,509,743,462041,Львівська область
13216,462042,1586,46,1246,333,913,462042,Львівська область
13217,462043,1889,35,1216,398,818,462043,Львівська область
13218,462044,1893,35,1269,459,810,462044,Львівська область
13219,462045,2054,40,1270,418,852,462045,Львівська область
13220,462046,1908,37,1229,422,807,462046,Львівська область
13221,462047,1479,33,968,365,603,462047,Львівська область
13222,462048,1592,33,1017,362,655,462048,Львівська область
13223,462049,1715,34,1118,337,781,462049,Львівська область
13224,462050,2003,36,1293,372,921,462050,Львівська область
13225,462051,2401,51,1536,506,1030,462051,Львівська область
13226,462052,2097,29,1124,528,596,462052,Львівська область
13227,462053,2208,60,1551,532,1019,462053,Львівська область
13228,462054,2121,40,1507,519,988,462054,Львівська область
13229,462055,2359,47,1391,660,731,462055,Львівська область
13230,462056,2527,37,1306,580,726,462056,Львівська область
13231,462057,2120,40,1190,534,656,462057,Львівська область
13232,462058,2710,38,1866,646,1220,462058,Львівська область
13233,462059,2053,36,1206,455,751,462059,Львівська область
13234,462060,2394,58,1520,566,954,462060,Львівська область
13235,462061,1865,46,1268,388,880,462061,Львівська область
13236,462062,1890,39,1236,340,896,462062,Львівська область
13237,462063,1707,53,1205,300,905,462063,Львівська область
13238,462064,1821,33,1111,322,789,462064,Львівська область
13239,462065,2366,35,1682,445,1237,462065,Львівська область
13240,462066,2303,41,1489,369,1120,462066,Львівська область
13241,462067,1826,44,1175,372,803,462067,Львівська область
13242,462068,1552,38,1078,320,758,462068,Львівська область
13243,462069,1836,31,1226,456,770,462069,Львівська область
13244,462070,1790,36,1239,392,847,462070,Львівська область
13245,462071,1818,32,1189,331,858,462071,Львівська область
13246,462072,1925,32,1308,382,926,462072,Львівська область
13247,462073,2224,37,1601,412,1189,462073,Львівська область
13248,462074,1650,38,1071,284,787,462074,Львівська область
13249,462075,1969,42,1340,322,1018,462075,Львівська область
13250,462076,1778,31,1197,389,808,462076,Львівська область
13251,462077,2018,56,1346,380,966,462077,Львівська область
13252,462078,1975,44,1323,385,938,462078,Львівська область
13253,462079,1495,26,1043,330,713,462079,Львівська область
13254,462080,2072,43,1349,398,951,462080,Львівська область
13255,462081,1924,36,1322,391,931,462081,Львівська область
13256,462082,1456,25,946,230,716,462082,Львівська область
13257,462083,1910,42,1266,316,950,462083,Львівська область
13258,462084,1470,42,951,257,694,462084,Львівська область
13259,462085,1704,28,1163,349,814,462085,Львівська область
13260,462086,2003,35,1355,339,1016,462086,Львівська область
13261,462087,2426,46,1585,488,1097,462087,Львівська область
13262,462088,2402,50,1630,466,1164,462088,Львівська область
13263,462089,2126,54,1410,383,1027,462089,Львівська область
13264,462090,2290,50,1580,452,1128,462090,Львівська область
13265,462091,88,0,71,23,48,462091,Львівська область
13266,462093,135,6,119,31,88,462093,Львівська область
13267,462094,669,31,539,169,370,462094,Львівська область
13268,462130,2177,41,1505,587,918,462130,Львівська область
13269,462131,1510,17,977,343,634,462131,Львівська область
13270,462132,1154,27,719,284,435,462132,Львівська область
13271,462133,1272,28,845,320,525,462133,Львівська область
13272,462134,2316,35,1521,437,1084,462134,Львівська область
13273,462135,2272,50,1349,427,922,462135,Львівська область
13274,462136,1797,32,1149,397,752,462136,Львівська область
13275,462153,1077,11,333,133,200,462153,Львівська область
13276,462156,1436,12,957,387,570,462156,Львівська область
13277,462158,1356,20,979,261,718,462158,Львівська область
13278,460904,2378,39,1699,373,1326,460904,Львівська область
13279,460905,2149,44,1485,308,1177,460905,Львівська область
13280,460906,1942,52,1320,253,1067,460906,Львівська область
13281,460907,2141,49,1424,253,1171,460907,Львівська область
13282,460908,682,12,535,128,407,460908,Львівська область
13283,460909,2476,43,1704,357,1347,460909,Львівська область
13284,460910,935,14,705,153,552,460910,Львівська область
13285,460911,1880,37,1367,300,1067,460911,Львівська область
13286,460912,1575,18,1079,230,849,460912,Львівська область
13287,460913,1685,42,1123,261,862,460913,Львівська область
13288,460914,743,12,504,121,383,460914,Львівська область
13289,460915,926,17,710,100,610,460915,Львівська область
13290,460916,1116,20,799,144,655,460916,Львівська область
13291,460917,1737,26,1168,259,909,460917,Львівська область
13292,460918,2324,43,1663,288,1375,460918,Львівська область
13293,460919,1750,24,1147,290,857,460919,Львівська область
13294,460920,1842,35,1246,292,954,460920,Львівська область
13295,460921,1919,26,1170,258,912,460921,Львівська область
13296,460922,1739,26,1198,268,930,460922,Львівська область
13297,460923,1334,14,989,222,767,460923,Львівська область
13298,460924,1193,13,876,201,675,460924,Львівська область
13299,460925,744,17,578,160,418,460925,Львівська область
13300,460926,378,6,285,70,215,460926,Львівська область
13301,460927,1648,38,1184,234,950,460927,Львівська область
13302,460928,259,10,212,39,173,460928,Львівська область
13303,460929,1105,21,716,153,563,460929,Львівська область
13304,460930,1577,22,1112,246,866,460930,Львівська область
13305,460931,1474,15,1082,204,878,460931,Львівська область
13306,460932,418,13,286,52,234,460932,Львівська область
13307,460933,136,2,122,20,102,460933,Львівська область
13308,460934,270,2,194,37,157,460934,Львівська область
13309,460935,72,0,52,8,44,460935,Львівська область
13310,460936,70,1,44,6,38,460936,Львівська область
13311,460937,208,9,172,27,145,460937,Львівська область
13312,460938,790,10,586,144,442,460938,Львівська область
13313,460939,435,3,373,74,299,460939,Львівська область
13314,460940,236,1,205,29,176,460940,Львівська область
13315,460941,243,11,216,37,179,460941,Львівська область
13316,460942,533,8,395,108,287,460942,Львівська область
13317,460943,469,5,337,70,267,460943,Львівська область
13318,460944,456,4,337,82,255,460944,Львівська область
13319,460945,109,1,92,30,62,460945,Львівська область
13320,460946,496,11,382,92,290,460946,Львівська область
13321,460947,1723,21,1172,270,902,460947,Львівська область
13322,460948,2024,42,1422,320,1102,460948,Львівська область
13323,460949,1296,43,863,330,533,460949,Львівська область
13324,460950,923,19,756,281,475,460950,Львівська область
13325,460951,457,3,286,68,218,460951,Львівська область
13326,460952,323,6,246,36,210,460952,Львівська область
13327,460953,193,7,163,9,154,460953,Львівська область
13328,460954,228,4,169,28,141,460954,Львівська область
13329,460955,123,3,101,8,93,460955,Львівська область
13330,460956,134,1,120,18,102,460956,Львівська область
13331,460957,106,2,93,25,68,460957,Львівська область
13332,460958,577,29,459,53,406,460958,Львівська область
13333,460959,416,11,366,47,319,460959,Львівська область
13334,460960,1478,19,1164,150,1014,460960,Львівська область
13335,460961,1383,23,1096,190,906,460961,Львівська область
13336,460962,911,11,727,112,615,460962,Львівська область
13337,460963,2051,159,1380,200,1180,460963,Львівська область
13338,460964,1895,44,1377,273,1104,460964,Львівська область
13339,460965,223,11,167,31,136,460965,Львівська область
13340,460966,1225,32,849,224,625,460966,Львівська область
13341,460967,433,5,327,61,266,460967,Львівська область
13342,460968,483,6,312,63,249,460968,Львівська область
13343,460969,904,18,698,139,559,460969,Львівська область
13344,460970,637,21,535,64,471,460970,Львівська область
13345,460971,588,16,439,90,349,460971,Львівська область
13346,460972,245,0,232,29,203,460972,Львівська область
13347,460973,123,0,108,14,94,460973,Львівська область
13348,460974,520,10,392,105,287,460974,Львівська область
13349,460975,318,11,266,29,237,460975,Львівська область
13350,460976,250,0,180,40,140,460976,Львівська область
13351,460977,1938,60,1318,271,1047,460977,Львівська область
13352,460978,602,11,441,156,285,460978,Львівська область
13353,460979,952,31,788,81,707,460979,Львівська область
13354,460980,73,2,59,12,47,460980,Львівська область
13355,460981,362,32,285,64,221,460981,Львівська область
13356,460982,293,2,271,19,252,460982,Львівська область
13357,460983,340,7,275,22,253,460983,Львівська область
13358,460984,952,23,830,126,704,460984,Львівська область
13359,460985,780,41,691,63,628,460985,Львівська область
13360,460986,449,2,362,80,282,460986,Львівська область
13361,460987,1981,35,1450,310,1140,460987,Львівська область
13362,460988,2306,69,1713,321,1392,460988,Львівська область
13363,460989,1548,16,1055,226,829,460989,Львівська область
13364,460990,275,2,210,31,179,460990,Львівська область
13365,460991,1180,17,798,165,633,460991,Львівська область
13366,460992,2011,34,1339,315,1024,460992,Львівська область
13367,460993,1548,19,1042,304,738,460993,Львівська область
13368,460994,1228,16,842,185,657,460994,Львівська область
13369,460995,1682,23,1240,218,1022,460995,Львівська область
13370,460996,1097,23,833,174,659,460996,Львівська область
13371,460997,349,7,294,57,237,460997,Львівська область
13372,460998,177,1,135,38,97,460998,Львівська область
13373,460999,648,8,457,123,334,460999,Львівська область
13374,461000,485,2,444,42,402,461000,Львівська область
13375,461001,168,1,131,17,114,461001,Львівська область
13376,461002,319,1,275,26,249,461002,Львівська область
13377,461929,2153,40,1500,371,1129,461929,Львівська область
13378,461930,2109,28,1426,329,1097,461930,Львівська область
13379,461933,1336,25,965,235,730,461933,Львівська область
13380,461934,1662,39,1084,244,840,461934,Львівська область
13381,461937,2453,47,1719,421,1298,461937,Львівська область
13382,461938,2070,34,1364,227,1137,461938,Львівська область
13383,461939,2422,43,1600,386,1214,461939,Львівська область
13384,461943,1970,35,1294,251,1043,461943,Львівська область
13385,461944,2248,50,1427,374,1053,461944,Львівська область
13386,461945,1239,21,788,326,462,461945,Львівська область
13387,461946,2274,41,1480,401,1079,461946,Львівська область
13388,461951,2192,42,1424,473,951,461951,Львівська область
13389,461952,2107,49,1306,455,851,461952,Львівська область
13390,461953,2214,32,1402,376,1026,461953,Львівська область
13391,461960,2469,53,1475,354,1121,461960,Львівська область
13392,461961,2391,46,1465,426,1039,461961,Львівська область
13393,462095,1979,43,1196,395,801,462095,Львівська область
13394,462096,2062,43,1288,417,871,462096,Львівська область
13395,462097,2136,31,1319,437,882,462097,Львівська область
13396,462098,2248,36,1523,470,1053,462098,Львівська область
13397,462099,1618,31,986,336,650,462099,Львівська область
13398,462100,1893,50,1113,373,740,462100,Львівська область
13399,462101,1279,29,737,268,469,462101,Львівська область
13400,462102,1998,37,1318,324,994,462102,Львівська область
13401,462103,2478,55,1674,450,1224,462103,Львівська область
13402,462104,2350,56,1624,471,1153,462104,Львівська область
13403,462105,2442,56,1658,463,1195,462105,Львівська область
13404,462106,2448,50,1660,453,1207,462106,Львівська область
13405,462107,2456,57,1675,525,1150,462107,Львівська область
13406,462108,2414,57,1610,379,1231,462108,Львівська область
13407,462114,2565,59,1713,471,1242,462114,Львівська область
13408,462115,2435,28,1461,367,1094,462115,Львівська область
13409,462116,2224,50,1357,414,943,462116,Львівська область
13410,462117,2224,40,1432,408,1024,462117,Львівська область
13411,462118,2172,38,1434,433,1001,462118,Львівська область
13412,462151,441,13,367,106,261,462151,Львівська область
13413,462152,674,47,620,533,87,462152,Львівська область
13414,462157,1377,20,995,162,833,462157,Львівська область
13415,462160,1285,15,1038,159,879,462160,Львівська область
13416,462162,614,12,447,139,308,462162,Львівська область
13417,460001,2171,24,1314,561,753,460001,Львівська область
13418,460002,1742,36,1014,358,656,460002,Львівська область
13419,460003,1484,17,893,291,602,460003,Львівська область
13420,460004,1712,25,992,426,566,460004,Львівська область
13421,460005,1965,26,1239,427,812,460005,Львівська область
13422,460006,2242,34,1332,550,782,460006,Львівська область
13423,460007,1825,33,1067,393,674,460007,Львівська область
13424,460008,2229,32,1354,540,814,460008,Львівська область
13425,460009,1957,29,1224,488,736,460009,Львівська область
13426,460010,317,3,255,101,154,460010,Львівська область
13427,460011,327,7,269,106,163,460011,Львівська область
13428,460012,122,0,87,22,65,460012,Львівська область
13429,460013,112,0,90,30,60,460013,Львівська область
13430,460014,301,1,224,98,126,460014,Львівська область
13431,460015,208,2,163,91,72,460015,Львівська область
13432,460016,267,9,205,58,147,460016,Львівська область
13433,460017,452,7,319,126,193,460017,Львівська область
13434,460018,371,9,270,132,138,460018,Львівська область
13435,460019,325,2,244,68,176,460019,Львівська область
13436,460020,366,5,221,111,110,460020,Львівська область
13437,460021,590,6,371,85,286,460021,Львівська область
13438,460022,100,1,61,20,41,460022,Львівська область
13439,460023,748,6,514,252,262,460023,Львівська область
13440,460024,459,7,359,199,160,460024,Львівська область
13441,460025,426,5,285,122,163,460025,Львівська область
13442,460026,329,7,204,135,69,460026,Львівська область
13443,460027,410,1,296,141,155,460027,Львівська область
13444,460028,62,2,42,20,22,460028,Львівська область
13445,460029,803,32,564,258,306,460029,Львівська область
13446,460030,151,5,97,62,35,460030,Львівська область
13447,460031,94,3,60,29,31,460031,Львівська область
13448,460032,467,9,344,141,203,460032,Львівська область
13449,460033,431,2,345,102,243,460033,Львівська область
13450,460034,148,6,112,45,67,460034,Львівська область
13451,460035,342,0,230,100,130,460035,Львівська область
13452,460036,323,1,245,87,158,460036,Львівська область
13453,460037,269,7,195,92,103,460037,Львівська область
13454,460038,143,3,100,51,49,460038,Львівська область
13455,460039,296,3,253,91,162,460039,Львівська область
13456,460040,141,2,111,48,63,460040,Львівська область
13457,460041,127,2,86,46,40,460041,Львівська область
13458,460042,383,15,243,95,148,460042,Львівська область
13459,460043,262,3,186,69,117,460043,Львівська область
13460,460044,221,5,138,41,97,460044,Львівська область
13461,460045,300,6,219,68,151,460045,Львівська область
13462,460046,445,3,263,116,147,460046,Львівська область
13463,460047,1552,28,918,298,620,460047,Львівська область
13464,460048,102,4,74,23,51,460048,Львівська область
13465,460049,537,10,349,159,190,460049,Львівська область
13466,460050,349,3,229,102,127,460050,Львівська область
13467,460051,148,0,112,48,64,460051,Львівська область
13468,460052,338,2,222,116,106,460052,Львівська область
13469,460053,127,0,110,33,77,460053,Львівська область
13470,460054,1138,11,826,370,456,460054,Львівська область
13471,460055,187,0,124,34,90,460055,Львівська область
13472,460056,352,9,260,139,121,460056,Львівська область
13473,460057,196,4,156,61,95,460057,Львівська область
13474,460058,463,4,326,171,155,460058,Львівська область
13475,460059,601,13,412,176,236,460059,Львівська область
13476,460060,177,2,125,62,63,460060,Львівська область
13477,460061,375,7,260,110,150,460061,Львівська область
13478,460062,285,3,216,96,120,460062,Львівська область
13479,460063,117,0,101,31,70,460063,Львівська область
13480,460064,118,1,80,34,46,460064,Львівська область
13481,460065,562,8,425,180,245,460065,Львівська область
13482,460066,349,4,231,69,162,460066,Львівська область
13483,460067,217,2,150,40,110,460067,Львівська область
13484,460068,101,1,71,30,41,460068,Львівська область
13485,460069,167,3,127,44,83,460069,Львівська область
13486,460070,855,21,670,330,340,460070,Львівська область
13487,460071,83,1,44,19,25,460071,Львівська область
13488,460072,213,0,126,43,83,460072,Львівська область
13489,460073,550,5,435,183,252,460073,Львівська область
13490,460074,325,6,220,89,131,460074,Львівська область
13491,460075,400,1,289,115,174,460075,Львівська область
13492,460076,223,2,159,56,103,460076,Львівська область
13493,460077,214,8,145,63,82,460077,Львівська область
13494,460078,277,0,214,52,162,460078,Львівська область
13495,460079,928,17,664,215,449,460079,Львівська область
13496,460080,493,10,390,147,243,460080,Львівська область
13497,460081,206,5,140,74,66,460081,Львівська область
13498,460082,838,9,526,204,322,460082,Львівська область
13499,460083,475,6,353,165,188,460083,Львівська область
13500,460084,376,2,273,123,150,460084,Львівська область
13501,460085,572,4,415,187,228,460085,Львівська область
13502,460086,49,1,36,13,23,460086,Львівська область
13503,460087,1069,25,745,233,512,460087,Львівська область
13504,460088,268,4,211,80,131,460088,Львівська область
13505,460089,527,21,425,108,317,460089,Львівська область
13506,460090,443,6,314,134,180,460090,Львівська область
13507,460091,165,3,136,86,50,460091,Львівська область
13508,460092,530,9,312,84,228,460092,Львівська область
13509,460093,273,5,176,71,105,460093,Львівська область
13510,460094,219,3,165,74,91,460094,Львівська область
13511,460095,1589,17,1045,522,523,460095,Львівська область
13512,460096,1601,27,968,455,513,460096,Львівська область
13513,460097,2327,33,1615,692,923,460097,Львівська область
13514,460098,1159,27,712,350,362,460098,Львівська область
13515,460099,321,6,224,90,134,460099,Львівська область
13516,460100,863,10,660,204,456,460100,Львівська область
13517,460101,1337,10,973,226,747,460101,Львівська область
13518,460102,433,5,288,61,227,460102,Львівська область
13519,460103,213,4,174,33,141,460103,Львівська область
13520,460104,504,12,346,149,197,460104,Львівська область
13521,460105,234,2,184,79,105,460105,Львівська область
13522,460106,2161,42,1401,519,882,460106,Львівська область
13523,460107,1515,34,1140,432,708,460107,Львівська область
13524,460108,1168,26,697,273,424,460108,Львівська область
13525,460109,207,10,119,54,65,460109,Львівська область
13526,460110,339,4,257,70,187,460110,Львівська область
13527,460111,387,6,319,115,204,460111,Львівська область
13528,460112,294,3,203,52,151,460112,Львівська область
13529,460113,131,1,97,41,56,460113,Львівська область
13530,460114,118,3,78,30,48,460114,Львівська область
13531,460115,166,2,115,72,43,460115,Львівська область
13532,460116,626,13,489,155,334,460116,Львівська область
13533,460117,366,4,251,83,168,460117,Львівська область
13534,460118,230,9,133,46,87,460118,Львівська область
13535,460119,887,9,653,213,440,460119,Львівська область
13536,460120,485,3,377,76,301,460120,Львівська область
13537,460121,369,0,304,108,196,460121,Львівська область
13538,460122,315,2,233,63,170,460122,Львівська область
13539,460123,160,1,114,36,78,460123,Львівська область
13540,460124,258,3,180,41,139,460124,Львівська область
13541,460125,1580,23,1044,493,551,460125,Львівська область
13542,460126,342,9,238,107,131,460126,Львівська область
13543,460127,165,1,130,56,74,460127,Львівська область
13544,460128,1089,41,699,291,408,460128,Львівська область
13545,460129,219,2,151,47,104,460129,Львівська область
13546,460130,127,1,88,35,53,460130,Львівська область
13547,460131,324,14,208,56,152,460131,Львівська область
13548,460132,782,18,533,204,329,460132,Львівська область
13549,460133,661,9,449,67,382,460133,Львівська область
13550,460134,566,9,421,149,272,460134,Львівська область
13551,460135,484,6,308,114,194,460135,Львівська область
13552,460136,220,3,183,107,76,460136,Львівська область
13553,460137,304,0,238,114,124,460137,Львівська область
13554,460138,595,9,390,174,216,460138,Львівська область
13555,460139,1101,20,705,331,374,460139,Львівська область
13556,460140,136,1,109,38,71,460140,Львівська область
13557,460141,241,0,202,99,103,460141,Львівська область
13558,460142,392,4,283,121,162,460142,Львівська область
13559,460143,423,6,378,177,201,460143,Львівська область
13560,460144,625,11,375,173,202,460144,Львівська область
13561,460145,451,6,312,152,160,460145,Львівська область
13562,460146,180,3,101,36,65,460146,Львівська область
13563,460147,581,16,402,193,209,460147,Львівська область
13564,460148,50,0,48,20,28,460148,Львівська область
13565,460614,2084,41,1286,434,852,460614,Львівська область
13566,460615,2328,43,1372,528,844,460615,Львівська область
13567,460616,2276,39,1384,502,882,460616,Львівська область
13568,460617,2207,31,1399,525,874,460617,Львівська область
13569,460618,340,4,212,78,134,460618,Львівська область
13570,460622,2284,35,1516,372,1144,460622,Львівська область
13571,460623,2190,27,1467,423,1044,460623,Львівська область
13572,460625,523,13,337,132,205,460625,Львівська область
13573,460626,930,19,638,154,484,460626,Львівська область
13574,460627,526,11,389,122,267,460627,Львівська область
13575,460628,533,14,362,115,247,460628,Львівська область
13576,460629,260,6,198,63,135,460629,Львівська область
13577,460630,1036,9,663,278,385,460630,Львівська область
13578,460631,264,2,192,69,123,460631,Львівська область
13579,460632,39,2,25,8,17,460632,Львівська область
13580,460633,221,1,193,42,151,460633,Львівська область
13581,460634,228,2,185,77,108,460634,Львівська область
13582,460635,178,3,146,51,95,460635,Львівська область
13583,460636,400,0,312,130,182,460636,Львівська область
13584,460637,902,10,575,183,392,460637,Львівська область
13585,460638,178,0,131,37,94,460638,Львівська область
13586,460639,180,2,125,28,97,460639,Львівська область
13587,460640,592,44,397,81,316,460640,Львівська область
13588,460641,204,2,178,31,147,460641,Львівська область
13589,460642,494,6,334,124,210,460642,Львівська область
13590,460643,155,5,120,34,86,460643,Львівська область
13591,460649,1093,7,768,211,557,460649,Львівська область
13592,460650,1593,19,1042,250,792,460650,Львівська область
13593,460651,451,4,343,99,244,460651,Львівська область
13594,460652,112,5,79,37,42,460652,Львівська область
13595,460653,671,2,542,75,467,460653,Львівська область
13596,460658,785,10,586,133,453,460658,Львівська область
13597,460663,1543,28,1014,316,698,460663,Львівська область
13598,460664,410,7,290,84,206,460664,Львівська область
13599,460670,1413,20,888,230,658,460670,Львівська область
13600,460671,279,10,189,59,130,460671,Львівська область
13601,460672,409,7,327,60,267,460672,Львівська область
13602,460673,164,0,125,27,98,460673,Львівська область
13603,460674,750,8,531,148,383,460674,Львівська область
13604,460675,286,4,189,50,139,460675,Львівська область
13605,460676,163,1,132,42,90,460676,Львівська область
13606,460677,94,0,77,46,31,460677,Львівська область
13607,460678,226,3,164,44,120,460678,Львівська область
13608,460679,80,2,75,29,46,460679,Львівська область
13609,461003,2348,45,1352,691,661,461003,Львівська область
13610,461004,2302,31,1496,757,739,461004,Львівська область
13611,461005,2382,35,1417,723,694,461005,Львівська область
13612,461006,2394,59,1533,953,580,461006,Львівська область
13613,461007,237,2,153,62,91,461007,Львівська область
13614,461008,680,15,516,299,217,461008,Львівська область
13615,461009,386,8,290,101,189,461009,Львівська область
13616,461010,597,7,371,148,223,461010,Львівська область
13617,461011,224,1,173,129,44,461011,Львівська область
13618,461012,133,2,84,45,39,461012,Львівська область
13619,461013,145,0,122,57,65,461013,Львівська область
13620,461014,1195,11,820,319,501,461014,Львівська область
13621,461015,354,4,274,115,159,461015,Львівська область
13622,461016,502,9,382,145,237,461016,Львівська область
13623,461017,227,0,153,73,80,461017,Львівська область
13624,461018,971,14,728,311,417,461018,Львівська область
13625,461019,236,2,168,72,96,461019,Львівська область
13626,461020,847,6,544,221,323,461020,Львівська область
13627,461021,307,5,236,106,130,461021,Львівська область
13628,461022,379,5,316,102,214,461022,Львівська область
13629,461023,508,8,354,237,117,461023,Львівська область
13630,461024,396,4,330,128,202,461024,Львівська область
13631,461025,161,2,131,47,84,461025,Львівська область
13632,461026,497,14,387,157,230,461026,Львівська область
13633,461027,240,4,146,77,69,461027,Львівська область
13634,461028,905,5,807,384,423,461028,Львівська область
13635,461029,484,7,319,126,193,461029,Львівська область
13636,461030,694,14,546,218,328,461030,Львівська область
13637,461031,179,2,140,47,93,461031,Львівська область
13638,461032,892,20,681,240,441,461032,Львівська область
13639,461033,842,6,636,238,398,461033,Львівська область
13640,461034,248,0,190,38,152,461034,Львівська область
13641,461035,270,5,217,70,147,461035,Львівська область
13642,461036,1540,39,909,447,462,461036,Львівська область
13643,461037,1291,30,769,318,451,461037,Львівська область
13644,461038,459,4,276,130,146,461038,Львівська область
13645,461039,671,14,485,149,336,461039,Львівська область
13646,461040,584,5,350,169,181,461040,Львівська область
13647,461041,420,5,338,120,218,461041,Львівська область
13648,461042,228,2,181,74,107,461042,Львівська область
13649,461043,384,9,313,130,183,461043,Львівська область
13650,461044,361,3,280,107,173,461044,Львівська область
13651,461045,122,0,98,32,66,461045,Львівська область
13652,461046,581,9,378,197,181,461046,Львівська область
13653,461047,316,6,199,84,115,461047,Львівська область
13654,461048,355,1,256,121,135,461048,Львівська область
13655,461049,2075,31,1346,706,640,461049,Львівська область
13656,461050,86,0,57,22,35,461050,Львівська область
13657,461051,290,10,229,115,114,461051,Львівська область
13658,461052,413,3,306,92,214,461052,Львівська область
13659,461053,792,9,568,239,329,461053,Львівська область
13660,461054,248,2,185,60,125,461054,Львівська область
13661,461055,172,4,112,59,53,461055,Львівська область
13662,461056,504,11,372,190,182,461056,Львівська область
13663,461057,808,18,712,239,473,461057,Львівська область
13664,461058,32,0,26,11,15,461058,Львівська область
13665,460149,224,1,158,49,109,460149,Львівська область
13666,460150,801,16,568,148,420,460150,Львівська область
13667,460151,1035,19,802,205,597,460151,Львівська область
13668,460152,675,13,511,143,368,460152,Львівська область
13669,460153,230,3,187,26,161,460153,Львівська область
13670,460154,1024,23,694,187,507,460154,Львівська область
13671,460155,1213,20,712,179,533,460155,Львівська область
13672,460156,1115,20,737,273,464,460156,Львівська область
13673,460157,1360,14,846,278,568,460157,Львівська область
13674,460158,1024,19,622,227,395,460158,Львівська область
13675,460159,558,13,441,54,387,460159,Львівська область
13676,460160,619,6,429,86,343,460160,Львівська область
13677,460161,131,1,101,18,83,460161,Львівська область
13678,460162,1878,22,1254,265,989,460162,Львівська область
13679,460163,1580,21,1009,230,779,460163,Львівська область
13680,460164,1956,31,1271,379,892,460164,Львівська область
13681,460165,1588,20,1041,312,729,460165,Львівська область
13682,460166,1453,27,900,241,659,460166,Львівська область
13683,460167,1881,38,1229,332,897,460167,Львівська область
13684,460168,421,8,277,102,175,460168,Львівська область
13685,460169,2374,32,1346,493,853,460169,Львівська область
13686,460170,1072,12,804,134,670,460170,Львівська область
13687,460171,906,11,657,210,447,460171,Львівська область
13688,460172,722,11,531,115,416,460172,Львівська область
13689,460173,508,2,400,69,331,460173,Львівська область
13690,460174,632,14,407,78,329,460174,Львівська область
13691,460175,873,14,619,122,497,460175,Львівська область
13692,460176,1326,11,958,196,762,460176,Львівська область
13693,460177,743,11,567,167,400,460177,Львівська область
13694,460178,364,6,262,42,220,460178,Львівська область
13695,460179,235,7,162,35,127,460179,Львівська область
13696,460180,231,4,189,71,118,460180,Львівська область
13697,460181,1005,13,693,186,507,460181,Львівська область
13698,460182,308,5,184,41,143,460182,Львівська область
13699,460183,1573,28,1018,258,760,460183,Львівська область
13700,460184,1404,41,821,228,593,460184,Львівська область
13701,460185,465,7,354,106,248,460185,Львівська область
13702,460186,227,12,169,33,136,460186,Львівська область
13703,460187,271,3,221,103,118,460187,Львівська область
13704,460188,259,1,207,57,150,460188,Львівська область
13705,460189,275,8,230,64,166,460189,Львівська область
13706,460190,1070,6,627,143,484,460190,Львівська область
13707,460191,366,4,196,57,139,460191,Львівська область
13708,460192,342,1,271,42,229,460192,Львівська область
13709,460193,189,1,147,50,97,460193,Львівська область
13710,460194,353,2,326,58,268,460194,Львівська область
13711,460195,185,4,154,40,114,460195,Львівська область
13712,460196,2265,55,1663,259,1404,460196,Львівська область
13713,460197,650,9,512,91,421,460197,Львівська область
13714,460198,731,10,453,144,309,460198,Львівська область
13715,460199,839,11,577,185,392,460199,Львівська область
13716,460200,560,10,394,167,227,460200,Львівська область
13717,460201,171,9,139,20,119,460201,Львівська область
13718,460202,856,2,638,199,439,460202,Львівська область
13719,460203,427,0,319,85,234,460203,Львівська область
13720,460204,294,2,183,31,152,460204,Львівська область
13721,460205,381,9,266,82,184,460205,Львівська область
13722,460206,1452,20,988,266,722,460206,Львівська область
13723,460207,120,0,87,15,72,460207,Львівська область
13724,460208,198,7,173,38,135,460208,Львівська область
13725,460209,1702,26,1217,253,964,460209,Львівська область
13726,460210,1759,38,1144,254,890,460210,Львівська область
13727,460211,336,9,186,41,145,460211,Львівська область
13728,460213,414,5,320,68,252,460213,Львівська область
13729,460214,321,12,220,52,168,460214,Львівська область
13730,460215,800,14,600,187,413,460215,Львівська область
13731,460216,410,18,302,82,220,460216,Львівська область
13732,460217,442,11,319,64,255,460217,Львівська область
13733,460218,956,15,664,161,503,460218,Львівська область
13734,460219,207,1,153,25,128,460219,Львівська область
13735,460220,322,3,207,53,154,460220,Львівська область
13736,460221,32,1,30,11,19,460221,Львівська область
13737,460743,2186,36,1235,619,616,460743,Львівська область
13738,460744,1872,30,1089,537,552,460744,Львівська область
13739,460745,1269,13,724,366,358,460745,Львівська область
13740,460746,969,12,475,281,194,460746,Львівська область
13741,460747,1263,22,668,373,295,460747,Львівська область
13742,460748,1928,38,1153,496,657,460748,Львівська область
13743,460749,1204,15,765,259,506,460749,Львівська область
13744,460750,1327,39,719,280,439,460750,Львівська область
13745,460751,760,14,445,180,265,460751,Львівська область
13746,460752,1008,22,592,229,363,460752,Львівська область
13747,460753,707,4,403,215,188,460753,Львівська область
13748,460754,251,3,176,48,128,460754,Львівська область
13749,460755,89,1,73,31,42,460755,Львівська область
13750,460756,710,22,440,180,260,460756,Львівська область
13751,460757,487,12,357,100,257,460757,Львівська область
13752,460758,768,13,447,188,259,460758,Львівська область
13753,460759,812,19,540,258,282,460759,Львівська область
13754,460760,524,9,359,176,183,460760,Львівська область
13755,460761,438,10,339,122,217,460761,Львівська область
13756,460762,494,3,339,160,179,460762,Львівська область
13757,460763,149,1,89,31,58,460763,Львівська область
13758,460764,328,4,211,77,134,460764,Львівська область
13759,460765,221,6,163,51,112,460765,Львівська область
13760,460766,421,6,340,76,264,460766,Львівська область
13761,460767,466,8,318,104,214,460767,Львівська область
13762,460768,356,2,274,121,153,460768,Львівська область
13763,460769,1283,26,744,255,489,460769,Львівська область
13764,460770,587,7,309,87,222,460770,Львівська область
13765,460771,898,6,544,206,338,460771,Львівська область
13766,460772,514,8,295,149,146,460772,Львівська область
13767,460773,220,0,141,69,72,460773,Львівська область
13768,460774,235,2,179,54,125,460774,Львівська область
13769,460775,65,3,41,5,36,460775,Львівська область
13770,460776,357,3,243,83,160,460776,Львівська область
13771,460777,400,3,275,109,166,460777,Львівська область
13772,460778,49,2,27,16,11,460778,Львівська область
13773,460779,110,0,75,47,28,460779,Львівська область
13774,460780,520,5,317,186,131,460780,Львівська область
13775,460781,214,4,170,72,98,460781,Львівська область
13776,460782,397,7,218,141,77,460782,Львівська область
13777,460783,729,8,499,303,196,460783,Львівська область
13778,460784,183,7,130,65,65,460784,Львівська область
13779,460785,219,4,194,165,29,460785,Львівська область
13780,460786,455,12,285,133,152,460786,Львівська область
13781,460787,373,1,204,177,27,460787,Львівська область
13782,460788,933,13,630,320,310,460788,Львівська область
13783,460789,445,3,330,206,124,460789,Львівська область
13784,460790,437,6,341,143,198,460790,Львівська область
13785,460791,212,1,147,40,107,460791,Львівська область
13786,460792,379,3,208,31,177,460792,Львівська область
13787,460793,600,3,404,102,302,460793,Львівська область
13788,460794,144,4,108,29,79,460794,Львівська область
13789,460796,137,0,84,45,39,460796,Львівська область
13790,460797,728,17,425,226,199,460797,Львівська область
13791,460798,333,8,248,81,167,460798,Львівська область
13792,460799,116,4,88,28,60,460799,Львівська область
13793,460800,828,8,497,337,160,460800,Львівська область
13794,460801,565,7,328,127,201,460801,Львівська область
13795,460802,444,14,263,95,168,460802,Львівська область
13796,460803,144,1,93,54,39,460803,Львівська область
13797,460804,214,3,148,71,77,460804,Львівська область
13798,460805,906,15,543,228,315,460805,Львівська область
13799,460806,207,2,108,24,84,460806,Львівська область
13800,460807,563,9,291,99,192,460807,Львівська область
13801,460808,116,0,62,18,44,460808,Львівська область
13802,460809,177,2,145,28,117,460809,Львівська область
13803,460810,245,6,157,56,101,460810,Львівська область
13804,460811,201,1,130,49,81,460811,Львівська область
13805,460812,492,6,383,205,178,460812,Львівська область
13806,460813,470,11,318,86,232,460813,Львівська область
13807,460814,159,5,112,36,76,460814,Львівська область
13808,460815,445,5,300,159,141,460815,Львівська область
13809,460816,779,36,477,195,282,460816,Львівська область
13810,460817,285,4,202,113,89,460817,Львівська область
13811,460818,174,1,129,58,71,460818,Львівська область
13812,460819,181,2,134,41,93,460819,Львівська область
13813,460820,147,3,105,43,62,460820,Львівська область
13814,460821,247,4,186,54,132,460821,Львівська область
13815,460822,194,3,113,40,73,460822,Львівська область
13816,460823,716,13,512,191,321,460823,Львівська область
13817,460824,777,15,578,283,295,460824,Львівська область
13818,460825,860,12,544,272,272,460825,Львівська область
13819,460826,111,1,68,28,40,460826,Львівська область
13820,460827,414,16,341,167,174,460827,Львівська область
13821,460830,21,0,14,7,7,460830,Львівська область
13822,461059,1189,29,836,422,414,461059,Львівська область
13823,461060,274,1,247,98,149,461060,Львівська область
13824,461061,591,20,423,206,217,461061,Львівська область
13825,461062,1973,34,1193,692,501,461062,Львівська область
13826,461063,617,7,440,219,221,461063,Львівська область
13827,461064,341,4,205,120,85,461064,Львівська область
13828,461065,234,2,213,91,122,461065,Львівська область
13829,461066,160,3,108,45,63,461066,Львівська область
13830,461067,330,1,251,126,125,461067,Львівська область
13831,461068,153,8,129,46,83,461068,Львівська область
13832,461069,102,5,89,32,57,461069,Львівська область
13833,461070,650,0,470,191,279,461070,Львівська область
13834,461071,372,27,275,132,143,461071,Львівська область
13835,461072,1287,19,751,405,346,461072,Львівська область
13836,461073,909,7,660,301,359,461073,Львівська область
13837,461074,317,7,254,114,140,461074,Львівська область
13838,461075,782,13,519,176,343,461075,Львівська область
13839,461076,482,9,409,149,260,461076,Львівська область
13840,461077,636,10,496,201,295,461077,Львівська область
13841,461078,195,6,155,43,112,461078,Львівська область
13842,461079,389,1,327,117,210,461079,Львівська область
13843,461080,207,0,180,69,111,461080,Львівська область
13844,461081,2098,32,1314,630,684,461081,Львівська область
13845,461082,625,4,495,144,351,461082,Львівська область
13846,461083,374,8,270,76,194,461083,Львівська область
13847,461084,437,3,386,184,202,461084,Львівська область
13848,461085,1093,10,842,163,679,461085,Львівська область
13849,461086,396,14,338,48,290,461086,Львівська область
13850,461087,332,5,221,99,122,461087,Львівська область
13851,461088,218,3,131,61,70,461088,Львівська область
13852,461089,647,9,437,130,307,461089,Львівська область
13853,461090,203,5,157,41,116,461090,Львівська область
13854,461091,241,3,185,95,90,461091,Львівська область
13855,461092,1125,18,724,268,456,461092,Львівська область
13856,461093,226,0,193,40,153,461093,Львівська область
13857,461094,286,4,178,70,108,461094,Львівська область
13858,461095,186,0,152,77,75,461095,Львівська область
13859,461096,122,3,94,22,72,461096,Львівська область
13860,461097,133,0,81,27,54,461097,Львівська область
13861,461098,133,0,108,43,65,461098,Львівська область
13862,461099,605,5,432,96,336,461099,Львівська область
13863,461100,720,8,438,145,293,461100,Львівська область
13864,461101,502,9,417,165,252,461101,Львівська область
13865,461102,306,2,216,69,147,461102,Львівська область
13866,461103,435,8,316,97,219,461103,Львівська область
13867,461104,587,8,477,189,288,461104,Львівська область
13868,461105,174,0,141,44,97,461105,Львівська область
13869,461106,158,1,129,60,69,461106,Львівська область
13870,461107,236,8,140,78,62,461107,Львівська область
13871,461108,239,2,172,49,123,461108,Львівська область
13872,461109,87,4,50,21,29,461109,Львівська область
13873,461110,123,3,87,36,51,461110,Львівська область
13874,461111,421,9,371,181,190,461111,Львівська область
13875,461112,290,2,265,130,135,461112,Львівська область
13876,461113,356,2,318,87,231,461113,Львівська область
13877,461114,316,2,278,78,200,461114,Львівська область
13878,461115,2423,55,1441,671,770,461115,Львівська область
13879,461116,549,6,381,117,264,461116,Львівська область
13880,461117,903,10,647,173,474,461117,Львівська область
13881,461118,1104,30,740,237,503,461118,Львівська область
13882,461119,465,7,364,235,129,461119,Львівська область
13883,461120,369,8,229,124,105,461120,Львівська область
13884,461121,485,6,293,146,147,461121,Львівська область
13885,461122,1553,24,913,448,465,461122,Львівська область
13886,461123,551,3,418,94,324,461123,Львівська область
13887,461124,91,1,69,33,36,461124,Львівська область
13888,461125,1104,17,741,241,500,461125,Львівська область
13889,461126,331,7,204,88,116,461126,Львівська область
13890,461127,845,25,593,272,321,461127,Львівська область
13891,461128,787,21,433,226,207,461128,Львівська область
13892,461129,1175,19,671,328,343,461129,Львівська область
13893,461130,1321,29,844,362,482,461130,Львівська область
13894,461131,271,43,182,35,147,461131,Львівська область
13895,461132,1315,35,701,280,421,461132,Львівська область
13896,461133,1250,28,751,267,484,461133,Львівська область
13897,461134,1105,28,646,255,391,461134,Львівська область
13898,461135,296,6,205,60,145,461135,Львівська область
13899,461136,520,1,393,196,197,461136,Львівська область
13900,461140,398,3,313,71,242,461140,Львівська область
13901,461141,173,13,129,23,106,461141,Львівська область
13902,461142,522,5,337,136,201,461142,Львівська область
13903,461143,430,6,253,144,109,461143,Львівська область
13904,461144,1137,15,656,310,346,461144,Львівська область
13905,461145,264,2,190,94,96,461145,Львівська область
13906,461146,1189,17,737,388,349,461146,Львівська область
13907,461147,32,1,27,10,17,461147,Львівська область
13908,460223,303,6,207,57,150,460223,Львівська область
13909,460224,201,1,135,37,98,460224,Львівська область
13910,460225,1245,18,918,267,651,460225,Львівська область
13911,460226,661,11,424,200,224,460226,Львівська область
13912,460227,240,1,112,46,66,460227,Львівська область
13913,460228,885,11,622,254,368,460228,Львівська область
13914,460229,271,5,165,56,109,460229,Львівська область
13915,460230,1052,6,767,290,477,460230,Львівська область
13916,460231,584,20,388,175,213,460231,Львівська область
13917,460232,812,13,519,222,297,460232,Львівська область
13918,460233,586,8,357,159,198,460233,Львівська область
13919,460234,831,18,610,119,491,460234,Львівська область
13920,460235,707,9,496,220,276,460235,Львівська область
13921,460236,112,1,81,20,61,460236,Львівська область
13922,460237,1280,17,827,259,568,460237,Львівська область
13923,460238,1274,17,859,312,547,460238,Львівська область
13924,460239,876,13,628,157,471,460239,Львівська область
13925,460240,1097,19,697,286,411,460240,Львівська область
13926,460241,656,6,380,136,244,460241,Львівська область
13927,460242,509,6,342,180,162,460242,Львівська область
13928,460243,297,10,177,72,105,460243,Львівська область
13929,460244,107,0,97,30,67,460244,Львівська область
13930,460245,847,14,569,275,294,460245,Львівська область
13931,460246,593,5,437,153,284,460246,Львівська область
13932,460247,1645,30,1056,315,741,460247,Львівська область
13933,460248,67,0,58,20,38,460248,Львівська область
13934,460249,602,26,491,164,327,460249,Львівська область
13935,460250,1906,30,1191,423,768,460250,Львівська область
13936,460251,312,2,170,75,95,460251,Львівська область
13937,460252,558,14,343,128,215,460252,Львівська область
13938,460253,705,13,467,150,317,460253,Львівська область
13939,460254,1023,13,637,266,371,460254,Львівська область
13940,460255,266,7,191,67,124,460255,Львівська область
13941,460256,216,3,133,60,73,460256,Львівська область
13942,460257,1084,16,626,308,318,460257,Львівська область
13943,460258,374,11,265,69,196,460258,Львівська область
13944,460259,1345,21,838,414,424,460259,Львівська область
13945,460260,105,1,74,48,26,460260,Львівська область
13946,460261,1399,19,918,373,545,460261,Львівська область
13947,460262,138,0,122,44,78,460262,Львівська область
13948,460263,1837,26,1077,479,598,460263,Львівська область
13949,460264,745,11,466,128,338,460264,Львівська область
13950,460266,517,4,311,159,152,460266,Львівська область
13951,460267,1644,25,1006,346,660,460267,Львівська область
13952,460268,1049,16,634,286,348,460268,Львівська область
13953,460269,651,12,425,152,273,460269,Львівська область
13954,460270,113,0,66,25,41,460270,Львівська область
13955,460271,330,1,243,137,106,460271,Львівська область
13956,460272,724,10,492,215,277,460272,Львівська область
13957,460273,592,15,353,170,183,460273,Львівська область
13958,460274,981,24,687,276,411,460274,Львівська область
13959,460275,716,6,461,196,265,460275,Львівська область
13960,460276,531,27,379,89,290,460276,Львівська область
13961,460277,1442,21,826,258,568,460277,Львівська область
13962,460278,351,2,235,98,137,460278,Львівська область
13963,460279,331,2,257,109,148,460279,Львівська область
13964,460280,1238,14,816,260,556,460280,Львівська область
13965,460281,1511,21,964,340,624,460281,Львівська область
13966,460282,902,5,641,204,437,460282,Львівська область
13967,460283,810,14,586,218,368,460283,Львівська область
13968,460284,1033,21,726,234,492,460284,Львівська область
13969,460285,679,5,456,119,337,460285,Львівська область
13970,460286,188,0,155,26,129,460286,Львівська область
13971,460287,681,17,508,131,377,460287,Львівська область
13972,460288,463,7,315,120,195,460288,Львівська область
13973,460289,103,0,75,23,52,460289,Львівська область
13974,460290,965,25,561,173,388,460290,Львівська область
13975,460291,1026,11,652,195,457,460291,Львівська область
13976,460292,1229,23,696,213,483,460292,Львівська область
13977,460293,1242,57,793,222,571,460293,Львівська область
13978,460294,959,7,703,165,538,460294,Львівська область
13979,460295,863,10,570,194,376,460295,Львівська область
13980,460296,138,1,80,33,47,460296,Львівська область
13981,460297,505,12,377,145,232,460297,Львівська область
13982,461685,635,16,353,151,202,461685,Львівська область
13983,461686,793,19,422,195,227,461686,Львівська область
13984,461687,1265,32,654,322,332,461687,Львівська область
13985,461688,1667,43,893,423,470,461688,Львівська область
13986,461689,1489,34,829,362,467,461689,Львівська область
13987,461690,2151,56,1177,567,610,461690,Львівська область
13988,461691,1907,41,1062,478,584,461691,Львівська область
13989,461692,1238,32,682,323,359,461692,Львівська область
13990,461693,932,21,511,250,261,461693,Львівська область
13991,461694,1587,31,790,379,411,461694,Львівська область
13992,461695,1606,38,883,411,472,461695,Львівська область
13993,461696,2094,60,1195,483,712,461696,Львівська область
13994,461697,831,18,453,213,240,461697,Львівська область
13995,461698,909,24,520,255,265,461698,Львівська область
13996,461699,770,17,423,196,227,461699,Львівська область
13997,461700,1014,25,597,263,334,461700,Львівська область
13998,461701,1246,26,699,332,367,461701,Львівська область
13999,461702,756,20,432,184,248,461702,Львівська область
14000,461703,1202,32,650,333,317,461703,Львівська область
14001,461704,538,12,296,159,137,461704,Львівська область
14002,461705,535,14,303,176,127,461705,Львівська область
14003,461706,756,15,426,192,234,461706,Львівська область
14004,461707,739,15,499,242,257,461707,Львівська область
14005,461708,1640,20,1079,513,566,461708,Львівська область
14006,461709,1550,30,845,314,531,461709,Львівська область
14007,461710,1556,27,932,331,601,461710,Львівська область
14008,461711,2253,48,1355,539,816,461711,Львівська область
14009,461712,2061,44,1159,457,702,461712,Львівська область
14010,461713,1310,18,743,254,489,461713,Львівська область
14011,461714,2301,37,1343,469,874,461714,Львівська область
14012,461715,2292,39,1200,452,748,461715,Львівська область
14013,461716,2037,51,1165,473,692,461716,Львівська область
14014,461717,1900,43,1128,442,686,461717,Львівська область
14015,461718,2335,43,1345,516,829,461718,Львівська область
14016,461719,2318,52,1374,534,840,461719,Львівська область
14017,461721,2354,86,1419,460,959,461721,Львівська область
14018,461722,2414,55,1559,614,945,461722,Львівська область
14019,461723,2155,46,1312,415,897,461723,Львівська область
14020,461724,2158,59,1286,466,820,461724,Львівська область
14021,461725,2211,51,1282,456,826,461725,Львівська область
14022,461726,2361,46,1400,511,889,461726,Львівська область
14023,461727,2310,58,1316,457,859,461727,Львівська область
14024,461728,2473,64,1516,600,916,461728,Львівська область
14025,461729,2400,44,1300,505,795,461729,Львівська область
14026,461730,2319,64,1384,628,756,461730,Львівська область
14027,461731,2347,50,1331,563,768,461731,Львівська область
14028,461732,2350,47,1424,524,900,461732,Львівська область
14029,461733,1363,33,858,318,540,461733,Львівська область
14030,461734,1139,22,758,298,460,461734,Львівська область
14031,461735,1289,23,707,292,415,461735,Львівська область
14032,461736,1434,20,711,325,386,461736,Львівська область
14033,461737,1294,24,735,255,480,461737,Львівська область
14034,461738,1857,31,1092,456,636,461738,Львівська область
14035,461739,1372,20,712,295,417,461739,Львівська область
14036,461740,1831,30,1028,427,601,461740,Львівська область
14037,461741,2065,36,1165,490,675,461741,Львівська область
14038,461742,52,2,45,16,29,461742,Львівська область
14039,461743,478,44,423,299,124,461743,Львівська область
14040,461808,2202,49,1305,482,823,461808,Львівська область
14041,461809,2083,35,1268,458,810,461809,Львівська область
14042,461810,1529,27,960,393,567,461810,Львівська область
14043,461811,1919,31,1364,682,682,461811,Львівська область
14044,461812,2401,40,1440,608,832,461812,Львівська область
14045,461813,2077,40,1187,455,732,461813,Львівська область
14046,461814,2319,37,1401,539,862,461814,Львівська область
14047,461815,2207,31,1284,546,738,461815,Львівська область
14048,462161,1088,19,702,250,452,462161,Львівська область
14049,1,1483,64,1196,555,641,1,Львівська область
14050,460419,1056,7,666,429,237,460419,Львівська область
14051,460420,521,13,308,198,110,460420,Львівська область
14052,460421,713,15,432,292,140,460421,Львівська область
14053,460422,985,5,697,274,423,460422,Львівська область
14054,460423,453,6,287,126,161,460423,Львівська область
14055,460424,1575,19,1044,502,542,460424,Львівська область
14056,460425,1679,20,999,475,524,460425,Львівська область
14057,460426,306,4,201,98,103,460426,Львівська область
14058,460427,123,4,99,57,42,460427,Львівська область
14059,460428,1836,19,995,680,315,460428,Львівська область
14060,460429,236,0,166,99,67,460429,Львівська область
14061,460430,1967,44,1232,744,488,460430,Львівська область
14062,460431,2043,43,1262,704,558,460431,Львівська область
14063,460432,1981,36,1269,741,528,460432,Львівська область
14064,460433,470,9,337,170,167,460433,Львівська область
14065,460434,277,2,214,117,97,460434,Львівська область
14066,460435,305,6,217,162,55,460435,Львівська область
14067,460436,291,4,220,138,82,460436,Львівська область
14068,460437,602,7,433,168,265,460437,Львівська область
14069,460438,182,3,146,54,92,460438,Львівська область
14070,460439,1092,16,718,311,407,460439,Львівська область
14071,460440,311,4,224,104,120,460440,Львівська область
14072,460441,673,8,474,174,300,460441,Львівська область
14073,460442,459,9,323,122,201,460442,Львівська область
14074,460443,1122,10,573,249,324,460443,Львівська область
14075,460444,1297,14,909,320,589,460444,Львівська область
14076,460445,580,12,370,100,270,460445,Львівська область
14077,460446,692,22,429,251,178,460446,Львівська область
14078,460447,445,5,350,221,129,460447,Львівська область
14079,460448,527,10,437,138,299,460448,Львівська область
14080,460449,419,6,314,98,216,460449,Львівська область
14081,460450,445,3,312,123,189,460450,Львівська область
14082,460451,436,5,291,123,168,460451,Львівська область
14083,460452,319,2,254,48,206,460452,Львівська область
14084,460453,1397,33,960,276,684,460453,Львівська область
14085,460454,767,2,610,156,454,460454,Львівська область
14086,460455,1613,27,1130,458,672,460455,Львівська область
14087,460456,434,6,339,151,188,460456,Львівська область
14088,460457,832,7,552,214,338,460457,Львівська область
14089,460458,431,5,267,76,191,460458,Львівська область
14090,460459,974,7,635,188,447,460459,Львівська область
14091,460460,1709,18,1213,471,742,460460,Львівська область
14092,460461,558,8,347,114,233,460461,Львівська область
14093,460462,1626,16,972,362,610,460462,Львівська область
14094,460463,412,8,263,115,148,460463,Львівська область
14095,460464,631,10,416,132,284,460464,Львівська область
14096,460465,1257,19,838,314,524,460465,Львівська область
14097,460466,824,1,570,192,378,460466,Львівська область
14098,460467,324,7,224,67,157,460467,Львівська область
14099,460468,1410,20,948,275,673,460468,Львівська область
14100,460469,2222,43,1449,518,931,460469,Львівська область
14101,460470,2160,47,1430,532,898,460470,Львівська область
14102,460471,2498,43,1658,603,1055,460471,Львівська область
14103,460472,1522,40,1004,359,645,460472,Львівська область
14104,460473,1761,44,1117,387,730,460473,Львівська область
14105,460474,318,2,232,50,182,460474,Львівська область
14106,460475,1029,25,671,204,467,460475,Львівська область
14107,460476,364,8,298,70,228,460476,Львівська область
14108,460477,798,10,698,168,530,460477,Львівська область
14109,460478,826,12,614,162,452,460478,Львівська область
14110,460479,1163,23,889,287,602,460479,Львівська область
14111,460480,717,15,460,123,337,460480,Львівська область
14112,460481,718,9,440,167,273,460481,Львівська область
14113,460482,718,14,549,192,357,460482,Львівська область
14114,460483,158,4,131,41,90,460483,Львівська область
14115,460484,414,9,299,73,226,460484,Львівська область
14116,460485,517,5,371,84,287,460485,Львівська область
14117,460486,1152,18,778,173,605,460486,Львівська область
14118,460487,196,2,144,27,117,460487,Львівська область
14119,460488,938,11,562,171,391,460488,Львівська область
14120,460489,142,3,114,45,69,460489,Львівська область
14121,460490,1528,24,1009,304,705,460490,Львівська область
14122,460491,1594,20,1044,310,734,460491,Львівська область
14123,460492,320,6,275,103,172,460492,Львівська область
14124,460493,620,38,507,41,466,460493,Львівська область
14125,460494,503,7,396,56,340,460494,Львівська область
14126,460495,354,2,248,102,146,460495,Львівська область
14127,460496,461,8,345,153,192,460496,Львівська область
14128,460497,323,7,238,60,178,460497,Львівська область
14129,460498,922,21,581,129,452,460498,Львівська область
14130,460499,1265,20,841,146,695,460499,Львівська область
14131,460500,488,7,299,59,240,460500,Львівська область
14132,460501,1336,24,907,206,701,460501,Львівська область
14133,460502,2130,36,1478,348,1130,460502,Львівська область
14134,460503,743,1,222,127,95,460503,Львівська область
14135,460504,1889,30,1272,276,996,460504,Львівська область
14136,460505,1364,23,968,232,736,460505,Львівська область
14137,460506,268,2,207,32,175,460506,Львівська область
14138,460508,1128,21,772,176,596,460508,Львівська область
14139,461571,1787,32,1123,470,653,461571,Львівська область
14140,461572,1413,43,881,404,477,461572,Львівська область
14141,461573,1477,47,905,348,557,461573,Львівська область
14142,461574,1726,36,1047,419,628,461574,Львівська область
14143,461575,1480,28,956,320,636,461575,Львівська область
14144,461576,1159,16,680,292,388,461576,Львівська область
14145,461577,1438,28,731,398,333,461577,Львівська область
14146,461578,2061,37,1188,436,752,461578,Львівська область
14147,461579,2072,37,1209,487,722,461579,Львівська область
14148,461580,1987,49,1127,435,692,461580,Львівська область
14149,461581,1009,17,622,190,432,461581,Львівська область
14150,461582,950,20,594,212,382,461582,Львівська область
14151,461583,1098,22,663,232,431,461583,Львівська область
14152,461584,1945,25,1238,464,774,461584,Львівська область
14153,461585,2082,39,1259,477,782,461585,Львівська область
14154,461586,1322,22,856,351,505,461586,Львівська область
14155,461587,1378,25,827,312,515,461587,Львівська область
14156,461588,2461,54,1509,599,910,461588,Львівська область
14157,461589,1094,17,609,227,382,461589,Львівська область
14158,461590,1743,43,1227,397,830,461590,Львівська область
14159,461591,1619,29,1121,444,677,461591,Львівська область
14160,461592,1233,30,787,263,524,461592,Львівська область
14161,461593,295,6,229,56,173,461593,Львівська область
14162,461594,468,8,324,109,215,461594,Львівська область
14163,461595,956,20,714,345,369,461595,Львівська область
14164,461596,374,5,252,135,117,461596,Львівська область
14165,461597,354,3,239,136,103,461597,Львівська область
14166,461598,531,10,375,181,194,461598,Львівська область
14167,461599,473,6,321,182,139,461599,Львівська область
14168,461600,1688,28,953,552,401,461600,Львівська область
14169,461601,520,6,311,159,152,461601,Львівська область
14170,461602,385,8,295,154,141,461602,Львівська область
14171,461603,2470,56,1632,669,963,461603,Львівська область
14172,461604,1219,28,788,293,495,461604,Львівська область
14173,461605,655,15,432,180,252,461605,Львівська область
14174,461606,284,3,178,77,101,461606,Львівська область
14175,461607,538,2,425,141,284,461607,Львівська область
14176,461608,540,4,363,114,249,461608,Львівська область
14177,461609,514,6,421,96,325,461609,Львівська область
14178,461610,1993,36,1508,369,1139,461610,Львівська область
14179,461611,263,1,213,59,154,461611,Львівська область
14180,461612,553,7,381,146,235,461612,Львівська область
14181,461613,117,1,91,34,57,461613,Львівська область
14182,461614,387,3,300,35,265,461614,Львівська область
14183,461615,294,3,249,34,215,461615,Львівська область
14184,461616,1097,22,760,361,399,461616,Львівська область
14185,461617,527,11,320,193,127,461617,Львівська область
14186,461618,1007,22,770,264,506,461618,Львівська область
14187,461619,869,16,617,153,464,461619,Львівська область
14188,461620,163,2,125,55,70,461620,Львівська область
14189,461621,122,0,68,12,56,461621,Львівська область
14190,461622,987,17,687,124,563,461622,Львівська область
14191,461623,463,10,377,49,328,461623,Львівська область
14192,461624,403,9,279,43,236,461624,Львівська область
14193,461625,949,46,739,142,597,461625,Львівська область
14194,461626,468,9,372,71,301,461626,Львівська область
14195,461627,634,6,450,106,344,461627,Львівська область
14196,461628,315,0,283,77,206,461628,Львівська область
14197,461629,226,4,186,57,129,461629,Львівська область
14198,461630,473,6,363,102,261,461630,Львівська область
14199,461631,809,12,600,241,359,461631,Львівська область
14200,461632,91,3,73,22,51,461632,Львівська область
14201,461633,413,10,290,165,125,461633,Львівська область
14202,461634,911,6,643,278,365,461634,Львівська область
14203,461635,178,6,139,62,77,461635,Львівська область
14204,461636,192,2,147,67,80,461636,Львівська область
14205,461637,323,4,207,71,136,461637,Львівська область
14206,461638,1058,15,713,310,403,461638,Львівська область
14207,461639,937,9,627,246,381,461639,Львівська область
14208,461640,575,10,343,179,164,461640,Львівська область
14209,461641,284,4,177,38,139,461641,Львівська область
14210,461642,357,3,217,90,127,461642,Львівська область
14211,461643,390,7,213,143,70,461643,Львівська область
14212,461644,334,10,247,74,173,461644,Львівська область
14213,461645,863,7,689,130,559,461645,Львівська область
14214,461646,664,6,484,316,168,461646,Львівська область
14215,461647,337,5,270,93,177,461647,Львівська область
14216,461649,359,2,249,139,110,461649,Львівська область
14217,461650,649,7,485,144,341,461650,Львівська область
14218,461651,451,10,300,105,195,461651,Львівська область
14219,461652,458,4,375,50,325,461652,Львівська область
14220,461653,271,8,211,20,191,461653,Львівська область
14221,461654,735,8,465,153,312,461654,Львівська область
14222,461655,2165,31,1358,712,646,461655,Львівська область
14223,461656,310,6,199,102,97,461656,Львівська область
14224,461657,208,2,160,68,92,461657,Львівська область
14225,461658,937,9,588,276,312,461658,Львівська область
14226,461659,883,16,581,227,354,461659,Львівська область
14227,461660,347,3,263,80,183,461660,Львівська область
14228,461661,396,5,302,80,222,461661,Львівська область
14229,461662,784,16,564,131,433,461662,Львівська область
14230,461663,1842,23,1192,419,773,461663,Львівська область
14231,461664,1117,10,706,286,420,461664,Львівська область
14232,461665,693,13,420,171,249,461665,Львівська область
14233,461666,650,8,468,187,281,461666,Львівська область
14234,461667,2024,20,1425,307,1118,461667,Львівська область
14235,461668,492,8,292,137,155,461668,Львівська область
14236,461669,458,10,296,196,100,461669,Львівська область
14237,461670,517,11,391,178,213,461670,Львівська область
14238,461671,894,7,499,280,219,461671,Львівська область
14239,461672,435,8,268,160,108,461672,Львівська область
14240,461673,1132,7,669,316,353,461673,Львівська область
14241,461674,1965,33,1186,530,656,461674,Львівська область
14242,461675,1812,18,1117,560,557,461675,Львівська область
14243,461676,243,3,142,39,103,461676,Львівська область
14244,461677,680,6,455,187,268,461677,Львівська область
14245,461678,869,7,573,201,372,461678,Львівська область
14246,461679,178,3,125,49,76,461679,Львівська область
14247,461680,1392,35,1012,536,476,461680,Львівська область
14248,461681,1017,12,716,158,558,461681,Львівська область
14249,461682,54,1,27,7,20,461682,Львівська область
14250,461683,75,2,65,17,48,461683,Львівська область
14251,461684,13,0,13,2,11,461684,Львівська область
14252,460510,2312,38,1343,660,683,460510,Львівська область
14253,460511,1916,48,1099,518,581,460511,Львівська область
14254,460512,2271,53,1274,604,670,460512,Львівська область
14255,460513,2337,38,1498,770,728,460513,Львівська область
14256,460514,2316,39,1308,553,755,460514,Львівська область
14257,460515,2031,47,1170,551,619,460515,Львівська область
14258,460516,1952,41,1196,478,718,460516,Львівська область
14259,460517,1809,44,1119,465,654,460517,Львівська область
14260,460518,1028,19,739,413,326,460518,Львівська область
14261,460519,243,3,155,113,42,460519,Львівська область
14262,460520,137,3,72,37,35,460520,Львівська область
14263,460521,576,17,372,159,213,460521,Львівська область
14264,460522,366,7,262,82,180,460522,Львівська область
14265,460523,240,1,181,75,106,460523,Львівська область
14266,460524,223,5,190,50,140,460524,Львівська область
14267,460525,52,0,40,11,29,460525,Львівська область
14268,460526,163,1,116,38,78,460526,Львівська область
14269,460527,525,12,391,138,253,460527,Львівська область
14270,460528,271,1,203,81,122,460528,Львівська область
14271,460529,288,8,180,64,116,460529,Львівська область
14272,460530,576,9,390,147,243,460530,Львівська область
14273,460531,90,0,78,23,55,460531,Львівська область
14274,460532,82,2,47,15,32,460532,Львівська область
14275,460533,203,10,128,49,79,460533,Львівська область
14276,460534,183,2,126,45,81,460534,Львівська область
14277,460535,1344,26,739,415,324,460535,Львівська область
14278,460536,883,9,521,278,243,460536,Львівська область
14279,460537,957,13,540,221,319,460537,Львівська область
14280,460538,1255,21,763,278,485,460538,Львівська область
14281,460539,266,2,200,68,132,460539,Львівська область
14282,460540,440,5,237,118,119,460540,Львівська область
14283,460541,112,2,68,34,34,460541,Львівська область
14284,460542,218,2,192,63,129,460542,Львівська область
14285,460543,758,20,575,260,315,460543,Львівська область
14286,460544,781,18,499,258,241,460544,Львівська область
14287,460545,562,15,397,185,212,460545,Львівська область
14288,460546,249,4,147,65,82,460546,Львівська область
14289,460547,150,2,85,43,42,460547,Львівська область
14290,460548,167,1,109,63,46,460548,Львівська область
14291,460549,55,1,44,30,14,460549,Львівська область
14292,460550,308,8,172,94,78,460550,Львівська область
14293,460551,54,0,40,8,32,460551,Львівська область
14294,460552,521,7,339,100,239,460552,Львівська область
14295,460553,206,0,152,25,127,460553,Львівська область
14296,460554,272,7,215,41,174,460554,Львівська область
14297,460555,283,2,192,49,143,460555,Львівська область
14298,460556,275,5,199,78,121,460556,Львівська область
14299,460557,134,1,93,45,48,460557,Львівська область
14300,460558,281,2,207,81,126,460558,Львівська область
14301,460559,193,3,151,72,79,460559,Львівська область
14302,460560,967,14,688,190,498,460560,Львівська область
14303,460561,92,0,66,11,55,460561,Львівська область
14304,460562,202,1,164,22,142,460562,Львівська область
14305,460563,295,5,199,79,120,460563,Львівська область
14306,460564,347,10,239,53,186,460564,Львівська область
14307,460565,670,6,535,121,414,460565,Львівська область
14308,460566,193,4,128,29,99,460566,Львівська область
14309,460567,495,9,334,112,222,460567,Львівська область
14310,460568,207,7,153,40,113,460568,Львівська область
14311,460569,170,3,137,38,99,460569,Львівська область
14312,460570,1112,25,697,330,367,460570,Львівська область
14313,460571,758,2,409,189,220,460571,Львівська область
14314,460572,536,5,343,197,146,460572,Львівська область
14315,460573,251,5,150,91,59,460573,Львівська область
14316,460574,419,10,295,123,172,460574,Львівська область
14317,460575,42,2,29,10,19,460575,Львівська область
14318,460576,506,3,277,97,180,460576,Львівська область
14319,460577,174,0,133,75,58,460577,Львівська область
14320,460578,83,3,64,27,37,460578,Львівська область
14321,460579,82,0,53,25,28,460579,Львівська область
14322,460580,828,9,490,294,196,460580,Львівська область
14323,460581,157,0,118,64,54,460581,Львівська область
14324,460582,106,0,83,45,38,460582,Львівська область
14325,460583,242,6,181,88,93,460583,Львівська область
14326,460584,397,9,300,108,192,460584,Львівська область
14327,460585,737,9,521,240,281,460585,Львівська область
14328,460586,110,1,86,49,37,460586,Львівська область
14329,460587,116,2,93,31,62,460587,Львівська область
14330,460588,195,1,152,52,100,460588,Львівська область
14331,460589,129,1,96,34,62,460589,Львівська область
14332,460590,740,13,465,193,272,460590,Львівська область
14333,460591,315,3,228,68,160,460591,Львівська область
14334,460592,83,4,53,15,38,460592,Львівська область
14335,460593,166,1,120,29,91,460593,Львівська область
14336,460594,728,15,448,216,232,460594,Львівська область
14337,460595,100,3,76,37,39,460595,Львівська область
14338,460596,667,7,414,99,315,460596,Львівська область
14339,460597,313,5,212,67,145,460597,Львівська область
14340,460598,947,18,732,294,438,460598,Львівська область
14341,460599,633,15,431,218,213,460599,Львівська область
14342,460600,181,3,146,65,81,460600,Львівська область
14343,460601,424,11,279,135,144,460601,Львівська область
14344,460602,72,0,50,26,24,460602,Львівська область
14345,460603,183,4,119,77,42,460603,Львівська область
14346,460604,1229,24,764,399,365,460604,Львівська область
14347,460605,544,13,427,138,289,460605,Львівська область
14348,460606,1269,26,784,369,415,460606,Львівська область
14349,460607,103,4,67,13,54,460607,Львівська область
14350,460608,195,4,121,60,61,460608,Львівська область
14351,460609,200,3,122,45,77,460609,Львівська область
14352,460610,87,0,76,25,51,460610,Львівська область
14353,460611,35,1,26,11,15,460611,Львівська область
14354,460612,32,1,31,26,5,460612,Львівська область
14355,460613,60,0,60,34,26,460613,Львівська область
14356,460680,256,3,201,38,163,460680,Львівська область
14357,460681,369,10,254,52,202,460681,Львівська область
14358,460682,306,1,217,51,166,460682,Львівська область
14359,460683,226,0,177,32,145,460683,Львівська область
14360,460684,150,1,109,31,78,460684,Львівська область
14361,460685,301,2,249,58,191,460685,Львівська область
14362,460686,105,2,86,21,65,460686,Львівська область
14363,460687,488,6,346,127,219,460687,Львівська область
14364,460688,142,1,115,17,98,460688,Львівська область
14365,460689,832,16,567,132,435,460689,Львівська область
14366,460690,412,5,303,97,206,460690,Львівська область
14367,460691,253,7,172,46,126,460691,Львівська область
14368,460692,589,5,461,128,333,460692,Львівська область
14369,460693,150,5,123,32,91,460693,Львівська область
14370,460694,1180,8,832,205,627,460694,Львівська область
14371,460695,688,8,485,171,314,460695,Львівська область
14372,460696,468,6,377,120,257,460696,Львівська область
14373,460697,92,0,72,18,54,460697,Львівська область
14374,460698,1713,21,1130,285,845,460698,Львівська область
14375,460699,867,14,667,184,483,460699,Львівська область
14376,460700,216,4,161,37,124,460700,Львівська область
14377,460701,2116,19,1338,399,939,460701,Львівська область
14378,460702,2129,46,1375,494,881,460702,Львівська область
14379,460703,1942,31,1224,425,799,460703,Львівська область
14380,460704,1540,28,923,361,562,460704,Львівська область
14381,460705,1466,33,853,326,527,460705,Львівська область
14382,460706,1905,29,1192,401,791,460706,Львівська область
14383,460707,845,15,522,181,341,460707,Львівська область
14384,460709,246,1,198,86,112,460709,Львівська область
14385,460710,648,6,468,101,367,460710,Львівська область
14386,460711,308,3,262,80,182,460711,Львівська область
14387,460712,204,1,148,71,77,460712,Львівська область
14388,460713,149,1,105,12,93,460713,Львівська область
14389,460714,609,5,378,121,257,460714,Львівська область
14390,460715,156,2,108,37,71,460715,Львівська область
14391,460716,2258,32,1420,676,744,460716,Львівська область
14392,460717,881,12,574,245,329,460717,Львівська область
14393,460718,2354,50,1684,342,1342,460718,Львівська область
14394,460719,1187,10,826,204,622,460719,Львівська область
14395,460720,381,3,294,64,230,460720,Львівська область
14396,460721,1971,20,1364,317,1047,460721,Львівська область
14397,460722,710,11,534,192,342,460722,Львівська область
14398,460723,1041,11,591,242,349,460723,Львівська область
14399,460724,1986,21,1205,418,787,460724,Львівська область
14400,460725,1487,35,887,302,585,460725,Львівська область
14401,460726,752,21,432,180,252,460726,Львівська область
14402,460727,1157,26,784,187,597,460727,Львівська область
14403,460728,233,3,167,52,115,460728,Львівська область
14404,460729,2398,47,1618,523,1095,460729,Львівська область
14405,460730,967,10,804,199,605,460730,Львівська область
14406,460731,904,8,582,188,394,460731,Львівська область
14407,460732,554,21,407,129,278,460732,Львівська область
14408,460733,251,3,199,61,138,460733,Львівська область
14409,460734,1303,23,851,313,538,460734,Львівська область
14410,460735,696,11,470,164,306,460735,Львівська область
14411,460736,497,6,388,144,244,460736,Львівська область
14412,460737,189,0,154,51,103,460737,Львівська область
14413,460738,307,3,244,94,150,460738,Львівська область
14414,460739,44,1,37,17,20,460739,Львівська область
14415,460740,365,16,119,38,81,460740,Львівська область
14416,460741,228,14,214,106,108,460741,Львівська область
14417,460831,462,7,308,77,231,460831,Львівська область
14418,460832,274,4,222,43,179,460832,Львівська область
14419,460833,585,6,496,56,440,460833,Львівська область
14420,460834,195,4,144,27,117,460834,Львівська область
14421,460835,456,8,362,64,298,460835,Львівська область
14422,460836,509,5,419,116,303,460836,Львівська область
14423,460837,313,5,227,32,195,460837,Львівська область
14424,460838,165,4,100,22,78,460838,Львівська область
14425,460839,712,8,421,154,267,460839,Львівська область
14426,460840,270,3,163,56,107,460840,Львівська область
14427,460841,108,0,70,15,55,460841,Львівська область
14428,460842,108,1,85,14,71,460842,Львівська область
14429,460843,379,11,240,69,171,460843,Львівська область
14430,460844,110,1,76,15,61,460844,Львівська область
14431,460845,792,12,557,178,379,460845,Львівська область
14432,460846,273,2,198,39,159,460846,Львівська область
14433,460847,453,4,290,59,231,460847,Львівська область
14434,460848,752,16,501,129,372,460848,Львівська область
14435,460849,639,4,438,124,314,460849,Львівська область
14436,460850,430,11,303,73,230,460850,Львівська область
14437,460851,1592,27,923,330,593,460851,Львівська область
14438,460852,1598,27,918,333,585,460852,Львівська область
14439,460853,221,0,143,51,92,460853,Львівська область
14440,460854,407,4,264,93,171,460854,Львівська область
14441,460855,379,5,274,72,202,460855,Львівська область
14442,460856,463,5,327,127,200,460856,Львівська область
14443,460857,108,1,60,18,42,460857,Львівська область
14444,460859,628,13,433,107,326,460859,Львівська область
14445,460860,509,1,376,103,273,460860,Львівська область
14446,460861,270,1,204,80,124,460861,Львівська область
14447,460862,210,3,134,70,64,460862,Львівська область
14448,460863,182,3,143,61,82,460863,Львівська область
14449,460864,452,5,326,184,142,460864,Львівська область
14450,460865,1861,39,1123,391,732,460865,Львівська область
14451,460866,1959,45,1191,489,702,460866,Львівська область
14452,460867,1518,18,974,405,569,460867,Львівська область
14453,460868,1047,25,568,256,312,460868,Львівська область
14454,460869,299,9,197,78,119,460869,Львівська область
14455,460870,304,1,272,76,196,460870,Львівська область
14456,460871,125,4,83,40,43,460871,Львівська область
14457,460872,650,14,539,170,369,460872,Львівська область
14458,460873,158,0,138,27,111,460873,Львівська область
14459,460874,494,4,319,54,265,460874,Львівська область
14460,460875,150,5,134,19,115,460875,Львівська область
14461,460876,214,6,151,52,99,460876,Львівська область
14462,460877,348,7,303,115,188,460877,Львівська область
14463,460878,597,11,383,138,245,460878,Львівська область
14464,460879,280,0,225,82,143,460879,Львівська область
14465,460880,443,2,326,90,236,460880,Львівська область
14466,460881,237,4,201,69,132,460881,Львівська область
14467,460882,522,10,379,123,256,460882,Львівська область
14468,460883,156,1,124,39,85,460883,Львівська область
14469,460884,432,2,317,124,193,460884,Львівська область
14470,460885,372,3,307,101,206,460885,Львівська область
14471,460886,126,1,84,8,76,460886,Львівська область
14472,460887,82,1,59,14,45,460887,Львівська область
14473,460888,423,0,310,92,218,460888,Львівська область
14474,460889,240,5,135,35,100,460889,Львівська область
14475,460890,265,0,205,34,171,460890,Львівська область
14476,460891,241,0,162,47,115,460891,Львівська область
14477,460892,458,5,355,116,239,460892,Львівська область
14478,460893,189,9,147,35,112,460893,Львівська область
14479,460894,223,4,170,79,91,460894,Львівська область
14480,460895,378,5,268,60,208,460895,Львівська область
14481,460896,404,5,301,116,185,460896,Львівська область
14482,460897,410,4,311,99,212,460897,Львівська область
14483,460898,62,1,40,9,31,460898,Львівська область
14484,460899,692,4,506,176,330,460899,Львівська область
14485,460900,405,4,298,111,187,460900,Львівська область
14486,460901,396,3,326,97,229,460901,Львівська область
14487,460902,199,0,125,36,89,460902,Львівська область
14488,460903,77,1,70,33,37,460903,Львівська область
14489,461746,1366,25,817,268,549,461746,Львівська область
14490,461747,1544,63,828,333,495,461747,Львівська область
14491,461748,1558,24,906,375,531,461748,Львівська область
14492,461749,1663,22,893,358,535,461749,Львівська область
14493,461750,1475,29,785,352,433,461750,Львівська область
14494,461751,1444,22,795,330,465,461751,Львівська область
14495,461752,1490,24,698,290,408,461752,Львівська область
14496,461753,1481,19,795,301,494,461753,Львівська область
14497,461754,1481,24,829,313,516,461754,Львівська область
14498,461755,1460,21,794,282,512,461755,Львівська область
14499,461756,1559,21,858,347,511,461756,Львівська область
14500,461757,1500,16,870,324,546,461757,Львівська область
14501,461758,24,0,23,12,11,461758,Львівська область
14502,462155,28,3,24,9,15,462155,Львівська область
14503,460619,1533,27,931,483,448,460619,Львівська область
14504,460620,1387,20,897,377,520,460620,Львівська область
14505,460621,1908,33,1152,612,540,460621,Львівська область
14506,460624,1578,15,984,443,541,460624,Львівська область
14507,460644,498,9,417,123,294,460644,Львівська область
14508,460645,109,1,94,37,57,460645,Львівська область
14509,460646,168,1,143,35,108,460646,Львівська область
14510,460647,128,1,111,42,69,460647,Львівська область
14511,460648,380,7,290,109,181,460648,Львівська область
14512,460654,718,9,439,125,314,460654,Львівська область
14513,460656,578,6,494,169,325,460656,Львівська область
14514,460657,97,4,84,32,52,460657,Львівська область
14515,460659,310,6,252,119,133,460659,Львівська область
14516,460660,562,3,385,128,257,460660,Львівська область
14517,460661,247,4,190,99,91,460661,Львівська область
14518,460662,247,3,191,85,106,460662,Львівська область
14519,460665,887,11,609,315,294,460665,Львівська область
14520,460666,932,18,603,238,365,460666,Львівська область
14521,460667,309,11,214,113,101,460667,Львівська область
14522,460668,224,7,155,68,87,460668,Львівська область
14523,460669,501,5,317,139,178,460669,Львівська область
14524,461205,95,0,81,46,35,461205,Львівська область
14525,461206,95,0,75,39,36,461206,Львівська область
14526,461207,344,1,280,116,164,461207,Львівська область
14527,461208,429,8,304,137,167,461208,Львівська область
14528,461209,311,5,238,160,78,461209,Львівська область
14529,461210,66,0,55,23,32,461210,Львівська область
14530,461211,165,1,127,58,69,461211,Львівська область
14531,461212,580,8,433,173,260,461212,Львівська область
14532,461213,398,6,311,122,189,461213,Львівська область
14533,461214,740,10,424,224,200,461214,Львівська область
14534,461216,633,7,366,187,179,461216,Львівська область
14535,461217,715,8,488,231,257,461217,Львівська область
14536,461218,990,9,571,298,273,461218,Львівська область
14537,461219,120,2,76,46,30,461219,Львівська область
14538,461220,547,9,358,180,178,461220,Львівська область
14539,461221,277,1,195,91,104,461221,Львівська область
14540,461222,322,3,239,82,157,461222,Львівська область
14541,461223,583,4,387,222,165,461223,Львівська область
14542,461224,156,0,141,86,55,461224,Львівська область
14543,461225,201,2,138,71,67,461225,Львівська область
14544,461226,341,5,273,174,99,461226,Львівська область
14545,461227,253,0,181,66,115,461227,Львівська область
14546,461228,388,3,248,119,129,461228,Львівська область
14547,461229,344,6,242,125,117,461229,Львівська область
14548,461230,449,5,350,106,244,461230,Львівська область
14549,461231,462,5,380,94,286,461231,Львівська область
14550,461232,544,13,380,137,243,461232,Львівська область
14551,461233,382,2,265,91,174,461233,Львівська область
14552,461234,796,13,566,220,346,461234,Львівська область
14553,461235,589,35,484,171,313,461235,Львівська область
14554,461236,177,1,153,62,91,461236,Львівська область
14555,461237,1221,10,728,359,369,461237,Львівська область
14556,461238,308,0,232,103,129,461238,Львівська область
14557,461239,454,7,291,140,151,461239,Львівська область
14558,461240,563,3,452,237,215,461240,Львівська область
14559,461241,262,0,217,117,100,461241,Львівська область
14560,461242,122,0,95,38,57,461242,Львівська область
14561,461243,663,6,433,191,242,461243,Львівська область
14562,461244,1303,63,818,293,525,461244,Львівська область
14563,461245,228,9,151,62,89,461245,Львівська область
14564,461246,2188,48,1272,572,700,461246,Львівська область
14565,461247,1956,30,1123,536,587,461247,Львівська область
14566,461248,2337,33,1298,568,730,461248,Львівська область
14567,461249,2204,40,1272,607,665,461249,Львівська область
14568,461250,2261,28,1272,624,648,461250,Львівська область
14569,461251,2012,35,1041,504,537,461251,Львівська область
14570,461252,2046,36,1154,542,612,461252,Львівська область
14571,461253,1091,14,734,346,388,461253,Львівська область
14572,461254,470,5,362,203,159,461254,Львівська область
14573,461255,340,5,268,129,139,461255,Львівська область
14574,461256,649,9,527,179,348,461256,Львівська область
14575,461257,154,1,120,51,69,461257,Львівська область
14576,461258,127,0,97,43,54,461258,Львівська область
14577,461259,222,1,176,49,127,461259,Львівська область
14578,461261,410,3,289,135,154,461261,Львівська область
14579,461262,477,15,367,186,181,461262,Львівська область
14580,461263,1409,20,830,425,405,461263,Львівська область
14581,461264,1344,25,830,422,408,461264,Львівська область
14582,461265,869,18,606,225,381,461265,Львівська область
14583,461266,721,10,511,232,279,461266,Львівська область
14584,461267,635,13,477,209,268,461267,Львівська область
14585,461268,1375,53,1003,329,674,461268,Львівська область
14586,461269,531,10,390,157,233,461269,Львівська область
14587,461270,79,0,52,17,35,461270,Львівська область
14588,461271,815,41,578,236,342,461271,Львівська область
14589,461272,361,9,294,105,189,461272,Львівська область
14590,461273,219,4,149,52,97,461273,Львівська область
14591,461274,561,9,352,154,198,461274,Львівська область
14592,461275,427,9,313,134,179,461275,Львівська область
14593,461276,339,3,237,88,149,461276,Львівська область
14594,461277,301,3,197,85,112,461277,Львівська область
14595,461278,729,9,467,241,226,461278,Львівська область
14596,461279,144,3,98,22,76,461279,Львівська область
14597,461280,741,16,481,136,345,461280,Львівська область
14598,461281,62,2,42,26,16,461281,Львівська область
14599,461282,93,2,58,18,40,461282,Львівська область
14600,461283,88,0,80,11,69,461283,Львівська область
14601,461284,615,10,517,153,364,461284,Львівська область
14602,461285,369,5,283,75,208,461285,Львівська область
14603,461286,1533,23,914,336,578,461286,Львівська область
14604,461287,201,0,167,36,131,461287,Львівська область
14605,461288,1411,11,925,289,636,461288,Львівська область
14606,461289,407,8,278,112,166,461289,Львівська область
14607,461290,592,9,421,175,246,461290,Львівська область
14608,461291,333,9,240,116,124,461291,Львівська область
14609,461292,363,12,271,160,111,461292,Львівська область
14610,461293,711,17,515,286,229,461293,Львівська область
14611,461294,1325,23,898,420,478,461294,Львівська область
14612,461296,1658,40,1068,565,503,461296,Львівська область
14613,461297,957,14,601,296,305,461297,Львівська область
14614,461298,631,11,459,187,272,461298,Львівська область
14615,461299,1257,28,863,393,470,461299,Львівська область
14616,461300,1012,19,635,279,356,461300,Львівська область
14617,461301,424,13,265,133,132,461301,Львівська область
14618,461302,131,2,114,42,72,461302,Львівська область
14619,461303,402,8,271,104,167,461303,Львівська область
14620,461304,325,7,265,154,111,461304,Львівська область
14621,461305,2244,60,1413,595,818,461305,Львівська область
14622,461306,2473,50,1516,602,914,461306,Львівська область
14623,461307,1236,18,815,368,447,461307,Львівська область
14624,461308,309,2,218,95,123,461308,Львівська область
14625,461311,51,0,48,21,27,461311,Львівська область
14626,461314,19,1,16,10,6,461314,Львівська область
14627,461315,14,0,14,7,7,461315,Львівська область
14628,461816,2368,50,1412,745,667,461816,Львівська область
14629,461817,1984,53,1248,595,653,461817,Львівська область
14630,461818,2162,56,1325,640,685,461818,Львівська область
14631,461819,2186,60,1241,602,639,461819,Львівська область
14632,461820,2251,30,1426,667,759,461820,Львівська область
14633,461821,2037,41,1244,556,688,461821,Львівська область
14634,461822,2133,43,1277,660,617,461822,Львівська область
14635,461823,2051,45,1189,600,589,461823,Львівська область
14636,461824,2164,51,1267,612,655,461824,Львівська область
14637,461825,2134,39,1306,617,689,461825,Львівська область
14638,461826,2225,35,1399,676,723,461826,Львівська область
14639,461827,2174,48,1324,640,684,461827,Львівська область
14640,461828,2039,47,1189,620,569,461828,Львівська область
14641,461829,2152,46,1217,593,624,461829,Львівська область
14642,461830,2228,53,1294,642,652,461830,Львівська область
14643,461831,2164,29,1313,636,677,461831,Львівська область
14644,461832,2176,56,1305,639,666,461832,Львівська область
14645,461833,1997,54,1106,574,532,461833,Львівська область
14646,461834,1885,35,1217,696,521,461834,Львівська область
14647,461835,2243,50,1412,617,795,461835,Львівська область
14648,461836,1670,35,1015,510,505,461836,Львівська область
14649,461837,2273,62,1418,693,725,461837,Львівська область
14650,461838,2367,54,1473,658,815,461838,Львівська область
14651,461839,2104,42,1333,639,694,461839,Львівська область
14652,461840,2180,45,1256,681,575,461840,Львівська область
14653,461841,2138,52,1250,646,604,461841,Львівська область
14654,461842,1752,46,1010,550,460,461842,Львівська область
14655,461843,2000,58,1187,551,636,461843,Львівська область
14656,461845,65,2,56,25,31,461845,Львівська область
14657,461847,17,0,17,9,8,461847,Львівська область
14658,461137,750,13,493,283,210,461137,Львівська область
14659,461138,557,8,351,169,182,461138,Львівська область
14660,461139,960,8,643,369,274,461139,Львівська область
14661,461148,877,11,560,279,281,461148,Львівська область
14662,461149,391,1,226,97,129,461149,Львівська область
14663,461150,138,1,76,29,47,461150,Львівська область
14664,461151,332,2,228,48,180,461151,Львівська область
14665,461152,232,2,178,33,145,461152,Львівська область
14666,461153,1520,14,904,163,741,461153,Львівська область
14667,461154,505,9,368,113,255,461154,Львівська область
14668,461155,919,11,662,91,571,461155,Львівська область
14669,461156,920,6,604,190,414,461156,Львівська область
14670,461157,177,1,141,54,87,461157,Львівська область
14671,461158,1328,16,713,354,359,461158,Львівська область
14672,461159,1391,17,774,346,428,461159,Львівська область
14673,461160,835,12,600,151,449,461160,Львівська область
14674,461161,171,5,115,42,73,461161,Львівська область
14675,461162,1334,19,909,264,645,461162,Львівська область
14676,461163,312,6,215,63,152,461163,Львівська область
14677,461164,2199,44,1330,536,794,461164,Львівська область
14678,461165,1964,30,1191,552,639,461165,Львівська область
14679,461166,506,5,272,115,157,461166,Львівська область
14680,461167,663,4,453,247,206,461167,Львівська область
14681,461168,260,2,173,73,100,461168,Львівська область
14682,461169,332,6,210,96,114,461169,Львівська область
14683,461170,451,5,246,143,103,461170,Львівська область
14684,461171,436,4,224,123,101,461171,Львівська область
14685,461172,323,5,194,109,85,461172,Львівська область
14686,461173,189,5,131,56,75,461173,Львівська область
14687,461174,224,4,128,71,57,461174,Львівська область
14688,461175,700,19,502,163,339,461175,Львівська область
14689,461176,464,2,325,124,201,461176,Львівська область
14690,461177,1340,26,953,520,433,461177,Львівська область
14691,461178,237,1,157,64,93,461178,Львівська область
14692,461179,348,2,200,90,110,461179,Львівська область
14693,461180,245,7,152,104,48,461180,Львівська область
14694,461181,435,12,271,110,161,461181,Львівська область
14695,461182,295,2,183,74,109,461182,Львівська область
14696,461183,442,3,251,162,89,461183,Львівська область
14697,461184,285,4,172,95,77,461184,Львівська область
14698,461185,602,10,391,184,207,461185,Львівська область
14699,461186,943,10,598,360,238,461186,Львівська область
14700,461187,679,4,440,210,230,461187,Львівська область
14701,461188,60,1,47,29,18,461188,Львівська область
14702,461189,1368,21,859,523,336,461189,Львівська область
14703,461190,1301,15,793,450,343,461190,Львівська область
14704,461191,165,1,126,48,78,461191,Львівська область
14705,461192,260,1,199,93,106,461192,Львівська область
14706,461193,213,4,136,93,43,461193,Львівська область
14707,461194,659,6,513,288,225,461194,Львівська область
14708,461195,933,17,494,294,200,461195,Львівська область
14709,461196,565,7,430,222,208,461196,Львівська область
14710,461197,600,3,370,174,196,461197,Львівська область
14711,461198,805,6,391,228,163,461198,Львівська область
14712,461199,1107,7,690,418,272,461199,Львівська область
14713,461200,447,2,276,189,87,461200,Львівська область
14714,461201,274,4,146,85,61,461201,Львівська область
14715,461202,709,16,465,242,223,461202,Львівська область
14716,461203,646,1,409,196,213,461203,Львівська область
14717,461204,59,1,51,24,27,461204,Львівська область
14718,461317,1584,22,774,347,427,461317,Львівська область
14719,461318,1425,23,791,350,441,461318,Львівська область
14720,461319,2250,36,1322,600,722,461319,Львівська область
14721,461320,2348,36,1293,656,637,461320,Львівська область
14722,461321,1962,44,1055,664,391,461321,Львівська область
14723,461322,1018,24,627,333,294,461322,Львівська область
14724,461323,1321,20,788,387,401,461323,Львівська область
14725,461324,811,20,582,239,343,461324,Львівська область
14726,461325,531,6,365,135,230,461325,Львівська область
14727,461326,1026,9,528,263,265,461326,Львівська область
14728,461327,444,11,356,164,192,461327,Львівська область
14729,461328,327,3,223,109,114,461328,Львівська область
14730,461329,220,0,138,37,101,461329,Львівська область
14731,461330,281,1,188,68,120,461330,Львівська область
14732,461331,914,11,540,206,334,461331,Львівська область
14733,461332,290,2,174,77,97,461332,Львівська область
14734,461333,346,2,271,99,172,461333,Львівська область
14735,461334,292,10,234,86,148,461334,Львівська область
14736,461335,935,21,757,274,483,461335,Львівська область
14737,461336,546,15,376,196,180,461336,Львівська область
14738,461337,138,4,105,62,43,461337,Львівська область
14739,461338,912,15,594,296,298,461338,Львівська область
14740,461339,736,17,522,177,345,461339,Львівська область
14741,461340,448,1,273,143,130,461340,Львівська область
14742,461341,210,0,172,52,120,461341,Львівська область
14743,461342,652,4,376,126,250,461342,Львівська область
14744,461343,878,6,520,256,264,461343,Львівська область
14745,461344,276,2,212,101,111,461344,Львівська область
14746,461345,458,5,269,114,155,461345,Львівська область
14747,461346,69,1,51,21,30,461346,Львівська область
14748,461347,318,9,242,106,136,461347,Львівська область
14749,461348,213,0,179,36,143,461348,Львівська область
14750,461349,65,1,55,32,23,461349,Львівська область
14751,461350,324,8,267,100,167,461350,Львівська область
14752,461351,299,5,212,102,110,461351,Львівська область
14753,461352,42,0,35,7,28,461352,Львівська область
14754,461353,91,0,65,29,36,461353,Львівська область
14755,461354,469,6,309,147,162,461354,Львівська область
14756,461355,182,0,154,86,68,461355,Львівська область
14757,461356,500,5,419,121,298,461356,Львівська область
14758,461357,354,13,268,155,113,461357,Львівська область
14759,461358,97,0,76,22,54,461358,Львівська область
14760,461359,388,9,269,148,121,461359,Львівська область
14761,461360,568,3,420,183,237,461360,Львівська область
14762,461361,507,9,328,97,231,461361,Львівська область
14763,461362,463,4,368,190,178,461362,Львівська область
14764,461363,660,15,545,234,311,461363,Львівська область
14765,461364,355,4,269,98,171,461364,Львівська область
14766,461365,131,1,108,24,84,461365,Львівська область
14767,461366,414,10,353,147,206,461366,Львівська область
14768,461367,193,7,157,48,109,461367,Львівська область
14769,461368,169,2,142,67,75,461368,Львівська область
14770,461369,127,2,112,44,68,461369,Львівська область
14771,461370,275,4,189,61,128,461370,Львівська область
14772,461371,79,1,42,8,34,461371,Львівська область
14773,461372,117,5,64,19,45,461372,Львівська область
14774,461373,624,13,402,167,235,461373,Львівська область
14775,461374,447,6,349,162,187,461374,Львівська область
14776,461375,167,4,131,59,72,461375,Львівська область
14777,461376,216,2,158,46,112,461376,Львівська область
14778,461377,357,9,233,82,151,461377,Львівська область
14779,461378,477,4,337,167,170,461378,Львівська область
14780,461379,214,3,176,118,58,461379,Львівська область
14781,461380,219,5,176,67,109,461380,Львівська область
14782,461381,891,20,580,340,240,461381,Львівська область
14783,461382,101,5,77,48,29,461382,Львівська область
14784,461383,352,3,233,150,83,461383,Львівська область
14785,461384,510,10,338,180,158,461384,Львівська область
14786,461385,490,10,306,210,96,461385,Львівська область
14787,461387,387,7,253,116,137,461387,Львівська область
14788,461388,325,2,236,92,144,461388,Львівська область
14789,461389,1042,22,782,380,402,461389,Львівська область
14790,461390,315,1,239,99,140,461390,Львівська область
14791,461391,381,6,278,153,125,461391,Львівська область
14792,461392,794,8,480,246,234,461392,Львівська область
14793,461393,449,6,253,79,174,461393,Львівська область
14794,461394,528,12,336,144,192,461394,Львівська область
14795,461395,1577,15,970,501,469,461395,Львівська область
14796,461396,389,9,250,158,92,461396,Львівська область
14797,461397,1330,16,783,401,382,461397,Львівська область
14798,461398,832,13,643,345,298,461398,Львівська область
14799,461399,839,9,536,256,280,461399,Львівська область
14800,461400,720,7,470,285,185,461400,Львівська область
14801,461401,208,3,159,59,100,461401,Львівська область
14802,461402,725,5,513,181,332,461402,Львівська область
14803,461403,597,4,385,183,202,461403,Львівська область
14804,461404,733,12,460,173,287,461404,Львівська область
14805,461405,143,0,125,34,91,461405,Львівська область
14806,461406,381,9,244,123,121,461406,Львівська область
14807,461407,302,9,212,95,117,461407,Львівська область
14808,461408,505,5,399,151,248,461408,Львівська область
14809,461409,1161,13,739,355,384,461409,Львівська область
14810,461410,156,2,143,22,121,461410,Львівська область
14811,461411,732,15,473,198,275,461411,Львівська область
14812,461412,267,1,182,86,96,461412,Львівська область
14813,461414,612,8,388,184,204,461414,Львівська область
14814,461415,239,4,173,38,135,461415,Львівська область
14815,461416,372,4,244,134,110,461416,Львівська область
14816,461418,608,12,489,216,273,461418,Львівська область
14817,461419,166,2,143,72,71,461419,Львівська область
14818,461420,187,2,134,41,93,461420,Львівська область
14819,461421,638,7,395,196,199,461421,Львівська область
14820,461422,470,7,288,114,174,461422,Львівська область
14821,461423,69,0,52,29,23,461423,Львівська область
14822,461424,164,2,101,57,44,461424,Львівська область
14823,461425,795,8,491,205,286,461425,Львівська область
14824,461426,251,3,150,55,95,461426,Львівська область
14825,461427,290,3,201,98,103,461427,Львівська область
14826,461428,51,1,50,20,30,461428,Львівська область
14827,461429,21,0,21,9,12,461429,Львівська область
14828,461430,26,0,26,11,15,461430,Львівська область
14829,461432,24,0,24,11,13,461432,Львівська область
14830,461433,15,0,15,4,11,461433,Львівська область
14831,461434,23,0,22,9,13,461434,Львівська область
14832,461435,30,0,30,11,19,461435,Львівська область
14833,461505,2311,46,1271,730,541,461505,Львівська область
14834,461506,1936,32,1044,545,499,461506,Львівська область
14835,461507,1345,20,793,389,404,461507,Львівська область
14836,461508,1041,6,531,273,258,461508,Львівська область
14837,461509,898,2,423,196,227,461509,Львівська область
14838,461510,1405,4,691,191,500,461510,Львівська область
14839,461511,799,8,473,137,336,461511,Львівська область
14840,461512,794,1,592,123,469,461512,Львівська область
14841,461513,303,2,206,76,130,461513,Львівська область
14842,461514,296,4,233,60,173,461514,Львівська область
14843,461515,292,8,227,109,118,461515,Львівська область
14844,461516,791,14,606,245,361,461516,Львівська область
14845,461517,595,10,430,174,256,461517,Львівська область
14846,461518,1288,15,925,380,545,461518,Львівська область
14847,461519,925,4,455,167,288,461519,Львівська область
14848,461520,406,5,240,128,112,461520,Львівська область
14849,461521,886,5,596,195,401,461521,Львівська область
14850,461522,998,10,773,326,447,461522,Львівська область
14851,461523,218,1,149,61,88,461523,Львівська область
14852,461524,243,0,190,99,91,461524,Львівська область
14853,461525,684,1,366,223,143,461525,Львівська область
14854,461526,569,4,367,82,285,461526,Львівська область
14855,461527,176,3,107,34,73,461527,Львівська область
14856,461528,108,5,74,33,41,461528,Львівська область
14857,461529,560,10,302,139,163,461529,Львівська область
14858,461530,215,1,123,62,61,461530,Львівська область
14859,461531,237,2,131,40,91,461531,Львівська область
14860,461532,100,3,71,23,48,461532,Львівська область
14861,461533,294,1,179,67,112,461533,Львівська область
14862,461534,202,2,115,35,80,461534,Львівська область
14863,461535,368,0,220,109,111,461535,Львівська область
14864,461536,295,2,162,72,90,461536,Львівська область
14865,461537,72,1,40,19,21,461537,Львівська область
14866,461538,731,2,376,214,162,461538,Львівська область
14867,461539,766,14,414,225,189,461539,Львівська область
14868,461540,183,2,124,36,88,461540,Львівська область
14869,461541,343,1,212,113,99,461541,Львівська область
14870,461542,189,1,120,92,28,461542,Львівська область
14871,461543,493,4,211,116,95,461543,Львівська область
14872,461544,1010,13,565,254,311,461544,Львівська область
14873,461545,725,7,377,228,149,461545,Львівська область
14874,461546,260,2,162,103,59,461546,Львівська область
14875,461547,107,1,78,22,56,461547,Львівська область
14876,461548,163,1,97,64,33,461548,Львівська область
14877,461549,330,2,221,81,140,461549,Львівська область
14878,461550,314,4,208,54,154,461550,Львівська область
14879,461551,428,3,293,129,164,461551,Львівська область
14880,461552,593,5,300,136,164,461552,Львівська область
14881,461553,549,5,292,167,125,461553,Львівська область
14882,461554,347,3,178,85,93,461554,Львівська область
14883,461555,782,5,408,204,204,461555,Львівська область
14884,461556,245,4,196,92,104,461556,Львівська область
14885,461557,629,9,367,137,230,461557,Львівська область
14886,461558,665,5,366,140,226,461558,Львівська область
14887,461559,968,6,527,192,335,461559,Львівська область
14888,461560,554,0,395,152,243,461560,Львівська область
14889,461561,799,12,427,212,215,461561,Львівська область
14890,461562,556,3,298,167,131,461562,Львівська область
14891,461563,299,4,176,76,100,461563,Львівська область
14892,461564,232,5,140,75,65,461564,Львівська область
14893,461565,349,5,199,117,82,461565,Львівська область
14894,461566,582,3,314,151,163,461566,Львівська область
14895,461567,297,3,174,59,115,461567,Львівська область
14896,461569,43,0,28,13,15,461569,Львівська область
14897,461570,18,0,18,11,7,461570,Львівська область
14898,461759,1142,26,647,273,374,461759,Львівська область
14899,461760,1514,27,864,362,502,461760,Львівська область
14900,461761,1524,31,904,408,496,461761,Львівська область
14901,461762,1470,24,831,397,434,461762,Львівська область
14902,461763,1595,37,938,458,480,461763,Львівська область
14903,461764,1727,38,945,482,463,461764,Львівська область
14904,461765,1646,27,970,445,525,461765,Львівська область
14905,461766,1296,36,744,324,420,461766,Львівська область
14906,461767,1387,24,750,331,419,461767,Львівська область
14907,461768,1375,31,769,319,450,461768,Львівська область
14908,461769,1500,32,821,405,416,461769,Львівська область
14909,461770,1469,26,886,403,483,461770,Львівська область
14910,461771,1444,24,882,404,478,461771,Львівська область
14911,461772,1513,45,830,393,437,461772,Львівська область
14912,461773,1438,40,845,396,449,461773,Львівська область
14913,461774,1474,30,851,378,473,461774,Львівська область
14914,461775,1491,25,887,457,430,461775,Львівська область
14915,461776,1409,22,822,324,498,461776,Львівська область
14916,461777,80,3,56,27,29,461777,Львівська область
14917,462163,469,5,306,137,169,462163,Львівська область
14918,460298,456,5,272,102,170,460298,Львівська область
14919,460299,168,1,114,28,86,460299,Львівська область
14920,460300,267,6,208,67,141,460300,Львівська область
14921,460301,128,1,97,15,82,460301,Львівська область
14922,460302,117,5,86,18,68,460302,Львівська область
14923,460303,167,6,137,29,108,460303,Львівська область
14924,460304,57,0,52,15,37,460304,Львівська область
14925,460305,216,0,186,35,151,460305,Львівська область
14926,460306,138,1,109,27,82,460306,Львівська область
14927,460307,37,0,34,10,24,460307,Львівська область
14928,460308,276,5,252,68,184,460308,Львівська область
14929,460309,197,1,169,35,134,460309,Львівська область
14930,460310,155,9,119,27,92,460310,Львівська область
14931,460311,230,18,174,43,131,460311,Львівська область
14932,460312,267,3,187,43,144,460312,Львівська область
14933,460313,113,1,84,3,81,460313,Львівська область
14934,460314,66,0,53,12,41,460314,Львівська область
14935,460315,83,0,76,9,67,460315,Львівська область
14936,460316,115,1,78,12,66,460316,Львівська область
14937,460317,109,9,86,10,76,460317,Львівська область
14938,460318,209,4,162,53,109,460318,Львівська область
14939,460319,646,9,481,131,350,460319,Львівська область
14940,460320,181,1,143,21,122,460320,Львівська область
14941,460321,510,7,403,70,333,460321,Львівська область
14942,460322,46,0,43,2,41,460322,Львівська область
14943,460323,545,8,402,108,294,460323,Львівська область
14944,460324,66,1,50,14,36,460324,Львівська область
14945,460325,159,0,129,49,80,460325,Львівська область
14946,460326,377,51,292,13,279,460326,Львівська область
14947,460327,605,7,480,111,369,460327,Львівська область
14948,460328,291,4,207,79,128,460328,Львівська область
14949,460329,541,8,413,164,249,460329,Львівська область
14950,460330,425,6,347,114,233,460330,Львівська область
14951,460331,341,15,291,46,245,460331,Львівська область
14952,460332,522,14,340,132,208,460332,Львівська область
14953,460333,773,11,610,161,449,460333,Львівська область
14954,460334,340,4,233,111,122,460334,Львівська область
14955,460335,164,16,117,35,82,460335,Львівська область
14956,460336,525,12,383,162,221,460336,Львівська область
14957,460337,475,6,341,175,166,460337,Львівська область
14958,460338,330,1,247,110,137,460338,Львівська область
14959,460339,953,17,557,264,293,460339,Львівська область
14960,460340,417,3,275,68,207,460340,Львівська область
14961,460341,137,1,109,18,91,460341,Львівська область
14962,460342,1469,36,720,268,452,460342,Львівська область
14963,460343,1619,28,814,317,497,460343,Львівська область
14964,460344,1436,19,877,277,600,460344,Львівська область
14965,460345,1562,22,920,343,577,460345,Львівська область
14966,460346,1539,44,1035,272,763,460346,Львівська область
14967,460347,205,15,138,19,119,460347,Львівська область
14968,460348,761,28,484,143,341,460348,Львівська область
14969,460349,323,6,255,64,191,460349,Львівська область
14970,460350,267,3,163,46,117,460350,Львівська область
14971,460351,580,15,438,182,256,460351,Львівська область
14972,460352,529,15,437,156,281,460352,Львівська область
14973,460353,306,12,243,78,165,460353,Львівська область
14974,460354,299,5,257,100,157,460354,Львівська область
14975,460355,436,17,357,187,170,460355,Львівська область
14976,460356,305,3,242,126,116,460356,Львівська область
14977,460357,1492,39,823,341,482,460357,Львівська область
14978,460358,1453,24,903,353,550,460358,Львівська область
14979,460359,1680,35,995,388,607,460359,Львівська область
14980,460360,1448,29,824,304,520,460360,Львівська область
14981,460361,1640,40,955,389,566,460361,Львівська область
14982,460362,622,27,425,100,325,460362,Львівська область
14983,460363,305,0,237,74,163,460363,Львівська область
14984,460364,1253,22,840,337,503,460364,Львівська область
14985,460365,1929,42,1298,403,895,460365,Львівська область
14986,460366,463,16,307,185,122,460366,Львівська область
14987,460367,477,14,403,79,324,460367,Львівська область
14988,460368,76,0,57,30,27,460368,Львівська область
14989,460369,876,13,654,297,357,460369,Львівська область
14990,460370,262,1,200,76,124,460370,Львівська область
14991,460371,509,9,358,149,209,460371,Львівська область
14992,460372,200,4,139,52,87,460372,Львівська область
14993,460373,77,0,60,27,33,460373,Львівська область
14994,460374,311,6,239,52,187,460374,Львівська область
14995,460375,729,6,434,206,228,460375,Львівська область
14996,460376,92,1,76,5,71,460376,Львівська область
14997,460377,202,6,150,55,95,460377,Львівська область
14998,460378,126,3,98,37,61,460378,Львівська область
14999,460379,270,4,189,72,117,460379,Львівська область
15000,460380,459,9,347,176,171,460380,Львівська область
15001,460381,176,3,127,75,52,460381,Львівська область
15002,460382,755,14,562,222,340,460382,Львівська область
15003,460383,521,12,327,124,203,460383,Львівська область
15004,460384,260,1,215,77,138,460384,Львівська область
15005,460385,277,3,222,81,141,460385,Львівська область
15006,460386,64,1,59,12,47,460386,Львівська область
15007,460387,257,2,173,52,121,460387,Львівська область
15008,460388,185,0,137,51,86,460388,Львівська область
15009,460389,264,7,169,54,115,460389,Львівська область
15010,460390,60,0,35,6,29,460390,Львівська область
15011,460391,380,6,268,94,174,460391,Львівська область
15012,460392,342,1,230,93,137,460392,Львівська область
15013,460393,264,3,185,56,129,460393,Львівська область
15014,460394,1368,91,864,332,532,460394,Львівська область
15015,460395,1209,15,689,340,349,460395,Львівська область
15016,460396,307,22,247,39,208,460396,Львівська область
15017,460397,63,2,39,21,18,460397,Львівська область
15018,460398,591,10,479,209,270,460398,Львівська область
15019,460399,329,3,274,101,173,460399,Львівська область
15020,460400,102,0,66,46,20,460400,Львівська область
15021,460401,165,12,128,26,102,460401,Львівська область
15022,460402,371,8,236,109,127,460402,Львівська область
15023,460403,321,4,276,131,145,460403,Львівська область
15024,460404,144,8,112,66,46,460404,Львівська область
15025,460405,230,10,175,74,101,460405,Львівська область
15026,460406,372,2,311,140,171,460406,Львівська область
15027,460407,679,1,547,207,340,460407,Львівська область
15028,460408,168,1,126,33,93,460408,Львівська область
15029,460409,391,5,359,92,267,460409,Львівська область
15030,460410,412,7,293,79,214,460410,Львівська область
15031,460411,25,0,14,4,10,460411,Львівська область
15032,460412,148,1,92,50,42,460412,Львівська область
15033,460413,437,11,277,88,189,460413,Львівська область
15034,460414,205,4,133,60,73,460414,Львівська область
15035,460415,110,0,84,26,58,460415,Львівська область
15036,460416,343,9,290,97,193,460416,Львівська область
15037,460417,45,1,42,16,26,460417,Львівська область
15038,460418,36,2,30,7,23,460418,Львівська область
15039,461436,1782,37,1243,532,711,461436,Львівська область
15040,461437,176,1,148,70,78,461437,Львівська область
15041,461438,465,10,345,166,179,461438,Львівська область
15042,461439,1046,9,809,283,526,461439,Львівська область
15043,461440,511,10,379,162,217,461440,Львівська область
15044,461441,611,13,476,181,295,461441,Львівська область
15045,461442,428,5,353,161,192,461442,Львівська область
15046,461443,1257,31,1029,279,750,461443,Львівська область
15047,461444,724,16,545,204,341,461444,Львівська область
15048,461445,802,15,526,146,380,461445,Львівська область
15049,461446,1264,16,892,287,605,461446,Львівська область
15050,461447,576,37,437,151,286,461447,Львівська область
15051,461448,285,1,238,98,140,461448,Львівська область
15052,461449,840,15,584,258,326,461449,Львівська область
15053,461450,1484,28,1118,418,700,461450,Львівська область
15054,461451,307,4,238,58,180,461451,Львівська область
15055,461452,597,7,471,69,402,461452,Львівська область
15056,461453,291,8,229,93,136,461453,Львівська область
15057,461454,230,14,169,35,134,461454,Львівська область
15058,461455,423,14,326,73,253,461455,Львівська область
15059,461456,270,0,215,60,155,461456,Львівська область
15060,461457,1413,23,983,336,647,461457,Львівська область
15061,461458,1310,17,937,305,632,461458,Львівська область
15062,461459,713,5,600,148,452,461459,Львівська область
15063,461460,909,14,724,169,555,461460,Львівська область
15064,461461,952,15,642,365,277,461461,Львівська область
15065,461463,558,10,432,173,259,461463,Львівська область
15066,461464,655,14,578,329,249,461464,Львівська область
15067,461465,1038,33,703,306,397,461465,Львівська область
15068,461466,223,2,171,37,134,461466,Львівська область
15069,461467,634,43,543,74,469,461467,Львівська область
15070,461468,860,13,560,253,307,461468,Львівська область
15071,461469,1340,27,908,408,500,461469,Львівська область
15072,461470,882,9,652,168,484,461470,Львівська область
15073,461471,281,3,208,77,131,461471,Львівська область
15074,461472,1182,64,935,328,607,461472,Львівська область
15075,461473,259,3,205,86,119,461473,Львівська область
15076,461474,423,58,326,56,270,461474,Львівська область
15077,461475,813,11,660,151,509,461475,Львівська область
15078,461477,756,13,553,185,368,461477,Львівська область
15079,461478,592,9,460,156,304,461478,Львівська область
15080,461479,245,4,209,41,168,461479,Львівська область
15081,461480,1566,39,1101,396,705,461480,Львівська область
15082,461481,274,5,195,63,132,461481,Львівська область
15083,461482,733,43,584,119,465,461482,Львівська область
15084,461483,1138,23,738,273,465,461483,Львівська область
15085,461484,307,18,207,69,138,461484,Львівська область
15086,461485,663,10,483,212,271,461485,Львівська область
15087,461486,158,3,134,20,114,461486,Львівська область
15088,461487,303,2,233,137,96,461487,Львівська область
15089,461488,461,6,361,161,200,461488,Львівська область
15090,461489,711,6,564,237,327,461489,Львівська область
15091,461490,673,20,583,151,432,461490,Львівська область
15092,461491,399,4,355,62,293,461491,Львівська область
15093,461492,826,14,637,175,462,461492,Львівська область
15094,461493,603,11,437,179,258,461493,Львівська область
15095,461494,944,15,610,257,353,461494,Львівська область
15096,461495,772,16,527,192,335,461495,Львівська область
15097,461496,548,6,353,176,177,461496,Львівська область
15098,461497,690,30,572,190,382,461497,Львівська область
15099,461498,396,5,339,115,224,461498,Львівська область
15100,461499,461,14,376,130,246,461499,Львівська область
15101,461500,251,11,212,35,177,461500,Львівська область
15102,461501,965,20,773,286,487,461501,Львівська область
15103,461502,1353,29,974,403,571,461502,Львівська область
15104,461503,343,11,274,163,111,461503,Львівська область
15105,461504,683,12,513,275,238,461504,Львівська область
15106,461744,1954,26,1253,481,772,461744,Львівська область
15107,461745,1958,25,1253,565,688,461745,Львівська область
15108,461779,2311,35,1320,598,722,461779,Львівська область
15109,461780,2180,35,1291,556,735,461780,Львівська область
15110,461781,1713,41,1058,433,625,461781,Львівська область
15111,461782,2129,52,1293,553,740,461782,Львівська область
15112,461783,2003,37,1198,536,662,461783,Львівська область
15113,461784,1868,41,1089,424,665,461784,Львівська область
15114,461785,1237,30,730,289,441,461785,Львівська область
15115,461786,1576,45,951,410,541,461786,Львівська область
15116,461787,1221,21,697,320,377,461787,Львівська область
15117,461788,2156,51,1295,549,746,461788,Львівська область
15118,461789,1314,30,748,335,413,461789,Львівська область
15119,461790,1695,39,1043,381,662,461790,Львівська область
15120,461791,1750,38,1026,482,544,461791,Львівська область
15121,461792,1757,41,1047,467,580,461792,Львівська область
15122,461793,1597,34,936,463,473,461793,Львівська область
15123,461794,1730,33,1014,467,547,461794,Львівська область
15124,461795,2041,41,1245,575,670,461795,Львівська область
15125,461796,1405,26,872,400,472,461796,Львівська область
15126,461797,1688,34,1020,527,493,461797,Львівська область
15127,461798,1374,27,778,452,326,461798,Львівська область
15128,461799,1357,23,783,398,385,461799,Львівська область
15129,461800,1409,27,769,427,342,461800,Львівська область
15130,461801,1141,23,624,254,370,461801,Львівська область
15131,461802,1262,28,777,258,519,461802,Львівська область
15132,461803,1836,46,1115,440,675,461803,Львівська область
15133,461804,128,6,106,42,64,461804,Львівська область
15134,461805,45,1,41,16,25,461805,Львівська область
15135,461806,2,0,1,1,0,461806,Львівська область
15136,461807,11,0,10,6,4,461807,Львівська область
15137,480407,1754,20,982,869,113,480407,Миколаївська область
15138,480408,1064,8,582,530,52,480408,Миколаївська область
15139,480409,440,3,246,233,13,480409,Миколаївська область
15140,480410,392,4,211,187,24,480410,Миколаївська область
15141,480411,110,1,66,59,7,480411,Миколаївська область
15142,480412,157,1,109,79,30,480412,Миколаївська область
15143,480413,201,1,131,115,16,480413,Миколаївська область
15144,480414,113,0,76,68,8,480414,Миколаївська область
15145,480415,347,1,213,187,26,480415,Миколаївська область
15146,480416,1186,16,766,677,89,480416,Миколаївська область
15147,480417,383,4,214,175,39,480417,Миколаївська область
15148,480418,396,0,210,182,28,480418,Миколаївська область
15149,480419,1016,11,571,483,88,480419,Миколаївська область
15150,480420,498,1,295,263,32,480420,Миколаївська область
15151,480421,507,3,295,260,35,480421,Миколаївська область
15152,480422,245,1,126,106,20,480422,Миколаївська область
15153,480423,293,3,153,143,10,480423,Миколаївська область
15154,480424,218,1,126,115,11,480424,Миколаївська область
15155,480425,713,7,441,390,51,480425,Миколаївська область
15156,480426,252,2,144,127,17,480426,Миколаївська область
15157,480427,1177,17,705,606,99,480427,Миколаївська область
15158,480428,710,10,422,371,51,480428,Миколаївська область
15159,480429,174,0,79,68,11,480429,Миколаївська область
15160,480430,165,1,83,74,9,480430,Миколаївська область
15161,480431,725,4,430,360,70,480431,Миколаївська область
15162,480432,710,8,461,418,43,480432,Миколаївська область
15163,480433,1214,14,594,548,46,480433,Миколаївська область
15164,480434,431,3,228,213,15,480434,Миколаївська область
15165,480435,174,0,90,76,14,480435,Миколаївська область
15166,480436,139,1,96,86,10,480436,Миколаївська область
15167,480437,859,13,488,442,46,480437,Миколаївська область
15168,480438,639,6,361,317,44,480438,Миколаївська область
15169,480439,1501,13,901,730,171,480439,Миколаївська область
15170,480440,677,9,430,367,63,480440,Миколаївська область
15171,480441,1423,10,906,836,70,480441,Миколаївська область
15172,480442,389,2,216,195,21,480442,Миколаївська область
15173,480443,768,7,402,332,70,480443,Миколаївська область
15174,480444,1250,11,732,612,120,480444,Миколаївська область
15175,480445,198,2,126,99,27,480445,Миколаївська область
15176,480446,481,2,271,231,40,480446,Миколаївська область
15177,480447,130,0,80,50,30,480447,Миколаївська область
15178,480448,124,0,79,63,16,480448,Миколаївська область
15179,480449,243,1,126,105,21,480449,Миколаївська область
15180,480450,137,0,75,62,13,480450,Миколаївська область
15181,480451,97,0,52,45,7,480451,Миколаївська область
15182,480453,142,5,121,109,12,480453,Миколаївська область
15183,480454,253,9,236,224,12,480454,Миколаївська область
15184,480535,863,7,519,435,84,480535,Миколаївська область
15185,480537,1079,3,650,576,74,480537,Миколаївська область
15186,480538,103,0,71,56,15,480538,Миколаївська область
15187,480539,154,0,101,80,21,480539,Миколаївська область
15188,480540,101,1,59,49,10,480540,Миколаївська область
15189,480541,854,6,512,441,71,480541,Миколаївська область
15190,480542,1506,13,884,807,77,480542,Миколаївська область
15191,480543,371,3,217,189,28,480543,Миколаївська область
15192,480544,204,4,118,96,22,480544,Миколаївська область
15193,480545,1552,10,943,877,66,480545,Миколаївська область
15194,480546,147,2,78,67,11,480546,Миколаївська область
15195,480547,267,0,195,180,15,480547,Миколаївська область
15196,480548,112,0,65,51,14,480548,Миколаївська область
15197,480549,709,9,377,310,67,480549,Миколаївська область
15198,480550,314,3,197,175,22,480550,Миколаївська область
15199,480551,603,7,322,267,55,480551,Миколаївська область
15200,480552,1823,20,1010,859,151,480552,Миколаївська область
15201,480667,1995,29,1095,963,132,480667,Миколаївська область
15202,480668,1334,16,683,606,77,480668,Миколаївська область
15203,480670,2261,26,1245,1001,244,480670,Миколаївська область
15204,480671,1142,9,636,563,73,480671,Миколаївська область
15205,480672,1759,24,1026,912,114,480672,Миколаївська область
15206,480673,2129,33,1167,1017,150,480673,Миколаївська область
15207,480728,2137,34,1369,1219,150,480728,Миколаївська область
15208,480729,2031,28,1330,1142,188,480729,Миколаївська область
15209,480730,2109,33,1358,1202,156,480730,Миколаївська область
15210,480731,2411,25,1582,1380,202,480731,Миколаївська область
15211,480732,2369,49,1522,1365,157,480732,Миколаївська область
15212,480733,2073,25,1329,1194,135,480733,Миколаївська область
15213,480734,2236,26,1471,1311,160,480734,Миколаївська область
15214,480735,2204,28,1452,1284,168,480735,Миколаївська область
15215,480736,2206,39,1437,1255,182,480736,Миколаївська область
15216,480737,1786,29,1141,1011,130,480737,Миколаївська область
15217,480738,1279,16,816,719,97,480738,Миколаївська область
15218,480739,2119,27,1348,1192,156,480739,Миколаївська область
15219,480740,2148,21,1290,1119,171,480740,Миколаївська область
15220,480741,2182,44,1374,1194,180,480741,Миколаївська область
15221,480742,2203,32,1377,1224,153,480742,Миколаївська область
15222,480743,2217,35,1449,1280,169,480743,Миколаївська область
15223,480744,1810,30,1052,918,134,480744,Миколаївська область
15224,480746,2022,26,1282,1136,146,480746,Миколаївська область
15225,480747,2369,14,1488,1322,166,480747,Миколаївська область
15226,480748,2181,40,1465,1287,178,480748,Миколаївська область
15227,480749,1876,27,1009,664,345,480749,Миколаївська область
15228,480750,2088,34,1248,1085,163,480750,Миколаївська область
15229,480751,2086,32,1375,1156,219,480751,Миколаївська область
15230,480752,2191,20,1306,1153,153,480752,Миколаївська область
15231,480753,1769,39,1123,948,175,480753,Миколаївська область
15232,480754,2104,39,1400,1181,219,480754,Миколаївська область
15233,480755,2152,31,1297,1111,186,480755,Миколаївська область
15234,480756,1863,32,1171,969,202,480756,Миколаївська область
15235,480757,1287,17,779,653,126,480757,Миколаївська область
15236,480758,1862,25,1135,956,179,480758,Миколаївська область
15237,480759,1621,27,1007,902,105,480759,Миколаївська область
15238,480760,1916,26,1159,1031,128,480760,Миколаївська область
15239,480761,1418,31,900,762,138,480761,Миколаївська область
15240,480762,1827,30,1203,1041,162,480762,Миколаївська область
15241,480763,1892,30,1173,1020,153,480763,Миколаївська область
15242,480764,1574,17,953,837,116,480764,Миколаївська область
15243,480765,1501,26,899,822,77,480765,Миколаївська область
15244,480766,1481,23,870,732,138,480766,Миколаївська область
15245,480767,1391,29,826,741,85,480767,Миколаївська область
15246,480768,2214,25,1370,1177,193,480768,Миколаївська область
15247,480769,2175,43,1356,1157,199,480769,Миколаївська область
15248,480770,2137,21,1394,1176,218,480770,Миколаївська область
15249,480771,1496,17,881,803,78,480771,Миколаївська область
15250,480772,2130,30,1266,1140,126,480772,Миколаївська область
15251,480773,2424,26,1408,1256,152,480773,Миколаївська область
15252,480774,1410,14,841,763,78,480774,Миколаївська область
15253,480775,1151,7,671,578,93,480775,Миколаївська область
15254,480776,1055,8,604,544,60,480776,Миколаївська область
15255,480777,92,2,82,74,8,480777,Миколаївська область
15256,480778,123,0,112,96,16,480778,Миколаївська область
15257,480779,61,0,55,49,6,480779,Миколаївська область
15258,480780,47,0,42,38,4,480780,Миколаївська область
15259,480781,2272,16,1400,1273,127,480781,Миколаївська область
15260,480782,2025,20,1290,1198,92,480782,Миколаївська область
15261,480783,1685,13,1096,982,114,480783,Миколаївська область
15262,480784,2183,30,1316,1171,145,480784,Миколаївська область
15263,480785,1479,20,948,843,105,480785,Миколаївська область
15264,480786,1733,24,1117,1001,116,480786,Миколаївська область
15265,480787,2451,38,1537,1341,196,480787,Миколаївська область
15266,480788,2112,20,1289,1169,120,480788,Миколаївська область
15267,480789,1617,26,1005,871,134,480789,Миколаївська область
15268,480790,2356,32,1292,1187,105,480790,Миколаївська область
15269,480791,1428,26,817,740,77,480791,Миколаївська область
15270,480792,1517,30,894,807,87,480792,Миколаївська область
15271,480793,2349,33,1473,1307,166,480793,Миколаївська область
15272,480794,1734,26,1055,932,123,480794,Миколаївська область
15273,480795,2152,38,1306,1177,129,480795,Миколаївська область
15274,480796,2246,20,1440,1280,160,480796,Миколаївська область
15275,480797,1753,27,1023,920,103,480797,Миколаївська область
15276,480798,2441,27,1566,1414,152,480798,Миколаївська область
15277,480799,2324,26,1501,1334,167,480799,Миколаївська область
15278,480800,2222,26,1449,1314,135,480800,Миколаївська область
15279,480801,2124,44,1371,1200,171,480801,Миколаївська область
15280,480804,2132,35,1337,1186,151,480804,Миколаївська область
15281,480805,2016,24,1360,1221,139,480805,Миколаївська область
15282,480806,2026,22,1282,1134,148,480806,Миколаївська область
15283,480807,1941,21,1054,943,111,480807,Миколаївська область
15284,480808,1954,32,1176,1051,125,480808,Миколаївська область
15285,480809,2230,27,1511,1311,200,480809,Миколаївська область
15286,480810,1651,14,961,874,87,480810,Миколаївська область
15287,480811,1759,27,1050,939,111,480811,Миколаївська область
15288,480812,2376,32,1478,1321,157,480812,Миколаївська область
15289,480813,2359,21,1499,1360,139,480813,Миколаївська область
15290,480814,146,5,130,119,11,480814,Миколаївська область
15291,480815,1464,22,985,865,120,480815,Миколаївська область
15292,480816,1533,14,948,841,107,480816,Миколаївська область
15293,480817,1707,19,1075,937,138,480817,Миколаївська область
15294,480818,2083,24,1334,1188,146,480818,Миколаївська область
15295,480819,2115,29,1233,1092,141,480819,Миколаївська область
15296,480820,2166,2,388,347,41,480820,Миколаївська область
15297,480821,1998,17,1310,1151,159,480821,Миколаївська область
15298,480822,2059,26,1329,1167,162,480822,Миколаївська область
15299,480823,1829,21,1182,1027,155,480823,Миколаївська область
15300,480824,1957,25,1168,1042,126,480824,Миколаївська область
15301,480825,1746,28,1167,1023,144,480825,Миколаївська область
15302,480826,2008,48,1274,1102,172,480826,Миколаївська область
15303,480827,2166,25,1286,1128,158,480827,Миколаївська область
15304,480828,1875,22,1232,1063,169,480828,Миколаївська область
15305,480829,2300,30,1392,1227,165,480829,Миколаївська область
15306,480830,2282,27,1361,1187,174,480830,Миколаївська область
15307,480831,2252,37,1369,1252,117,480831,Миколаївська область
15308,480832,2260,44,1446,1290,156,480832,Миколаївська область
15309,480833,1960,31,1233,1097,136,480833,Миколаївська область
15310,480834,1849,31,1141,1055,86,480834,Миколаївська область
15311,480835,1787,19,1057,918,139,480835,Миколаївська область
15312,480836,2064,35,1342,1170,172,480836,Миколаївська область
15313,480837,1935,33,1216,1056,160,480837,Миколаївська область
15314,480838,1626,29,1023,906,117,480838,Миколаївська область
15315,480839,1605,22,1041,953,88,480839,Миколаївська область
15316,480840,1345,17,907,811,96,480840,Миколаївська область
15317,480841,1825,16,1160,1029,131,480841,Миколаївська область
15318,480842,2063,40,1280,1140,140,480842,Миколаївська область
15319,480843,2091,20,1164,1045,119,480843,Миколаївська область
15320,480844,1821,31,1180,1039,141,480844,Миколаївська область
15321,480846,1997,39,1302,1139,163,480846,Миколаївська область
15322,480847,1467,35,917,819,98,480847,Миколаївська область
15323,480848,2057,30,1324,1191,133,480848,Миколаївська область
15324,480849,1379,24,897,814,83,480849,Миколаївська область
15325,480850,1488,29,971,868,103,480850,Миколаївська область
15326,480851,2192,39,1378,1212,166,480851,Миколаївська область
15327,480852,2177,34,1420,1258,162,480852,Миколаївська область
15328,480853,1541,23,956,844,112,480853,Миколаївська область
15329,480854,1638,14,960,867,93,480854,Миколаївська область
15330,480855,2262,32,1416,1241,175,480855,Миколаївська область
15331,480856,2019,19,1179,1075,104,480856,Миколаївська область
15332,480857,1960,20,1274,1159,115,480857,Миколаївська область
15333,480858,2254,24,1440,1267,173,480858,Миколаївська область
15334,480859,1637,21,1072,921,151,480859,Миколаївська область
15335,480860,2020,19,1251,1109,142,480860,Миколаївська область
15336,480861,2005,30,1269,1115,154,480861,Миколаївська область
15337,480862,2129,33,1388,1223,165,480862,Миколаївська область
15338,480863,2200,18,1352,1225,127,480863,Миколаївська область
15339,480864,2289,26,1313,1163,150,480864,Миколаївська область
15340,480865,1991,33,1268,1128,140,480865,Миколаївська область
15341,480866,2124,34,1396,1229,167,480866,Миколаївська область
15342,480867,47,0,41,39,2,480867,Миколаївська область
15343,480868,20,0,17,14,3,480868,Миколаївська область
15344,480869,140,7,118,102,16,480869,Миколаївська область
15345,480870,190,2,184,175,9,480870,Миколаївська область
15346,480871,30,1,26,24,2,480871,Миколаївська область
15347,480872,50,0,45,39,6,480872,Миколаївська область
15348,1,727,52,674,648,26,1,Миколаївська область
15349,480308,2154,30,1287,1171,116,480308,Миколаївська область
15350,480309,1550,20,910,808,102,480309,Миколаївська область
15351,480310,595,3,320,283,37,480310,Миколаївська область
15352,480311,1907,20,1037,963,74,480311,Миколаївська область
15353,480312,591,4,320,289,31,480312,Миколаївська область
15354,480313,344,1,201,160,41,480313,Миколаївська область
15355,480314,316,1,157,126,31,480314,Миколаївська область
15356,480315,1041,6,720,663,57,480315,Миколаївська область
15357,480316,2039,24,1251,1074,177,480316,Миколаївська область
15358,480317,1235,15,708,652,56,480317,Миколаївська область
15359,480318,377,4,213,187,26,480318,Миколаївська область
15360,480319,200,0,113,94,19,480319,Миколаївська область
15361,480320,973,6,613,559,54,480320,Миколаївська область
15362,480321,1153,10,682,618,64,480321,Миколаївська область
15363,480322,1357,8,800,744,56,480322,Миколаївська область
15364,480323,622,5,403,357,46,480323,Миколаївська область
15365,480324,428,2,268,260,8,480324,Миколаївська область
15366,480325,389,1,250,218,32,480325,Миколаївська область
15367,480326,1627,19,836,750,86,480326,Миколаївська область
15368,480327,1768,16,1003,903,100,480327,Миколаївська область
15369,480328,906,9,523,472,51,480328,Миколаївська область
15370,480329,123,3,115,95,20,480329,Миколаївська область
15371,480330,1441,21,845,752,93,480330,Миколаївська область
15372,480331,1314,15,772,691,81,480331,Миколаївська область
15373,480332,1870,18,1112,978,134,480332,Миколаївська область
15374,480333,1589,4,847,794,53,480333,Миколаївська область
15375,480334,463,2,278,246,32,480334,Миколаївська область
15376,480335,891,10,522,478,44,480335,Миколаївська область
15377,480336,799,11,470,435,35,480336,Миколаївська область
15378,480337,233,1,143,117,26,480337,Миколаївська область
15379,480338,416,1,222,167,55,480338,Миколаївська область
15380,480339,263,2,200,169,31,480339,Миколаївська область
15381,480340,1300,15,726,653,73,480340,Миколаївська область
15382,480341,1081,10,619,526,93,480341,Миколаївська область
15383,480342,2139,48,1313,1162,151,480342,Миколаївська область
15384,480343,1146,14,609,539,70,480343,Миколаївська область
15385,480344,833,5,530,472,58,480344,Миколаївська область
15386,480345,2151,17,1155,1030,125,480345,Миколаївська область
15387,480346,314,3,197,174,23,480346,Миколаївська область
15388,480347,177,0,106,79,27,480347,Миколаївська область
15389,480348,646,7,370,321,49,480348,Миколаївська область
15390,480873,2213,27,1254,1109,145,480873,Миколаївська область
15391,480874,1697,30,1004,899,105,480874,Миколаївська область
15392,480875,1985,43,1202,1044,158,480875,Миколаївська область
15393,480876,2225,27,1326,1127,199,480876,Миколаївська область
15394,480877,1774,35,1080,875,205,480877,Миколаївська область
15395,480878,1988,40,1207,993,214,480878,Миколаївська область
15396,480879,2151,55,1277,1071,206,480879,Миколаївська область
15397,480880,1802,28,1091,904,187,480880,Миколаївська область
15398,480881,1111,14,637,512,125,480881,Миколаївська область
15399,480882,1474,18,875,742,133,480882,Миколаївська область
15400,480883,2267,32,1322,1097,225,480883,Миколаївська область
15401,480884,1640,30,972,823,149,480884,Миколаївська область
15402,480885,1573,27,975,787,188,480885,Миколаївська область
15403,480886,1884,27,1085,880,205,480886,Миколаївська область
15404,480887,1039,14,648,533,115,480887,Миколаївська область
15405,480888,1236,18,772,675,97,480888,Миколаївська область
15406,480889,1691,20,1053,881,172,480889,Миколаївська область
15407,480890,1332,14,736,615,121,480890,Миколаївська область
15408,480891,2057,46,1329,1149,180,480891,Миколаївська область
15409,480892,2122,38,1394,1218,176,480892,Миколаївська область
15410,480893,1656,33,1005,864,141,480893,Миколаївська область
15411,480894,1767,22,1138,922,216,480894,Миколаївська область
15412,480895,1764,23,1118,958,160,480895,Миколаївська область
15413,480896,1815,41,1153,987,166,480896,Миколаївська область
15414,480897,1568,34,970,847,123,480897,Миколаївська область
15415,480898,1994,24,1292,1111,181,480898,Миколаївська область
15416,480899,2130,27,1394,1209,185,480899,Миколаївська область
15417,480900,2146,47,1386,1204,182,480900,Миколаївська область
15418,480901,1977,29,1318,1133,185,480901,Миколаївська область
15419,480902,2155,32,1343,1166,177,480902,Миколаївська область
15420,480903,1214,13,747,623,124,480903,Миколаївська область
15421,480904,1520,19,905,738,167,480904,Миколаївська область
15422,480905,1386,22,831,730,101,480905,Миколаївська область
15423,480906,1421,16,833,759,74,480906,Миколаївська область
15424,480907,2048,22,1284,1011,273,480907,Миколаївська область
15425,480908,1469,20,868,765,103,480908,Миколаївська область
15426,480909,2223,41,1345,1164,181,480909,Миколаївська область
15427,480910,863,9,533,473,60,480910,Миколаївська область
15428,480911,1222,16,758,659,99,480911,Миколаївська область
15429,480912,1646,30,1078,946,132,480912,Миколаївська область
15430,480913,2180,30,1415,1227,188,480913,Миколаївська область
15431,480914,2156,44,1282,1099,183,480914,Миколаївська область
15432,480915,2433,32,1381,1152,229,480915,Миколаївська область
15433,480916,2483,42,1524,1296,228,480916,Миколаївська область
15434,480917,2320,38,1347,1141,206,480917,Миколаївська область
15435,480918,2206,31,1504,1323,181,480918,Миколаївська область
15436,480919,2276,33,1545,1317,228,480919,Миколаївська область
15437,480920,2446,31,1652,1401,251,480920,Миколаївська область
15438,480921,2241,11,635,557,78,480921,Миколаївська область
15439,480922,2160,28,1351,1229,122,480922,Миколаївська область
15440,480923,1990,19,1233,1119,114,480923,Миколаївська область
15441,480924,2219,28,1296,1170,126,480924,Миколаївська область
15442,480925,1951,19,1122,987,135,480925,Миколаївська область
15443,480926,1846,17,1081,939,142,480926,Миколаївська область
15444,480927,1270,13,708,621,87,480927,Миколаївська область
15445,480928,42,0,31,24,7,480928,Миколаївська область
15446,480929,67,2,53,48,5,480929,Миколаївська область
15447,480930,13,0,13,12,1,480930,Миколаївська область
15448,480931,31,0,31,28,3,480931,Миколаївська область
15449,480932,64,2,55,50,5,480932,Миколаївська область
15450,480933,38,1,32,24,8,480933,Миколаївська область
15451,480934,32,0,28,25,3,480934,Миколаївська область
15452,480935,46,0,41,36,5,480935,Миколаївська область
15453,480936,60,0,59,40,19,480936,Миколаївська область
15454,480028,1945,20,1076,905,171,480028,Миколаївська область
15455,480029,1738,22,1038,922,116,480029,Миколаївська область
15456,480030,2028,30,1123,980,143,480030,Миколаївська область
15457,480031,1468,15,796,718,78,480031,Миколаївська область
15458,480032,1455,16,875,758,117,480032,Миколаївська область
15459,480033,1710,24,1021,847,174,480033,Миколаївська область
15460,480034,115,0,61,55,6,480034,Миколаївська область
15461,480035,93,1,59,37,22,480035,Миколаївська область
15462,480036,118,0,75,58,17,480036,Миколаївська область
15463,480037,1092,11,571,515,56,480037,Миколаївська область
15464,480038,998,7,578,547,31,480038,Миколаївська область
15465,480039,763,8,374,340,34,480039,Миколаївська область
15466,480040,292,5,144,125,19,480040,Миколаївська область
15467,480041,231,0,139,120,19,480041,Миколаївська область
15468,480042,198,7,107,101,6,480042,Миколаївська область
15469,480043,1451,15,820,761,59,480043,Миколаївська область
15470,480044,351,2,184,151,33,480044,Миколаївська область
15471,480045,210,1,92,76,16,480045,Миколаївська область
15472,480046,666,4,310,269,41,480046,Миколаївська область
15473,480047,201,1,132,115,17,480047,Миколаївська область
15474,480048,545,4,251,205,46,480048,Миколаївська область
15475,480050,1248,22,670,611,59,480050,Миколаївська область
15476,480051,296,2,177,167,10,480051,Миколаївська область
15477,480052,771,5,384,352,32,480052,Миколаївська область
15478,480053,1058,8,517,463,54,480053,Миколаївська область
15479,480054,466,4,238,198,40,480054,Миколаївська область
15480,480055,609,7,298,278,20,480055,Миколаївська область
15481,480056,532,4,261,187,74,480056,Миколаївська область
15482,480058,363,2,188,165,23,480058,Миколаївська область
15483,480060,678,5,436,375,61,480060,Миколаївська область
15484,480061,244,1,158,149,9,480061,Миколаївська область
15485,480062,565,3,316,253,63,480062,Миколаївська область
15486,480063,253,4,170,143,27,480063,Миколаївська область
15487,480064,1513,16,910,865,45,480064,Миколаївська область
15488,480065,110,0,73,67,6,480065,Миколаївська область
15489,480066,675,7,315,284,31,480066,Миколаївська область
15490,480067,654,7,324,258,66,480067,Миколаївська область
15491,480068,795,3,357,331,26,480068,Миколаївська область
15492,480069,34,0,25,22,3,480069,Миколаївська область
15493,480097,1332,23,766,672,94,480097,Миколаївська область
15494,480098,1333,15,828,685,143,480098,Миколаївська область
15495,480099,771,7,449,394,55,480099,Миколаївська область
15496,480100,536,7,312,261,51,480100,Миколаївська область
15497,480101,737,8,424,372,52,480101,Миколаївська область
15498,480102,885,9,505,436,69,480102,Миколаївська область
15499,480103,120,0,85,64,21,480103,Миколаївська область
15500,480104,226,10,131,111,20,480104,Миколаївська область
15501,480105,697,5,290,250,40,480105,Миколаївська область
15502,480106,800,4,417,367,50,480106,Миколаївська область
15503,480107,281,2,178,161,17,480107,Миколаївська область
15504,480108,642,3,386,352,34,480108,Миколаївська область
15505,480109,773,8,492,454,38,480109,Миколаївська область
15506,480110,193,1,110,98,12,480110,Миколаївська область
15507,480111,127,0,93,81,12,480111,Миколаївська область
15508,480112,134,1,70,62,8,480112,Миколаївська область
15509,480113,299,2,151,126,25,480113,Миколаївська область
15510,480114,82,0,50,38,12,480114,Миколаївська область
15511,480115,70,1,50,33,17,480115,Миколаївська область
15512,480116,681,9,353,332,21,480116,Миколаївська область
15513,480117,548,0,301,255,46,480117,Миколаївська область
15514,480118,86,1,64,57,7,480118,Миколаївська область
15515,480119,289,1,153,132,21,480119,Миколаївська область
15516,480120,533,4,300,272,28,480120,Миколаївська область
15517,480121,283,2,164,159,5,480121,Миколаївська область
15518,480122,221,0,134,119,15,480122,Миколаївська область
15519,480123,189,0,131,118,13,480123,Миколаївська область
15520,480124,366,16,228,205,23,480124,Миколаївська область
15521,480125,647,8,376,343,33,480125,Миколаївська область
15522,480126,151,0,130,120,10,480126,Миколаївська область
15523,480127,461,5,291,265,26,480127,Миколаївська область
15524,480128,207,3,98,89,9,480128,Миколаївська область
15525,480129,26,0,18,14,4,480129,Миколаївська область
15526,480349,1861,14,1249,1136,113,480349,Миколаївська область
15527,480350,1406,6,931,863,68,480350,Миколаївська область
15528,480351,1521,15,988,931,57,480351,Миколаївська область
15529,480352,995,4,645,592,53,480352,Миколаївська область
15530,480353,525,2,318,293,25,480353,Миколаївська область
15531,480354,310,1,196,178,18,480354,Миколаївська область
15532,480355,369,3,240,221,19,480355,Миколаївська область
15533,480356,927,16,457,434,23,480356,Миколаївська область
15534,480357,839,7,489,430,59,480357,Миколаївська область
15535,480358,278,2,189,174,15,480358,Миколаївська область
15536,480359,346,1,209,190,19,480359,Миколаївська область
15537,480360,474,4,279,251,28,480360,Миколаївська область
15538,480361,289,2,159,136,23,480361,Миколаївська область
15539,480362,684,6,377,351,26,480362,Миколаївська область
15540,480363,545,11,325,296,29,480363,Миколаївська область
15541,480364,419,3,285,258,27,480364,Миколаївська область
15542,480365,173,1,80,68,12,480365,Миколаївська область
15543,480366,511,0,317,292,25,480366,Миколаївська область
15544,480367,431,3,235,206,29,480367,Миколаївська область
15545,480368,474,9,270,241,29,480368,Миколаївська область
15546,480369,240,2,177,163,14,480369,Миколаївська область
15547,480370,123,3,70,60,10,480370,Миколаївська область
15548,480371,182,1,116,104,12,480371,Миколаївська область
15549,480372,124,0,76,61,15,480372,Миколаївська область
15550,480373,758,9,547,519,28,480373,Миколаївська область
15551,480374,242,0,148,136,12,480374,Миколаївська область
15552,480375,10,0,9,5,4,480375,Миколаївська область
15553,480376,474,26,448,421,27,480376,Миколаївська область
15554,480455,550,2,299,283,16,480455,Миколаївська область
15555,480456,490,2,267,254,13,480456,Миколаївська область
15556,480457,528,2,309,273,36,480457,Миколаївська область
15557,480458,1186,12,646,605,41,480458,Миколаївська область
15558,480459,1788,17,1054,933,121,480459,Миколаївська область
15559,480460,1162,7,712,633,79,480460,Миколаївська область
15560,480461,707,2,430,378,52,480461,Миколаївська область
15561,480462,732,14,406,356,50,480462,Миколаївська область
15562,480463,764,2,475,404,71,480463,Миколаївська область
15563,480464,620,4,332,302,30,480464,Миколаївська область
15564,480465,832,5,476,444,32,480465,Миколаївська область
15565,480466,1128,8,667,589,78,480466,Миколаївська область
15566,480467,1388,27,849,775,74,480467,Миколаївська область
15567,480468,630,3,377,344,33,480468,Миколаївська область
15568,480469,111,0,78,72,6,480469,Миколаївська область
15569,480470,176,0,100,91,9,480470,Миколаївська область
15570,480471,263,2,174,163,11,480471,Миколаївська область
15571,480472,719,96,344,283,61,480472,Миколаївська область
15572,480473,115,0,58,40,18,480473,Миколаївська область
15573,480474,275,1,141,109,32,480474,Миколаївська область
15574,480475,337,3,186,147,39,480475,Миколаївська область
15575,480476,541,10,325,285,40,480476,Миколаївська область
15576,480477,540,6,330,289,41,480477,Миколаївська область
15577,480478,154,1,87,78,9,480478,Миколаївська область
15578,480479,353,0,226,203,23,480479,Миколаївська область
15579,480480,120,1,73,59,14,480480,Миколаївська область
15580,480481,387,0,251,217,34,480481,Миколаївська область
15581,480482,98,2,55,49,6,480482,Миколаївська область
15582,480483,248,0,127,101,26,480483,Миколаївська область
15583,480484,369,0,216,197,19,480484,Миколаївська область
15584,480485,1164,12,560,524,36,480485,Миколаївська область
15585,480486,238,0,141,109,32,480486,Миколаївська область
15586,480487,490,7,243,224,19,480487,Миколаївська область
15587,480488,536,2,328,292,36,480488,Миколаївська область
15588,480489,113,0,73,66,7,480489,Миколаївська область
15589,480490,261,1,126,87,39,480490,Миколаївська область
15590,480491,959,11,551,488,63,480491,Миколаївська область
15591,480492,326,8,208,167,41,480492,Миколаївська область
15592,480493,859,4,422,383,39,480493,Миколаївська область
15593,480494,16,0,14,12,2,480494,Миколаївська область
15594,480495,74,2,71,69,2,480495,Миколаївська область
15595,480496,820,8,442,402,40,480496,Миколаївська область
15596,480497,777,5,464,427,37,480497,Миколаївська область
15597,480498,1026,14,614,561,53,480498,Миколаївська область
15598,480499,1065,12,571,523,48,480499,Миколаївська область
15599,480500,1148,17,683,623,60,480500,Миколаївська область
15600,480501,1402,7,817,711,106,480501,Миколаївська область
15601,480502,1122,12,650,554,96,480502,Миколаївська область
15602,480503,1657,31,1014,863,151,480503,Миколаївська область
15603,480504,1625,11,1007,869,138,480504,Миколаївська область
15604,480505,194,1,130,116,14,480505,Миколаївська область
15605,480506,482,5,300,228,72,480506,Миколаївська область
15606,480507,1883,17,1133,984,149,480507,Миколаївська область
15607,480508,981,32,506,436,70,480508,Миколаївська область
15608,480509,214,2,121,97,24,480509,Миколаївська область
15609,480510,205,3,132,113,19,480510,Миколаївська область
15610,480511,213,2,128,115,13,480511,Миколаївська область
15611,480512,1053,16,623,535,88,480512,Миколаївська область
15612,480513,502,8,320,287,33,480513,Миколаївська область
15613,480514,475,0,242,221,21,480514,Миколаївська область
15614,480515,427,10,245,210,35,480515,Миколаївська область
15615,480516,432,6,259,230,29,480516,Миколаївська область
15616,480517,75,1,49,42,7,480517,Миколаївська область
15617,480518,459,1,263,219,44,480518,Миколаївська область
15618,480519,349,4,213,198,15,480519,Миколаївська область
15619,480520,122,1,56,48,8,480520,Миколаївська область
15620,480521,744,4,466,431,35,480521,Миколаївська область
15621,480522,311,0,173,146,27,480522,Миколаївська область
15622,480523,1874,21,1068,921,147,480523,Миколаївська область
15623,480524,303,3,165,150,15,480524,Миколаївська область
15624,480525,187,4,97,79,18,480525,Миколаївська область
15625,480526,313,1,207,195,12,480526,Миколаївська область
15626,480527,121,0,66,61,5,480527,Миколаївська область
15627,480528,630,2,389,344,45,480528,Миколаївська область
15628,480529,127,0,65,53,12,480529,Миколаївська область
15629,480530,1141,21,693,649,44,480530,Миколаївська область
15630,480531,639,7,362,322,40,480531,Миколаївська область
15631,480532,214,2,128,116,12,480532,Миколаївська область
15632,480533,991,14,581,502,79,480533,Миколаївська область
15633,480534,39,0,39,28,11,480534,Миколаївська область
15634,480594,410,4,238,218,20,480594,Миколаївська область
15635,480595,551,2,340,309,31,480595,Миколаївська область
15636,480596,685,4,356,322,34,480596,Миколаївська область
15637,480597,204,0,121,91,30,480597,Миколаївська область
15638,480598,342,3,178,140,38,480598,Миколаївська область
15639,480599,363,2,237,196,41,480599,Миколаївська область
15640,480600,573,3,353,290,63,480600,Миколаївська область
15641,480601,756,3,478,400,78,480601,Миколаївська область
15642,480602,306,1,170,146,24,480602,Миколаївська область
15643,480603,584,3,300,253,47,480603,Миколаївська область
15644,480604,593,2,323,276,47,480604,Миколаївська область
15645,480605,240,0,167,144,23,480605,Миколаївська область
15646,480606,148,0,97,75,22,480606,Миколаївська область
15647,480607,114,1,79,69,10,480607,Миколаївська область
15648,480608,671,6,394,367,27,480608,Миколаївська область
15649,480609,91,0,39,34,5,480609,Миколаївська область
15650,480610,660,6,347,304,43,480610,Миколаївська область
15651,480611,166,2,88,69,19,480611,Миколаївська область
15652,480612,422,2,238,211,27,480612,Миколаївська область
15653,480613,501,3,249,223,26,480613,Миколаївська область
15654,480614,134,0,79,70,9,480614,Миколаївська область
15655,480615,512,3,304,252,52,480615,Миколаївська область
15656,480616,323,2,215,195,20,480616,Миколаївська область
15657,480617,195,2,125,99,26,480617,Миколаївська область
15658,480618,358,4,197,156,41,480618,Миколаївська область
15659,480619,492,8,298,253,45,480619,Миколаївська область
15660,480620,975,10,512,450,62,480620,Миколаївська область
15661,480621,563,4,312,266,46,480621,Миколаївська область
15662,480622,866,3,468,377,91,480622,Миколаївська область
15663,480623,791,8,450,358,92,480623,Миколаївська область
15664,480624,305,2,161,141,20,480624,Миколаївська область
15665,480625,452,3,218,201,17,480625,Миколаївська область
15666,480626,308,3,128,112,16,480626,Миколаївська область
15667,480627,523,3,275,240,35,480627,Миколаївська область
15668,480628,75,1,40,34,6,480628,Миколаївська область
15669,480629,675,5,366,332,34,480629,Миколаївська область
15670,480630,253,1,164,126,38,480630,Миколаївська область
15671,480631,468,3,308,294,14,480631,Миколаївська область
15672,480632,526,1,369,327,42,480632,Миколаївська область
15673,480633,275,1,137,110,27,480633,Миколаївська область
15674,480634,164,1,79,60,19,480634,Миколаївська область
15675,480635,480,6,282,222,60,480635,Миколаївська область
15676,480636,406,5,245,222,23,480636,Миколаївська область
15677,480637,211,1,126,112,14,480637,Миколаївська область
15678,480638,63,0,40,30,10,480638,Миколаївська область
15679,480639,1765,21,972,887,85,480639,Миколаївська область
15680,480640,1070,16,556,500,56,480640,Миколаївська область
15681,480641,1298,18,760,666,94,480641,Миколаївська область
15682,480642,2121,20,1119,1018,101,480642,Миколаївська область
15683,480643,2302,28,1273,1127,146,480643,Миколаївська область
15684,480644,1903,27,1100,965,135,480644,Миколаївська область
15685,480645,56,0,51,41,10,480645,Миколаївська область
15686,480646,114,6,108,94,14,480646,Миколаївська область
15687,480070,2266,27,1368,1202,166,480070,Миколаївська область
15688,480071,1164,16,678,614,64,480071,Миколаївська область
15689,480072,472,4,270,250,20,480072,Миколаївська область
15690,480073,512,6,305,273,32,480073,Миколаївська область
15691,480074,697,4,406,355,51,480074,Миколаївська область
15692,480075,344,2,209,187,22,480075,Миколаївська область
15693,480076,238,1,142,133,9,480076,Миколаївська область
15694,480077,536,2,356,333,23,480077,Миколаївська область
15695,480078,368,0,211,195,16,480078,Миколаївська область
15696,480079,854,6,414,350,64,480079,Миколаївська область
15697,480080,2086,25,1155,1070,85,480080,Миколаївська область
15698,480081,393,2,231,213,18,480081,Миколаївська область
15699,480083,901,10,556,505,51,480083,Миколаївська область
15700,480084,794,10,455,398,57,480084,Миколаївська область
15701,480085,453,2,252,227,25,480085,Миколаївська область
15702,480086,192,1,104,86,18,480086,Миколаївська область
15703,480087,287,4,133,103,30,480087,Миколаївська область
15704,480088,220,5,122,108,14,480088,Миколаївська область
15705,480089,924,9,579,506,73,480089,Миколаївська область
15706,480090,1207,15,703,598,105,480090,Миколаївська область
15707,480091,296,1,183,167,16,480091,Миколаївська область
15708,480092,375,0,232,218,14,480092,Миколаївська область
15709,480093,211,3,123,112,11,480093,Миколаївська область
15710,480094,649,5,434,409,25,480094,Миколаївська область
15711,480095,762,2,418,364,54,480095,Миколаївська область
15712,480096,623,2,368,321,47,480096,Миколаївська область
15713,480159,1313,16,697,640,57,480159,Миколаївська область
15714,480161,1466,11,850,720,130,480161,Миколаївська область
15715,480162,1230,16,707,620,87,480162,Миколаївська область
15716,480163,1310,19,776,690,86,480163,Миколаївська область
15717,480164,514,2,290,264,26,480164,Миколаївська область
15718,480165,290,0,172,155,17,480165,Миколаївська область
15719,480166,129,0,74,69,5,480166,Миколаївська область
15720,480167,588,4,339,275,64,480167,Миколаївська область
15721,480168,606,8,376,327,49,480168,Миколаївська область
15722,480169,229,2,129,112,17,480169,Миколаївська область
15723,480170,127,3,89,79,10,480170,Миколаївська область
15724,480171,1399,11,683,630,53,480171,Миколаївська область
15725,480172,375,2,204,187,17,480172,Миколаївська область
15726,480173,310,12,153,136,17,480173,Миколаївська область
15727,480174,424,2,203,175,28,480174,Миколаївська область
15728,480175,264,1,160,129,31,480175,Миколаївська область
15729,480176,537,13,353,318,35,480176,Миколаївська область
15730,480177,95,1,62,45,17,480177,Миколаївська область
15731,480178,944,14,585,428,157,480178,Миколаївська область
15732,480179,551,10,298,267,31,480179,Миколаївська область
15733,480180,784,6,430,373,57,480180,Миколаївська область
15734,480181,444,0,237,213,24,480181,Миколаївська область
15735,480182,300,3,150,137,13,480182,Миколаївська область
15736,480183,767,9,435,383,52,480183,Миколаївська область
15737,480184,337,2,264,239,25,480184,Миколаївська область
15738,480185,320,3,211,179,32,480185,Миколаївська область
15739,480186,383,0,238,176,62,480186,Миколаївська область
15740,480187,1102,9,638,559,79,480187,Миколаївська область
15741,480188,1235,9,712,643,69,480188,Миколаївська область
15742,480189,1234,8,717,656,61,480189,Миколаївська область
15743,480190,788,7,419,390,29,480190,Миколаївська область
15744,480191,1045,8,559,528,31,480191,Миколаївська область
15745,480192,620,2,365,333,32,480192,Миколаївська область
15746,480193,712,5,401,368,33,480193,Миколаївська область
15747,480194,1467,5,854,782,72,480194,Миколаївська область
15748,480195,764,5,382,315,67,480195,Миколаївська область
15749,480196,76,0,46,32,14,480196,Миколаївська область
15750,480197,193,0,103,81,22,480197,Миколаївська область
15751,480198,916,2,505,455,50,480198,Миколаївська область
15752,480199,258,2,145,127,18,480199,Миколаївська область
15753,480200,164,1,78,59,19,480200,Миколаївська область
15754,480201,551,1,261,241,20,480201,Миколаївська область
15755,480202,1420,13,820,743,77,480202,Миколаївська область
15756,480203,290,3,171,148,23,480203,Миколаївська область
15757,480204,75,0,52,37,15,480204,Миколаївська область
15758,480205,761,3,425,391,34,480205,Миколаївська область
15759,480206,493,2,383,330,53,480206,Миколаївська область
15760,480207,762,8,373,338,35,480207,Миколаївська область
15761,480208,1219,14,711,603,108,480208,Миколаївська область
15762,480209,159,0,112,103,9,480209,Миколаївська область
15763,480210,1677,9,883,809,74,480210,Миколаївська область
15764,480211,1375,5,808,736,72,480211,Миколаївська область
15765,480212,552,6,311,257,54,480212,Миколаївська область
15766,480213,59,2,46,34,12,480213,Миколаївська область
15767,480214,1344,5,712,668,44,480214,Миколаївська область
15768,480215,348,1,197,169,28,480215,Миколаївська область
15769,480216,1203,12,613,557,56,480216,Миколаївська область
15770,480217,208,3,99,86,13,480217,Миколаївська область
15771,480218,182,1,107,98,9,480218,Миколаївська область
15772,480219,62,0,40,30,10,480219,Миколаївська область
15773,480220,771,6,455,374,81,480220,Миколаївська область
15774,480221,70,0,47,36,11,480221,Миколаївська область
15775,480245,1125,13,570,525,45,480245,Миколаївська область
15776,480246,1550,18,888,804,84,480246,Миколаївська область
15777,480247,960,5,536,493,43,480247,Миколаївська область
15778,480248,1361,22,794,719,75,480248,Миколаївська область
15779,480249,191,0,149,122,27,480249,Миколаївська область
15780,480250,136,0,78,71,7,480250,Миколаївська область
15781,480251,291,1,162,131,31,480251,Миколаївська область
15782,480252,516,2,314,278,36,480252,Миколаївська область
15783,480253,1157,11,584,496,88,480253,Миколаївська область
15784,480254,228,0,121,99,22,480254,Миколаївська область
15785,480255,128,2,75,56,19,480255,Миколаївська область
15786,480256,433,3,230,199,31,480256,Миколаївська область
15787,480257,317,3,198,112,86,480257,Миколаївська область
15788,480258,595,6,319,256,63,480258,Миколаївська область
15789,480259,281,1,161,145,16,480259,Миколаївська область
15790,480260,140,1,74,62,12,480260,Миколаївська область
15791,480261,161,2,90,77,13,480261,Миколаївська область
15792,480262,559,4,337,290,47,480262,Миколаївська область
15793,480263,88,0,39,34,5,480263,Миколаївська область
15794,480264,873,6,431,390,41,480264,Миколаївська область
15795,480265,671,3,333,295,38,480265,Миколаївська область
15796,480266,189,1,97,82,15,480266,Миколаївська область
15797,480267,1166,6,575,513,62,480267,Миколаївська область
15798,480268,320,2,156,128,28,480268,Миколаївська область
15799,480269,717,10,371,303,68,480269,Миколаївська область
15800,480270,714,4,387,324,63,480270,Миколаївська область
15801,480271,123,2,60,47,13,480271,Миколаївська область
15802,480272,519,2,277,210,67,480272,Миколаївська область
15803,480273,348,4,209,178,31,480273,Миколаївська область
15804,480274,246,0,143,115,28,480274,Миколаївська область
15805,480275,337,4,188,155,33,480275,Миколаївська область
15806,480276,401,4,223,187,36,480276,Миколаївська область
15807,480277,490,9,240,217,23,480277,Миколаївська область
15808,480278,132,2,65,53,12,480278,Миколаївська область
15809,480279,397,5,246,192,54,480279,Миколаївська область
15810,480280,156,0,105,77,28,480280,Миколаївська область
15811,480281,33,0,26,24,2,480281,Миколаївська область
15812,480282,654,4,402,370,32,480282,Миколаївська область
15813,480283,841,2,474,443,31,480283,Миколаївська область
15814,480284,1723,14,1081,1011,70,480284,Миколаївська область
15815,480285,919,6,609,586,23,480285,Миколаївська область
15816,480286,224,1,118,99,19,480286,Миколаївська область
15817,480287,264,2,161,140,21,480287,Миколаївська область
15818,480288,303,0,172,136,36,480288,Миколаївська область
15819,480289,465,1,253,223,30,480289,Миколаївська область
15820,480290,344,1,215,167,48,480290,Миколаївська область
15821,480291,80,0,53,44,9,480291,Миколаївська область
15822,480292,1405,17,712,621,91,480292,Миколаївська область
15823,480293,672,9,415,371,44,480293,Миколаївська область
15824,480294,361,5,188,171,17,480294,Миколаївська область
15825,480295,633,2,385,365,20,480295,Миколаївська область
15826,480296,269,3,157,147,10,480296,Миколаївська область
15827,480297,87,0,64,49,15,480297,Миколаївська область
15828,480298,317,3,177,163,14,480298,Миколаївська область
15829,480299,412,3,266,248,18,480299,Миколаївська область
15830,480300,418,4,274,240,34,480300,Миколаївська область
15831,480301,136,0,87,67,20,480301,Миколаївська область
15832,480302,365,1,232,175,57,480302,Миколаївська область
15833,480303,370,3,235,206,29,480303,Миколаївська область
15834,480304,73,0,57,43,14,480304,Миколаївська область
15835,480305,143,2,80,77,3,480305,Миколаївська область
15836,480306,59,0,46,44,2,480306,Миколаївська область
15837,480307,15,1,11,9,2,480307,Миколаївська область
15838,480647,1513,13,867,775,92,480647,Миколаївська область
15839,480648,1453,13,846,784,62,480648,Миколаївська область
15840,480649,1750,15,1018,949,69,480649,Миколаївська область
15841,480650,1768,9,1100,964,136,480650,Миколаївська область
15842,480651,2189,16,1388,1235,153,480651,Миколаївська область
15843,480652,1367,14,844,756,88,480652,Миколаївська область
15844,480653,1632,15,1068,932,136,480653,Миколаївська область
15845,480654,1735,29,1088,941,147,480654,Миколаївська область
15846,480655,2013,26,1279,1135,144,480655,Миколаївська область
15847,480656,2114,19,1213,1081,132,480656,Миколаївська область
15848,480657,1322,26,775,688,87,480657,Миколаївська область
15849,480658,1694,20,1014,903,111,480658,Миколаївська область
15850,480659,1349,14,819,726,93,480659,Миколаївська область
15851,480660,1747,14,1109,994,115,480660,Миколаївська область
15852,480661,1882,18,1053,972,81,480661,Миколаївська область
15853,480662,1816,15,1048,984,64,480662,Миколаївська область
15854,480663,1674,10,1042,949,93,480663,Миколаївська область
15855,480664,1674,18,1024,921,103,480664,Миколаївська область
15856,480665,633,9,391,359,32,480665,Миколаївська область
15857,480666,330,14,316,296,20,480666,Миколаївська область
15858,480710,2073,23,1139,1001,138,480710,Миколаївська область
15859,480711,1911,19,1201,994,207,480711,Миколаївська область
15860,480712,1774,24,1103,910,193,480712,Миколаївська область
15861,480713,1650,11,1026,836,190,480713,Миколаївська область
15862,480714,1759,18,1085,910,175,480714,Миколаївська область
15863,480715,1706,16,1043,867,176,480715,Миколаївська область
15864,480716,1756,23,1094,912,182,480716,Миколаївська область
15865,480717,2111,29,1352,1101,251,480717,Миколаївська область
15866,480718,2075,26,1289,1087,202,480718,Миколаївська область
15867,480719,2139,30,1306,1061,245,480719,Миколаївська область
15868,480720,1683,20,1071,876,195,480720,Миколаївська область
15869,480721,1675,14,1015,820,195,480721,Миколаївська область
15870,480722,1730,17,1004,841,163,480722,Миколаївська область
15871,480724,1868,23,1120,935,185,480724,Миколаївська область
15872,480725,1866,22,1215,982,233,480725,Миколаївська область
15873,480726,1781,21,1091,904,187,480726,Миколаївська область
15874,480727,1848,25,1185,980,205,480727,Миколаївська область
15875,480937,380,3,189,174,15,480937,Миколаївська область
15876,480001,663,9,431,369,62,480001,Миколаївська область
15877,480002,1151,8,750,621,129,480002,Миколаївська область
15878,480003,1072,7,577,500,77,480003,Миколаївська область
15879,480004,832,10,455,400,55,480004,Миколаївська область
15880,480005,642,9,340,297,43,480005,Миколаївська область
15881,480006,602,5,380,333,47,480006,Миколаївська область
15882,480007,229,2,139,110,29,480007,Миколаївська область
15883,480008,1019,11,565,486,79,480008,Миколаївська область
15884,480009,1046,10,559,512,47,480009,Миколаївська область
15885,480010,184,1,111,94,17,480010,Миколаївська область
15886,480011,601,6,337,284,53,480011,Миколаївська область
15887,480012,827,4,447,410,37,480012,Миколаївська область
15888,480013,1055,12,696,620,76,480013,Миколаївська область
15889,480014,843,7,438,376,62,480014,Миколаївська область
15890,480015,398,2,260,234,26,480015,Миколаївська область
15891,480016,203,1,132,119,13,480016,Миколаївська область
15892,480017,224,2,140,117,23,480017,Миколаївська область
15893,480018,213,0,122,112,10,480018,Миколаївська область
15894,480019,869,6,445,422,23,480019,Миколаївська область
15895,480020,310,2,191,162,29,480020,Миколаївська область
15896,480021,376,2,216,186,30,480021,Миколаївська область
15897,480022,121,0,72,56,16,480022,Миколаївська область
15898,480023,244,0,134,117,17,480023,Миколаївська область
15899,480024,697,5,373,287,86,480024,Миколаївська область
15900,480025,1081,7,685,468,217,480025,Миколаївська область
15901,480026,108,0,73,43,30,480026,Миколаївська область
15902,480027,371,26,345,332,13,480027,Миколаївська область
15903,480130,1637,6,1001,870,131,480130,Миколаївська область
15904,480131,1666,12,1005,903,102,480131,Миколаївська область
15905,480132,1657,19,826,723,103,480132,Миколаївська область
15906,480134,218,1,127,113,14,480134,Миколаївська область
15907,480136,430,9,212,180,32,480136,Миколаївська область
15908,480137,190,5,113,95,18,480137,Миколаївська область
15909,480138,302,3,175,136,39,480138,Миколаївська область
15910,480139,211,1,140,117,23,480139,Миколаївська область
15911,480140,445,2,249,208,41,480140,Миколаївська область
15912,480141,258,2,194,186,8,480141,Миколаївська область
15913,480142,315,4,153,138,15,480142,Миколаївська область
15914,480143,204,0,123,97,26,480143,Миколаївська область
15915,480144,259,4,120,87,33,480144,Миколаївська область
15916,480145,348,5,221,199,22,480145,Миколаївська область
15917,480146,340,3,231,194,37,480146,Миколаївська область
15918,480147,341,1,196,182,14,480147,Миколаївська область
15919,480148,423,5,283,235,48,480148,Миколаївська область
15920,480149,722,3,459,387,72,480149,Миколаївська область
15921,480150,183,0,107,96,11,480150,Миколаївська область
15922,480151,409,4,261,232,29,480151,Миколаївська область
15923,480152,309,2,192,175,17,480152,Миколаївська область
15924,480153,433,4,225,195,30,480153,Миколаївська область
15925,480154,345,3,212,156,56,480154,Миколаївська область
15926,480155,542,4,302,281,21,480155,Миколаївська область
15927,480156,344,4,235,202,33,480156,Миколаївська область
15928,480157,178,3,125,102,23,480157,Миколаївська область
15929,480158,352,3,189,159,30,480158,Миколаївська область
15930,480222,1836,29,1000,847,153,480222,Миколаївська область
15931,480223,2072,25,1103,968,135,480223,Миколаївська область
15932,480224,1731,19,897,787,110,480224,Миколаївська область
15933,480225,902,9,466,436,30,480225,Миколаївська область
15934,480226,749,11,407,369,38,480226,Миколаївська область
15935,480227,477,7,278,252,26,480227,Миколаївська область
15936,480228,316,1,113,87,26,480228,Миколаївська область
15937,480229,106,0,46,36,10,480229,Миколаївська область
15938,480230,529,5,267,218,49,480230,Миколаївська область
15939,480231,166,1,64,48,16,480231,Миколаївська область
15940,480232,332,1,167,148,19,480232,Миколаївська область
15941,480233,318,0,191,169,22,480233,Миколаївська область
15942,480234,195,1,119,102,17,480234,Миколаївська область
15943,480235,399,7,234,132,102,480235,Миколаївська область
15944,480236,247,2,119,57,62,480236,Миколаївська область
15945,480237,265,3,123,81,42,480237,Миколаївська область
15946,480238,309,3,172,149,23,480238,Миколаївська область
15947,480239,262,1,166,140,26,480239,Миколаївська область
15948,480240,254,2,162,139,23,480240,Миколаївська область
15949,480241,498,2,187,140,47,480241,Миколаївська область
15950,480242,841,3,453,382,71,480242,Миколаївська область
15951,480243,993,11,477,432,45,480243,Миколаївська область
15952,480244,20,0,18,13,5,480244,Миколаївська область
15953,480377,476,2,271,227,44,480377,Миколаївська область
15954,480378,83,0,48,15,33,480378,Миколаївська область
15955,480379,864,17,428,328,100,480379,Миколаївська область
15956,480380,727,11,395,330,65,480380,Миколаївська область
15957,480381,755,3,419,345,74,480381,Миколаївська область
15958,480382,212,1,125,100,25,480382,Миколаївська область
15959,480383,63,0,30,21,9,480383,Миколаївська область
15960,480384,630,15,368,242,126,480384,Миколаївська область
15961,480385,1074,16,587,519,68,480385,Миколаївська область
15962,480386,854,7,478,408,70,480386,Миколаївська область
15963,480387,892,6,511,452,59,480387,Миколаївська область
15964,480388,1194,14,650,576,74,480388,Миколаївська область
15965,480389,909,14,514,404,110,480389,Миколаївська область
15966,480390,806,14,421,329,92,480390,Миколаївська область
15967,480391,256,1,136,121,15,480391,Миколаївська область
15968,480392,809,8,466,291,175,480392,Миколаївська область
15969,480393,818,6,435,357,78,480393,Миколаївська область
15970,480394,1171,6,673,574,99,480394,Миколаївська область
15971,480395,121,0,79,69,10,480395,Миколаївська область
15972,480396,1002,12,572,479,93,480396,Миколаївська область
15973,480397,408,3,233,163,70,480397,Миколаївська область
15974,480398,771,8,428,353,75,480398,Миколаївська область
15975,480399,377,0,249,191,58,480399,Миколаївська область
15976,480400,147,0,96,87,9,480400,Миколаївська область
15977,480401,460,5,235,181,54,480401,Миколаївська область
15978,480402,609,4,328,257,71,480402,Миколаївська область
15979,480403,476,5,314,225,89,480403,Миколаївська область
15980,480404,624,4,379,283,96,480404,Миколаївська область
15981,480405,735,9,393,345,48,480405,Миколаївська область
15982,480406,15,0,15,9,6,480406,Миколаївська область
15983,480553,1636,17,870,744,126,480553,Миколаївська область
15984,480554,312,1,219,186,33,480554,Миколаївська область
15985,480555,336,5,226,194,32,480555,Миколаївська область
15986,480556,859,15,475,389,86,480556,Миколаївська область
15987,480557,1271,10,620,551,69,480557,Миколаївська область
15988,480558,1308,18,698,604,94,480558,Миколаївська область
15989,480559,754,6,431,389,42,480559,Миколаївська область
15990,480560,793,13,451,371,80,480560,Миколаївська область
15991,480561,783,7,440,365,75,480561,Миколаївська область
15992,480562,553,4,316,262,54,480562,Миколаївська область
15993,480563,597,5,373,305,68,480563,Миколаївська область
15994,480564,821,8,500,417,83,480564,Миколаївська область
15995,480565,606,3,330,277,53,480565,Миколаївська область
15996,480566,385,4,173,110,63,480566,Миколаївська область
15997,480567,381,4,259,229,30,480567,Миколаївська область
15998,480568,1537,15,864,684,180,480568,Миколаївська область
15999,480569,75,0,42,27,15,480569,Миколаївська область
16000,480570,159,1,91,62,29,480570,Миколаївська область
16001,480571,201,2,131,83,48,480571,Миколаївська область
16002,480572,333,4,194,160,34,480572,Миколаївська область
16003,480573,159,2,95,57,38,480573,Миколаївська область
16004,480574,517,6,340,301,39,480574,Миколаївська область
16005,480575,273,4,149,118,31,480575,Миколаївська область
16006,480576,101,0,60,47,13,480576,Миколаївська область
16007,480577,172,4,84,63,21,480577,Миколаївська область
16008,480578,1049,9,551,440,111,480578,Миколаївська область
16009,480579,715,12,421,349,72,480579,Миколаївська область
16010,480580,501,7,380,345,35,480580,Миколаївська область
16011,480581,485,12,290,242,48,480581,Миколаївська область
16012,480582,836,4,475,414,61,480582,Миколаївська область
16013,480583,549,4,315,257,58,480583,Миколаївська область
16014,480584,626,8,367,320,47,480584,Миколаївська область
16015,480585,179,2,108,84,24,480585,Миколаївська область
16016,480586,433,6,242,216,26,480586,Миколаївська область
16017,480587,946,3,483,399,84,480587,Миколаївська область
16018,480588,535,5,275,229,46,480588,Миколаївська область
16019,480589,218,2,147,123,24,480589,Миколаївська область
16020,480590,133,4,79,71,8,480590,Миколаївська область
16021,480591,137,2,89,69,20,480591,Миколаївська область
16022,480592,77,0,54,33,21,480592,Миколаївська область
16023,480593,467,1,238,160,78,480593,Миколаївська область
16024,480674,1866,26,1097,893,204,480674,Миколаївська область
16025,480675,1621,26,985,795,190,480675,Миколаївська область
16026,480676,756,11,461,392,69,480676,Миколаївська область
16027,480677,986,9,481,425,56,480677,Миколаївська область
16028,480678,952,9,537,457,80,480678,Миколаївська область
16029,480679,2199,31,1203,1047,156,480679,Миколаївська область
16030,480680,2046,25,1127,930,197,480680,Миколаївська область
16031,480681,1822,19,923,808,115,480681,Миколаївська область
16032,480682,1698,14,887,694,193,480682,Миколаївська область
16033,480683,1899,22,1115,957,158,480683,Миколаївська область
16034,480684,1715,16,961,840,121,480684,Миколаївська область
16035,480685,1617,20,922,787,135,480685,Миколаївська область
16036,480686,1121,10,568,495,73,480686,Миколаївська область
16037,480687,1313,17,754,658,96,480687,Миколаївська область
16038,480688,1564,13,849,716,133,480688,Миколаївська область
16039,480689,1182,6,639,553,86,480689,Миколаївська область
16040,480690,1869,26,1059,882,177,480690,Миколаївська область
16041,480691,510,4,278,229,49,480691,Миколаївська область
16042,480692,1354,13,773,652,121,480692,Миколаївська область
16043,480693,1260,16,680,569,111,480693,Миколаївська область
16044,480694,723,10,390,305,85,480694,Миколаївська область
16045,480695,1915,39,1127,938,189,480695,Миколаївська область
16046,480696,1845,22,1029,873,156,480696,Миколаївська область
16047,480697,2133,22,1155,963,192,480697,Миколаївська область
16048,480698,1332,14,709,597,112,480698,Миколаївська область
16049,480699,1240,8,627,522,105,480699,Миколаївська область
16050,480700,1397,9,795,693,102,480700,Миколаївська область
16051,480701,1884,15,1038,902,136,480701,Миколаївська область
16052,480702,1973,22,1051,895,156,480702,Миколаївська область
16053,480703,2169,36,1312,1115,197,480703,Миколаївська область
16054,480704,2308,38,1333,1139,194,480704,Миколаївська область
16055,480705,2205,25,1250,1092,158,480705,Миколаївська область
16056,480706,2304,27,1398,1185,213,480706,Миколаївська область
16057,480707,29,0,24,20,4,480707,Миколаївська область
16058,480708,21,1,20,13,7,480708,Миколаївська область
16059,480709,17,0,17,11,6,480709,Миколаївська область
16060,511073,2160,33,1393,1259,134,511073,Одеська область
16061,511074,2230,34,1457,1319,138,511074,Одеська область
16062,511075,2259,47,1507,1330,177,511075,Одеська область
16063,511076,2193,37,1421,1248,173,511076,Одеська область
16064,511077,2376,38,1532,1299,233,511077,Одеська область
16065,511078,2069,24,1284,1156,128,511078,Одеська область
16066,511079,2272,35,1377,1204,173,511079,Одеська область
16067,511080,1777,30,1054,934,120,511080,Одеська область
16068,511081,1897,28,1151,1019,132,511081,Одеська область
16069,511082,2072,35,1225,1059,166,511082,Одеська область
16070,511083,2013,29,1190,1004,186,511083,Одеська область
16071,511084,1624,30,987,867,120,511084,Одеська область
16072,511085,2233,48,1356,1173,183,511085,Одеська область
16073,511086,2404,32,1505,1290,215,511086,Одеська область
16074,511087,2348,44,1408,1182,226,511087,Одеська область
16075,511088,2216,30,1349,1147,202,511088,Одеська область
16076,511089,2291,20,1244,1065,179,511089,Одеська область
16077,511090,2312,33,1368,1218,150,511090,Одеська область
16078,511091,2508,26,1416,1219,197,511091,Одеська область
16079,511092,2343,36,1447,1256,191,511092,Одеська область
16080,511093,2210,28,1397,1218,179,511093,Одеська область
16081,511094,2121,17,1317,1144,173,511094,Одеська область
16082,511095,2219,52,1445,1233,212,511095,Одеська область
16083,511096,1767,16,974,849,125,511096,Одеська область
16084,511097,1628,37,978,854,124,511097,Одеська область
16085,511098,1826,18,960,855,105,511098,Одеська область
16086,511099,2626,63,1478,1312,166,511099,Одеська область
16087,511100,2466,37,1401,1247,154,511100,Одеська область
16088,511101,1512,29,922,820,102,511101,Одеська область
16089,511102,1669,18,1014,886,128,511102,Одеська область
16090,511103,2225,23,1398,1224,174,511103,Одеська область
16091,511104,2217,33,1433,1252,181,511104,Одеська область
16092,511105,2448,34,1547,1317,230,511105,Одеська область
16093,511106,2181,33,1410,1237,173,511106,Одеська область
16094,511107,2139,42,1314,1134,180,511107,Одеська область
16095,511108,2119,35,1341,1160,181,511108,Одеська область
16096,511109,2293,46,1402,1228,174,511109,Одеська область
16097,511110,2003,20,1287,1142,145,511110,Одеська область
16098,511111,1919,25,1249,1086,163,511111,Одеська область
16099,511112,2040,30,1329,1175,154,511112,Одеська область
16100,511113,2063,38,1329,1159,170,511113,Одеська область
16101,511114,2048,53,1354,1191,163,511114,Одеська область
16102,511115,2256,41,1331,1174,157,511115,Одеська область
16103,511116,1932,41,1186,1033,153,511116,Одеська область
16104,511117,2327,30,1438,1269,169,511117,Одеська область
16105,511118,2175,48,1322,1183,139,511118,Одеська область
16106,511119,1980,18,1221,1070,151,511119,Одеська область
16107,511120,2207,44,1373,1183,190,511120,Одеська область
16108,511121,2234,36,1334,1170,164,511121,Одеська область
16109,511122,2335,58,1445,1275,170,511122,Одеська область
16110,511123,2160,30,1373,1219,154,511123,Одеська область
16111,511124,2080,33,1348,1176,172,511124,Одеська область
16112,511125,2255,30,1348,1199,149,511125,Одеська область
16113,511126,2153,35,1364,1172,192,511126,Одеська область
16114,511127,1960,34,1254,1124,130,511127,Одеська область
16115,511128,2217,31,1438,1288,150,511128,Одеська область
16116,511129,2135,43,1363,1192,171,511129,Одеська область
16117,511130,1963,24,1261,1133,128,511130,Одеська область
16118,511131,1759,33,1090,977,113,511131,Одеська область
16119,511132,2114,42,1280,1122,158,511132,Одеська область
16120,511133,2239,48,1393,1212,181,511133,Одеська область
16121,511134,1935,41,1246,1077,169,511134,Одеська область
16122,511135,2189,38,1344,1175,169,511135,Одеська область
16123,511136,2381,35,1489,1357,132,511136,Одеська область
16124,511137,2384,38,1474,1272,202,511137,Одеська область
16125,511138,2326,28,1400,1126,274,511138,Одеська область
16126,511139,2260,22,1460,1301,159,511139,Одеська область
16127,511140,2214,42,1384,1218,166,511140,Одеська область
16128,511141,2173,21,1336,1166,170,511141,Одеська область
16129,511142,2218,32,1416,1233,183,511142,Одеська область
16130,511143,2180,42,1397,1235,162,511143,Одеська область
16131,511144,2069,55,1323,1176,147,511144,Одеська область
16132,511145,1999,29,1261,1104,157,511145,Одеська область
16133,511146,1958,35,1151,1028,123,511146,Одеська область
16134,511147,1944,50,1182,1033,149,511147,Одеська область
16135,511148,2370,44,1452,1245,207,511148,Одеська область
16136,511149,1840,21,1147,974,173,511149,Одеська область
16137,511150,1740,35,1006,890,116,511150,Одеська область
16138,511151,2351,31,1413,1242,171,511151,Одеська область
16139,511152,90,1,69,62,7,511152,Одеська область
16140,511153,54,1,20,18,2,511153,Одеська область
16141,511154,60,1,57,51,6,511154,Одеська область
16142,511155,52,5,36,31,5,511155,Одеська область
16143,511157,53,0,52,28,24,511157,Одеська область
16144,511158,109,1,85,79,6,511158,Одеська область
16145,1,1119,114,1001,955,46,1,Одеська область
16146,511159,2460,41,1481,1271,210,511159,Одеська область
16147,511160,2535,33,1541,1296,245,511160,Одеська область
16148,511161,2432,37,1555,1145,410,511161,Одеська область
16149,511162,2197,29,1328,1150,178,511162,Одеська область
16150,511163,2098,40,1335,1126,209,511163,Одеська область
16151,511164,1931,23,1161,995,166,511164,Одеська область
16152,511165,1862,32,1189,1055,134,511165,Одеська область
16153,511166,2248,37,1409,1225,184,511166,Одеська область
16154,511167,2167,39,1339,1198,141,511167,Одеська область
16155,511168,2174,28,1348,1201,147,511168,Одеська область
16156,511169,2157,24,1311,1187,124,511169,Одеська область
16157,511170,2192,27,1402,1259,143,511170,Одеська область
16158,511171,1487,26,948,812,136,511171,Одеська область
16159,511172,1950,34,1288,1122,166,511172,Одеська область
16160,511173,1917,27,1109,977,132,511173,Одеська область
16161,511174,1334,18,797,700,97,511174,Одеська область
16162,511175,2157,39,1403,1227,176,511175,Одеська область
16163,511176,1981,18,1321,1164,157,511176,Одеська область
16164,511177,2159,39,1380,1212,168,511177,Одеська область
16165,511178,1794,28,1157,983,174,511178,Одеська область
16166,511179,1812,32,1133,978,155,511179,Одеська область
16167,511180,2084,39,1322,1157,165,511180,Одеська область
16168,511181,1599,27,983,866,117,511181,Одеська область
16169,511182,2133,31,1325,1160,165,511182,Одеська область
16170,511183,1589,31,1010,896,114,511183,Одеська область
16171,511184,1778,22,1193,1028,165,511184,Одеська область
16172,511185,937,24,504,451,53,511185,Одеська область
16173,511186,2249,13,778,697,81,511186,Одеська область
16174,511187,2262,33,1338,1202,136,511187,Одеська область
16175,511188,1277,24,822,713,109,511188,Одеська область
16176,511189,2083,29,1265,1121,144,511189,Одеська область
16177,511190,2196,33,1292,1168,124,511190,Одеська область
16178,511191,2364,38,1513,1305,208,511191,Одеська область
16179,511192,2116,38,1282,1083,199,511192,Одеська область
16180,511193,1011,11,650,571,79,511193,Одеська область
16181,511194,2331,21,1454,1313,141,511194,Одеська область
16182,511195,2502,39,1516,1319,197,511195,Одеська область
16183,511196,2469,35,1567,1384,183,511196,Одеська область
16184,511197,2512,46,1641,1424,217,511197,Одеська область
16185,511198,2351,34,1321,1162,159,511198,Одеська область
16186,511199,1246,14,745,648,97,511199,Одеська область
16187,511200,2172,36,1221,1079,142,511200,Одеська область
16188,511201,2416,25,1470,1301,169,511201,Одеська область
16189,511202,1933,31,1261,1145,116,511202,Одеська область
16190,511203,2288,29,1485,1270,215,511203,Одеська область
16191,511204,2261,35,1419,1245,174,511204,Одеська область
16192,511205,2197,18,1198,1064,134,511205,Одеська область
16193,511206,2226,25,1445,1305,140,511206,Одеська область
16194,511207,2274,33,1377,1233,144,511207,Одеська область
16195,511208,2382,29,1481,1264,217,511208,Одеська область
16196,511209,1449,16,773,697,76,511209,Одеська область
16197,511210,2008,28,1179,1089,90,511210,Одеська область
16198,511211,1744,30,972,859,113,511211,Одеська область
16199,511212,2140,24,1237,1087,150,511212,Одеська область
16200,511213,2469,11,1435,1321,114,511213,Одеська область
16201,511214,2392,29,1462,1331,131,511214,Одеська область
16202,511215,2354,36,1413,1284,129,511215,Одеська область
16203,511216,2303,10,1319,1177,142,511216,Одеська область
16204,511217,169,1,106,96,10,511217,Одеська область
16205,511218,2060,19,1100,1010,90,511218,Одеська область
16206,511220,2392,37,1407,1247,160,511220,Одеська область
16207,511222,2348,24,1470,1293,177,511222,Одеська область
16208,511223,2275,16,1223,1127,96,511223,Одеська область
16209,511224,2297,25,1446,1280,166,511224,Одеська область
16210,511225,2137,33,1195,1064,131,511225,Одеська область
16211,511226,2388,50,1498,1313,185,511226,Одеська область
16212,511227,2411,41,1486,1275,211,511227,Одеська область
16213,511228,2513,41,1564,1395,169,511228,Одеська область
16214,511229,2325,27,1422,1251,171,511229,Одеська область
16215,511230,2436,25,1389,1252,137,511230,Одеська область
16216,511231,1396,19,843,740,103,511231,Одеська область
16217,511232,2225,22,1340,1202,138,511232,Одеська область
16218,511233,2203,32,1326,1180,146,511233,Одеська область
16219,511234,2301,15,1364,1216,148,511234,Одеська область
16220,511235,2285,33,1268,1133,135,511235,Одеська область
16221,511236,2237,24,1202,1087,115,511236,Одеська область
16222,511237,2247,29,1344,1209,135,511237,Одеська область
16223,511238,2535,39,1543,1339,204,511238,Одеська область
16224,511239,1894,29,1141,1029,112,511239,Одеська область
16225,511240,123,0,101,94,7,511240,Одеська область
16226,511241,188,7,177,164,13,511241,Одеська область
16227,511242,452,26,422,387,35,511242,Одеська область
16228,511243,553,27,525,491,34,511243,Одеська область
16229,511244,148,5,143,134,9,511244,Одеська область
16230,511447,1040,10,561,520,41,511447,Одеська область
16231,511450,2394,5,394,338,56,511450,Одеська область
16232,1,30,0,30,29,1,1,Одеська область
16233,511245,2266,35,1180,1074,106,511245,Одеська область
16234,511246,2276,145,1151,1006,145,511246,Одеська область
16235,511247,2154,32,1198,1045,153,511247,Одеська область
16236,511248,2203,48,1279,1145,134,511248,Одеська область
16237,511249,2104,33,1225,1035,190,511249,Одеська область
16238,511250,2382,32,1344,1146,198,511250,Одеська область
16239,511251,2115,19,1145,982,163,511251,Одеська область
16240,511252,2018,15,1061,915,146,511252,Одеська область
16241,511253,2418,63,1344,1165,179,511253,Одеська область
16242,511254,2439,24,1037,903,134,511254,Одеська область
16243,511255,2342,22,1238,1080,158,511255,Одеська область
16244,511256,1753,29,956,803,153,511256,Одеська область
16245,511257,2455,41,1469,1247,222,511257,Одеська область
16246,511258,2107,14,1151,1020,131,511258,Одеська область
16247,511259,2377,29,1353,1182,171,511259,Одеська область
16248,511260,1612,20,932,803,129,511260,Одеська область
16249,511261,2258,40,1234,1069,165,511261,Одеська область
16250,511262,2261,46,1052,904,148,511262,Одеська область
16251,511263,2378,38,1319,1099,220,511263,Одеська область
16252,511264,1781,41,801,667,134,511264,Одеська область
16253,511265,1550,24,884,763,121,511265,Одеська область
16254,511266,1852,23,998,829,169,511266,Одеська область
16255,511267,2320,5,460,382,78,511267,Одеська область
16256,511268,2334,31,1345,1130,215,511268,Одеська область
16257,511269,1760,31,1010,829,181,511269,Одеська область
16258,511270,2277,31,1274,1077,197,511270,Одеська область
16259,511271,1832,37,995,832,163,511271,Одеська область
16260,511272,2363,10,439,387,52,511272,Одеська область
16261,511273,2289,29,1288,1092,196,511273,Одеська область
16262,511274,2303,32,1310,1132,178,511274,Одеська область
16263,511275,1374,26,735,601,134,511275,Одеська область
16264,511276,2203,16,1193,933,260,511276,Одеська область
16265,511277,1045,21,560,455,105,511277,Одеська область
16266,511278,2115,41,1144,935,209,511278,Одеська область
16267,511279,2170,41,1169,996,173,511279,Одеська область
16268,511280,1989,46,1136,931,205,511280,Одеська область
16269,511281,1554,22,901,737,164,511281,Одеська область
16270,511282,2205,35,1144,974,170,511282,Одеська область
16271,511283,2142,38,1177,973,204,511283,Одеська область
16272,511284,2336,26,1383,1178,205,511284,Одеська область
16273,511285,1939,36,1111,904,207,511285,Одеська область
16274,511286,2252,27,1194,1022,172,511286,Одеська область
16275,511287,2222,32,1277,1089,188,511287,Одеська область
16276,511288,1965,15,623,533,90,511288,Одеська область
16277,511289,2070,29,1083,925,158,511289,Одеська область
16278,511290,2176,38,1185,1000,185,511290,Одеська область
16279,511291,2177,42,1237,1068,169,511291,Одеська область
16280,511292,1985,22,1086,939,147,511292,Одеська область
16281,511293,1862,20,1015,886,129,511293,Одеська область
16282,511294,2387,32,1372,800,572,511294,Одеська область
16283,511295,2288,34,1267,1125,142,511295,Одеська область
16284,511296,1985,37,1196,1010,186,511296,Одеська область
16285,511297,1290,23,780,698,82,511297,Одеська область
16286,511298,2043,37,1034,889,145,511298,Одеська область
16287,511299,1629,27,812,682,130,511299,Одеська область
16288,511300,2211,44,1340,1087,253,511300,Одеська область
16289,511301,2079,36,1262,1056,206,511301,Одеська область
16290,511302,2080,37,1092,912,180,511302,Одеська область
16291,511303,2177,17,1124,981,143,511303,Одеська область
16292,511304,2055,21,1222,1015,207,511304,Одеська область
16293,511305,2096,29,1230,1047,183,511305,Одеська область
16294,511306,2453,40,1559,1319,240,511306,Одеська область
16295,511307,2312,43,1374,1104,270,511307,Одеська область
16296,511308,2104,42,1272,1075,197,511308,Одеська область
16297,511309,2137,51,1299,1087,212,511309,Одеська область
16298,511310,2382,29,1318,1119,199,511310,Одеська область
16299,511311,2297,43,1335,1105,230,511311,Одеська область
16300,511312,2390,31,1516,1256,260,511312,Одеська область
16301,511313,2168,27,1223,1009,214,511313,Одеська область
16302,511314,2546,27,1599,1326,273,511314,Одеська область
16303,511315,2281,36,1457,1196,261,511315,Одеська область
16304,511316,2537,39,1455,1216,239,511316,Одеська область
16305,511317,2486,41,1341,1116,225,511317,Одеська область
16306,511318,2283,43,1396,1160,236,511318,Одеська область
16307,511319,2007,28,1134,937,197,511319,Одеська область
16308,511320,1890,28,985,835,150,511320,Одеська область
16309,511321,1992,47,1127,932,195,511321,Одеська область
16310,511322,1122,18,708,587,121,511322,Одеська область
16311,511323,2071,28,1248,1050,198,511323,Одеська область
16312,511324,2121,34,1295,1061,234,511324,Одеська область
16313,511325,2435,42,1388,1171,217,511325,Одеська область
16314,511326,34,0,33,33,0,511326,Одеська область
16315,511327,34,0,33,31,2,511327,Одеська область
16316,511328,56,1,48,46,2,511328,Одеська область
16317,511329,79,1,76,70,6,511329,Одеська область
16318,511330,21,0,21,21,0,511330,Одеська область
16319,511331,40,0,39,38,1,511331,Одеська область
16320,511332,47,1,46,44,2,511332,Одеська область
16321,511333,110,2,88,81,7,511333,Одеська область
16322,511334,86,5,80,74,6,511334,Одеська область
16323,511335,28,0,28,24,4,511335,Одеська область
16324,511336,173,7,160,132,28,511336,Одеська область
16325,511337,135,3,122,98,24,511337,Одеська область
16326,511338,81,3,51,47,4,511338,Одеська область
16327,511339,105,4,99,87,12,511339,Одеська область
16328,511437,1536,28,891,725,166,511437,Одеська область
16329,511442,2030,37,1233,1054,179,511442,Одеська область
16330,511219,2180,30,1240,1143,97,511219,Одеська область
16331,511221,2036,28,1236,1044,192,511221,Одеська область
16332,511340,2343,27,1453,1260,193,511340,Одеська область
16333,511341,2162,29,1337,1150,187,511341,Одеська область
16334,511342,2348,16,1326,1203,123,511342,Одеська область
16335,511343,2347,36,1327,1210,117,511343,Одеська область
16336,511344,2183,32,1235,1134,101,511344,Одеська область
16337,511345,2090,24,1106,969,137,511345,Одеська область
16338,511346,1901,18,1166,1017,149,511346,Одеська область
16339,511347,1816,35,1064,956,108,511347,Одеська область
16340,511348,2200,30,1331,1231,100,511348,Одеська область
16341,511349,2510,48,1395,1305,90,511349,Одеська область
16342,511350,2368,28,1370,1254,116,511350,Одеська область
16343,511351,2301,13,1349,1236,113,511351,Одеська область
16344,511352,2400,27,1247,1157,90,511352,Одеська область
16345,511353,1055,13,579,541,38,511353,Одеська область
16346,511354,1544,16,801,747,54,511354,Одеська область
16347,511355,2142,29,1155,1059,96,511355,Одеська область
16348,511356,2114,23,1072,990,82,511356,Одеська область
16349,511357,2298,26,1248,1151,97,511357,Одеська область
16350,511358,2400,30,1244,1128,116,511358,Одеська область
16351,511359,1715,28,958,905,53,511359,Одеська область
16352,511360,1195,19,765,704,61,511360,Одеська область
16353,511361,2284,37,1305,1199,106,511361,Одеська область
16354,511362,1239,17,725,678,47,511362,Одеська область
16355,511363,2220,19,1362,1224,138,511363,Одеська область
16356,511364,1186,28,1134,1035,99,511364,Одеська область
16357,511365,2130,28,1183,1043,140,511365,Одеська область
16358,511374,1994,25,1274,1153,121,511374,Одеська область
16359,511375,2165,26,1372,1248,124,511375,Одеська область
16360,511376,2366,33,1496,1373,123,511376,Одеська область
16361,511377,1928,21,1286,1158,128,511377,Одеська область
16362,511378,2080,43,1367,1244,123,511378,Одеська область
16363,511379,2073,22,1182,1103,79,511379,Одеська область
16364,511380,2014,17,1269,1142,127,511380,Одеська область
16365,511381,1986,22,1313,1174,139,511381,Одеська область
16366,511382,2263,44,1408,1271,137,511382,Одеська область
16367,511383,2326,33,1506,1366,140,511383,Одеська область
16368,511384,1946,16,1125,1038,87,511384,Одеська область
16369,511385,2216,22,1401,1263,138,511385,Одеська область
16370,511386,2208,38,1384,1247,137,511386,Одеська область
16371,511387,2242,55,1483,1356,127,511387,Одеська область
16372,511388,2195,33,1468,1332,136,511388,Одеська область
16373,511389,2139,41,1369,1214,155,511389,Одеська область
16374,511390,2057,30,1349,1198,151,511390,Одеська область
16375,511391,2288,35,1516,1373,143,511391,Одеська область
16376,511392,2253,25,1474,1309,165,511392,Одеська область
16377,511393,2147,27,1360,1209,151,511393,Одеська область
16378,511394,2160,37,1358,1211,147,511394,Одеська область
16379,511395,2071,28,1341,1185,156,511395,Одеська область
16380,511396,2188,26,1420,1262,158,511396,Одеська область
16381,511397,2009,29,1317,1197,120,511397,Одеська область
16382,511398,2205,30,1411,1230,181,511398,Одеська область
16383,511399,2103,20,1399,1221,178,511399,Одеська область
16384,511400,2335,32,1547,1355,192,511400,Одеська область
16385,511401,2111,39,1379,1239,140,511401,Одеська область
16386,511402,2132,47,1415,1275,140,511402,Одеська область
16387,511403,2116,33,1356,1219,137,511403,Одеська область
16388,511404,1956,35,1251,1139,112,511404,Одеська область
16389,511405,2296,32,1426,1291,135,511405,Одеська область
16390,511406,1994,51,1344,1183,161,511406,Одеська область
16391,511407,2135,23,1383,1184,199,511407,Одеська область
16392,511408,2470,19,1612,1412,200,511408,Одеська область
16393,511409,2448,35,1613,1442,171,511409,Одеська область
16394,511410,1944,33,1301,1188,113,511410,Одеська область
16395,511411,1948,37,1334,1191,143,511411,Одеська область
16396,511412,2187,27,1440,1276,164,511412,Одеська область
16397,511413,1810,26,1135,1032,103,511413,Одеська область
16398,511414,2057,25,1271,1135,136,511414,Одеська область
16399,511415,1971,32,1257,1126,131,511415,Одеська область
16400,511416,2051,33,1343,1213,130,511416,Одеська область
16401,511417,2122,43,1341,1182,159,511417,Одеська область
16402,511418,2358,29,1597,1415,182,511418,Одеська область
16403,511419,2437,36,1649,1463,186,511419,Одеська область
16404,511420,2464,38,1611,1452,159,511420,Одеська область
16405,511421,2437,23,1581,1368,213,511421,Одеська область
16406,511422,2259,30,1539,1352,187,511422,Одеська область
16407,511423,2469,13,1600,1388,212,511423,Одеська область
16408,511424,2471,40,1543,1379,164,511424,Одеська область
16409,511425,2370,36,1521,1338,183,511425,Одеська область
16410,511426,2066,36,1365,1237,128,511426,Одеська область
16411,511427,170,2,151,141,10,511427,Одеська область
16412,511428,112,4,98,90,8,511428,Одеська область
16413,511429,189,8,177,165,12,511429,Одеська область
16414,511430,104,3,81,76,5,511430,Одеська область
16415,511431,129,14,111,97,14,511431,Одеська область
16416,511432,16,0,16,16,0,511432,Одеська область
16417,511433,73,1,72,67,5,511433,Одеська область
16418,511434,463,12,386,360,26,511434,Одеська область
16419,511448,2092,16,1395,1209,186,511448,Одеська область
16420,510070,1337,16,636,558,78,510070,Одеська область
16421,510071,1837,13,857,776,81,510071,Одеська область
16422,510073,1490,26,787,674,113,510073,Одеська область
16423,510074,1472,11,844,710,134,510074,Одеська область
16424,510075,1289,8,684,598,86,510075,Одеська область
16425,510076,841,6,468,396,72,510076,Одеська область
16426,510077,1010,11,521,456,65,510077,Одеська область
16427,510078,1145,12,624,531,93,510078,Одеська область
16428,510079,1490,12,759,637,122,510079,Одеська область
16429,510080,1249,18,654,556,98,510080,Одеська область
16430,510081,306,4,176,142,34,510081,Одеська область
16431,510082,751,5,448,382,66,510082,Одеська область
16432,510083,292,6,199,127,72,510083,Одеська область
16433,510084,568,8,312,240,72,510084,Одеська область
16434,510085,255,1,157,137,20,510085,Одеська область
16435,510086,316,3,132,96,36,510086,Одеська область
16436,510087,1034,6,544,462,82,510087,Одеська область
16437,510088,840,11,426,384,42,510088,Одеська область
16438,510089,947,5,468,394,74,510089,Одеська область
16439,510090,854,8,464,384,80,510090,Одеська область
16440,510091,613,11,333,253,80,510091,Одеська область
16441,510092,503,1,302,244,58,510092,Одеська область
16442,510093,171,0,94,84,10,510093,Одеська область
16443,510094,261,1,183,149,34,510094,Одеська область
16444,510095,64,1,51,24,27,510095,Одеська область
16445,510096,121,0,68,43,25,510096,Одеська область
16446,510097,222,2,125,81,44,510097,Одеська область
16447,510098,265,0,172,115,57,510098,Одеська область
16448,510099,518,4,354,231,123,510099,Одеська область
16449,510100,271,1,138,91,47,510100,Одеська область
16450,510101,567,2,336,266,70,510101,Одеська область
16451,510102,314,4,173,161,12,510102,Одеська область
16452,510103,385,5,229,168,61,510103,Одеська область
16453,510105,400,9,256,212,44,510105,Одеська область
16454,510106,375,1,228,174,54,510106,Одеська область
16455,510107,203,0,115,96,19,510107,Одеська область
16456,510108,334,3,193,159,34,510108,Одеська область
16457,510109,261,3,153,100,53,510109,Одеська область
16458,510110,395,4,238,194,44,510110,Одеська область
16459,510111,393,2,231,194,37,510111,Одеська область
16460,510112,508,6,224,188,36,510112,Одеська область
16461,510113,420,2,241,188,53,510113,Одеська область
16462,510114,1280,17,646,499,147,510114,Одеська область
16463,510115,124,0,68,62,6,510115,Одеська область
16464,510116,467,3,301,263,38,510116,Одеська область
16465,510117,582,5,345,240,105,510117,Одеська область
16466,510441,1381,19,712,615,97,510441,Одеська область
16467,510442,1625,7,910,759,151,510442,Одеська область
16468,510443,1563,28,875,734,141,510443,Одеська область
16469,510444,1520,11,767,669,98,510444,Одеська область
16470,510445,1475,14,822,683,139,510445,Одеська область
16471,510446,843,17,442,389,53,510446,Одеська область
16472,510447,767,7,408,373,35,510447,Одеська область
16473,510448,53,0,44,35,9,510448,Одеська область
16474,510449,748,6,385,287,98,510449,Одеська область
16475,510450,710,9,381,312,69,510450,Одеська область
16476,510451,817,9,431,373,58,510451,Одеська область
16477,510452,133,2,77,73,4,510452,Одеська область
16478,510453,887,14,414,338,76,510453,Одеська область
16479,510454,844,19,459,366,93,510454,Одеська область
16480,510455,839,4,442,379,63,510455,Одеська область
16481,510456,433,3,222,188,34,510456,Одеська область
16482,510457,88,0,42,36,6,510457,Одеська область
16483,510459,630,4,326,263,63,510459,Одеська область
16484,510460,155,4,92,49,43,510460,Одеська область
16485,510461,346,4,172,142,30,510461,Одеська область
16486,510462,553,8,275,234,41,510462,Одеська область
16487,510463,322,2,176,140,36,510463,Одеська область
16488,510464,130,2,58,40,18,510464,Одеська область
16489,510465,170,1,96,86,10,510465,Одеська область
16490,510466,800,14,417,329,88,510466,Одеська область
16491,510467,1090,13,489,411,78,510467,Одеська область
16492,510468,1132,9,572,485,87,510468,Одеська область
16493,510469,205,1,113,77,36,510469,Одеська область
16494,510470,469,2,213,186,27,510470,Одеська область
16495,510471,37,0,28,21,7,510471,Одеська область
16496,510472,895,11,418,363,55,510472,Одеська область
16497,510524,261,2,174,133,41,510524,Одеська область
16498,510525,733,9,399,342,57,510525,Одеська область
16499,510526,362,3,178,151,27,510526,Одеська область
16500,510527,185,2,125,96,29,510527,Одеська область
16501,510528,205,1,134,117,17,510528,Одеська область
16502,510529,645,9,371,336,35,510529,Одеська область
16503,510530,120,1,71,55,16,510530,Одеська область
16504,510531,500,14,254,239,15,510531,Одеська область
16505,510532,699,12,437,388,49,510532,Одеська область
16506,510533,119,0,82,78,4,510533,Одеська область
16507,510534,414,1,241,185,56,510534,Одеська область
16508,510535,105,0,62,38,24,510535,Одеська область
16509,510536,104,1,68,43,25,510536,Одеська область
16510,510537,381,4,241,195,46,510537,Одеська область
16511,510538,30,0,26,23,3,510538,Одеська область
16512,510539,18,0,16,9,7,510539,Одеська область
16513,510540,66,0,44,32,12,510540,Одеська область
16514,510541,182,0,84,47,37,510541,Одеська область
16515,510542,161,0,96,48,48,510542,Одеська область
16516,510543,750,11,425,360,65,510543,Одеська область
16517,510544,64,1,28,22,6,510544,Одеська область
16518,510545,608,3,358,323,35,510545,Одеська область
16519,510546,1198,18,722,649,73,510546,Одеська область
16520,510547,257,1,107,96,11,510547,Одеська область
16521,510548,402,2,228,213,15,510548,Одеська область
16522,510549,40,0,32,14,18,510549,Одеська область
16523,510550,396,5,202,186,16,510550,Одеська область
16524,510551,1015,14,484,403,81,510551,Одеська область
16525,510552,570,4,238,230,8,510552,Одеська область
16526,510553,798,5,443,396,47,510553,Одеська область
16527,510554,292,3,231,188,43,510554,Одеська область
16528,510555,911,4,442,390,52,510555,Одеська область
16529,510557,1045,8,684,500,184,510557,Одеська область
16530,510558,99,1,73,41,32,510558,Одеська область
16531,510559,69,0,53,36,17,510559,Одеська область
16532,510560,54,0,27,19,8,510560,Одеська область
16533,510561,162,1,112,76,36,510561,Одеська область
16534,510562,1114,8,578,502,76,510562,Одеська область
16535,510563,172,4,104,81,23,510563,Одеська область
16536,510564,485,3,264,238,26,510564,Одеська область
16537,510565,281,0,132,105,27,510565,Одеська область
16538,510566,399,1,218,192,26,510566,Одеська область
16539,510567,311,3,185,172,13,510567,Одеська область
16540,510568,58,0,38,34,4,510568,Одеська область
16541,510569,212,3,132,114,18,510569,Одеська область
16542,510570,23,0,13,12,1,510570,Одеська область
16543,510571,155,0,96,76,20,510571,Одеська область
16544,510572,149,6,96,80,16,510572,Одеська область
16545,510573,696,9,351,291,60,510573,Одеська область
16546,510574,90,0,42,34,8,510574,Одеська область
16547,510575,645,4,372,289,83,510575,Одеська область
16548,510576,207,2,131,112,19,510576,Одеська область
16549,510578,144,1,82,63,19,510578,Одеська область
16550,510579,187,0,116,92,24,510579,Одеська область
16551,510580,2160,27,1127,1006,121,510580,Одеська область
16552,510581,2030,21,1068,933,135,510581,Одеська область
16553,510582,298,0,147,118,29,510582,Одеська область
16554,510583,592,3,299,265,34,510583,Одеська область
16555,510584,137,2,85,60,25,510584,Одеська область
16556,510585,416,5,206,175,31,510585,Одеська область
16557,510586,546,3,287,260,27,510586,Одеська область
16558,510587,169,1,98,80,18,510587,Одеська область
16559,510588,613,4,333,283,50,510588,Одеська область
16560,510589,189,2,88,77,11,510589,Одеська область
16561,510590,224,3,117,111,6,510590,Одеська область
16562,510591,413,1,185,168,17,510591,Одеська область
16563,510592,625,6,386,343,43,510592,Одеська область
16564,510594,414,4,221,181,40,510594,Одеська область
16565,510595,179,1,79,71,8,510595,Одеська область
16566,510596,272,1,167,145,22,510596,Одеська область
16567,510598,883,6,463,397,66,510598,Одеська область
16568,510599,238,6,130,114,16,510599,Одеська область
16569,510600,140,1,91,63,28,510600,Одеська область
16570,510601,93,1,57,44,13,510601,Одеська область
16571,510602,893,6,586,544,42,510602,Одеська область
16572,510603,780,9,377,331,46,510603,Одеська область
16573,510604,259,1,142,116,26,510604,Одеська область
16574,510605,212,2,103,94,9,510605,Одеська область
16575,510606,155,0,80,60,20,510606,Одеська область
16576,510608,262,2,125,108,17,510608,Одеська область
16577,510609,1338,11,714,613,101,510609,Одеська область
16578,510610,77,0,51,43,8,510610,Одеська область
16579,510762,606,7,299,236,63,510762,Одеська область
16580,510763,575,10,295,219,76,510763,Одеська область
16581,510764,729,6,351,285,66,510764,Одеська область
16582,510765,196,1,120,91,29,510765,Одеська область
16583,510766,173,3,129,114,15,510766,Одеська область
16584,510767,835,6,468,390,78,510767,Одеська область
16585,510768,354,5,207,176,31,510768,Одеська область
16586,510769,794,9,457,371,86,510769,Одеська область
16587,510770,352,3,189,165,24,510770,Одеська область
16588,510771,724,3,439,359,80,510771,Одеська область
16589,510772,599,1,335,282,53,510772,Одеська область
16590,510773,401,1,229,196,33,510773,Одеська область
16591,510774,1654,5,804,691,113,510774,Одеська область
16592,510775,866,5,465,387,78,510775,Одеська область
16593,510776,1695,22,865,730,135,510776,Одеська область
16594,510777,1860,14,1002,816,186,510777,Одеська область
16595,510778,846,3,465,390,75,510778,Одеська область
16596,510779,699,10,358,294,64,510779,Одеська область
16597,510780,318,4,216,162,54,510780,Одеська область
16598,511042,1334,16,799,705,94,511042,Одеська область
16599,511043,2090,31,1278,1150,128,511043,Одеська область
16600,511044,1950,19,1183,1067,116,511044,Одеська область
16601,511045,2028,19,1275,1132,143,511045,Одеська область
16602,511046,1676,28,938,837,101,511046,Одеська область
16603,511047,1304,23,649,595,54,511047,Одеська область
16604,511048,1060,19,585,556,29,511048,Одеська область
16605,511049,1955,29,1122,996,126,511049,Одеська область
16606,511050,2383,33,1376,1277,99,511050,Одеська область
16607,511051,2263,31,1329,1214,115,511051,Одеська область
16608,511052,1790,14,983,918,65,511052,Одеська область
16609,511053,2236,18,1277,1207,70,511053,Одеська область
16610,511054,1677,17,957,894,63,511054,Одеська область
16611,511055,1655,20,961,897,64,511055,Одеська область
16612,511056,1858,31,1076,980,96,511056,Одеська область
16613,511057,2245,26,1372,1236,136,511057,Одеська область
16614,511058,26,0,22,20,2,511058,Одеська область
16615,511059,28,0,25,20,5,511059,Одеська область
16616,510001,1199,14,606,551,55,510001,Одеська область
16617,510002,795,13,414,386,28,510002,Одеська область
16618,510003,1894,23,1053,959,94,510003,Одеська область
16619,510004,566,4,307,268,39,510004,Одеська область
16620,510005,901,9,489,432,57,510005,Одеська область
16621,510006,683,2,356,325,31,510006,Одеська область
16622,510007,819,8,418,381,37,510007,Одеська область
16623,510008,721,9,325,311,14,510008,Одеська область
16624,510009,94,0,63,52,11,510009,Одеська область
16625,510010,754,11,369,338,31,510010,Одеська область
16626,510011,274,3,134,126,8,510011,Одеська область
16627,510012,360,1,225,212,13,510012,Одеська область
16628,510013,437,0,253,242,11,510013,Одеська область
16629,510014,672,1,366,348,18,510014,Одеська область
16630,510015,771,6,360,343,17,510015,Одеська область
16631,510016,343,2,134,131,3,510016,Одеська область
16632,510017,584,8,339,304,35,510017,Одеська область
16633,510018,409,5,172,153,19,510018,Одеська область
16634,510019,407,5,178,165,13,510019,Одеська область
16635,510020,583,6,236,224,12,510020,Одеська область
16636,510021,1085,7,447,424,23,510021,Одеська область
16637,510022,743,6,454,407,47,510022,Одеська область
16638,510023,109,0,62,61,1,510023,Одеська область
16639,510024,504,4,245,206,39,510024,Одеська область
16640,510025,389,1,214,182,32,510025,Одеська область
16641,510026,355,8,186,159,27,510026,Одеська область
16642,510027,488,4,222,197,25,510027,Одеська область
16643,510028,429,1,262,223,39,510028,Одеська область
16644,510029,455,1,244,217,27,510029,Одеська область
16645,510030,587,4,320,295,25,510030,Одеська область
16646,510031,492,4,266,241,25,510031,Одеська область
16647,510032,403,1,192,172,20,510032,Одеська область
16648,510118,519,6,235,219,16,510118,Одеська область
16649,510120,202,0,122,105,17,510120,Одеська область
16650,510121,1201,4,726,645,81,510121,Одеська область
16651,510122,951,8,539,501,38,510122,Одеська область
16652,510123,1174,8,666,597,69,510123,Одеська область
16653,510124,1791,15,1058,982,76,510124,Одеська область
16654,510125,1499,11,930,821,109,510125,Одеська область
16655,510126,541,5,271,233,38,510126,Одеська область
16656,510127,138,2,83,75,8,510127,Одеська область
16657,510128,878,12,495,461,34,510128,Одеська область
16658,510129,578,7,349,309,40,510129,Одеська область
16659,510130,173,2,95,90,5,510130,Одеська область
16660,510131,471,4,267,244,23,510131,Одеська область
16661,510132,673,5,290,275,15,510132,Одеська область
16662,510134,256,3,133,113,20,510134,Одеська область
16663,510135,660,5,361,337,24,510135,Одеська область
16664,510136,237,0,135,126,9,510136,Одеська область
16665,510137,131,3,62,48,14,510137,Одеська область
16666,510138,482,4,263,226,37,510138,Одеська область
16667,510139,237,1,179,172,7,510139,Одеська область
16668,510140,154,1,121,96,25,510140,Одеська область
16669,510141,128,1,119,103,16,510141,Одеська область
16670,510142,704,2,434,362,72,510142,Одеська область
16671,510143,235,0,119,110,9,510143,Одеська область
16672,510144,418,2,220,193,27,510144,Одеська область
16673,510145,230,0,93,62,31,510145,Одеська область
16674,510146,1088,7,499,457,42,510146,Одеська область
16675,510147,91,0,56,47,9,510147,Одеська область
16676,510148,114,1,81,61,20,510148,Одеська область
16677,510149,385,2,187,176,11,510149,Одеська область
16678,510150,148,2,79,62,17,510150,Одеська область
16679,510151,1927,31,897,787,110,510151,Одеська область
16680,510152,652,4,373,348,25,510152,Одеська область
16681,510153,895,5,518,472,46,510153,Одеська область
16682,510154,603,4,378,328,50,510154,Одеська область
16683,510155,221,0,156,140,16,510155,Одеська область
16684,510156,935,8,462,380,82,510156,Одеська область
16685,510157,487,8,239,221,18,510157,Одеська область
16686,510158,181,0,113,107,6,510158,Одеська область
16687,510159,108,1,58,51,7,510159,Одеська область
16688,510160,59,0,39,31,8,510160,Одеська область
16689,510161,357,6,223,183,40,510161,Одеська область
16690,510162,394,4,215,176,39,510162,Одеська область
16691,510163,308,6,170,141,29,510163,Одеська область
16692,510164,381,7,226,208,18,510164,Одеська область
16693,510165,496,3,253,226,27,510165,Одеська область
16694,510166,241,2,125,104,21,510166,Одеська область
16695,510167,21,0,17,14,3,510167,Одеська область
16696,510345,238,0,99,85,14,510345,Одеська область
16697,510346,114,1,67,51,16,510346,Одеська область
16698,510347,686,2,354,321,33,510347,Одеська область
16699,510348,712,10,432,367,65,510348,Одеська область
16700,510349,1208,16,579,561,18,510349,Одеська область
16701,510350,129,0,90,86,4,510350,Одеська область
16702,510351,587,7,347,310,37,510351,Одеська область
16703,510352,760,6,429,397,32,510352,Одеська область
16704,510353,171,1,106,87,19,510353,Одеська область
16705,510354,449,4,248,237,11,510354,Одеська область
16706,510355,324,3,153,132,21,510355,Одеська область
16707,510356,1697,19,1045,907,138,510356,Одеська область
16708,510357,826,14,464,407,57,510357,Одеська область
16709,510358,322,0,172,146,26,510358,Одеська область
16710,510359,1536,16,841,752,89,510359,Одеська область
16711,510360,94,0,60,47,13,510360,Одеська область
16712,510361,100,0,50,38,12,510361,Одеська область
16713,510362,546,13,292,259,33,510362,Одеська область
16714,510363,399,3,215,200,15,510363,Одеська область
16715,510364,417,8,211,189,22,510364,Одеська область
16716,510365,964,7,455,430,25,510365,Одеська область
16717,510366,1501,10,666,630,36,510366,Одеська область
16718,510367,1368,20,711,642,69,510367,Одеська область
16719,510368,327,1,218,201,17,510368,Одеська область
16720,510369,1462,9,795,710,85,510369,Одеська область
16721,510370,485,3,249,230,19,510370,Одеська область
16722,510371,434,2,208,192,16,510371,Одеська область
16723,510372,81,0,42,41,1,510372,Одеська область
16724,510373,322,10,150,138,12,510373,Одеська область
16725,510374,1257,11,697,642,55,510374,Одеська область
16726,510375,1611,22,982,831,151,510375,Одеська область
16727,510376,186,6,126,109,17,510376,Одеська область
16728,510377,73,1,44,43,1,510377,Одеська область
16729,510378,107,1,75,60,15,510378,Одеська область
16730,510379,26,0,21,18,3,510379,Одеська область
16731,510473,1919,17,1106,985,121,510473,Одеська область
16732,510474,136,1,78,64,14,510474,Одеська область
16733,510475,136,2,88,76,12,510475,Одеська область
16734,510476,124,0,81,54,27,510476,Одеська область
16735,510477,571,3,360,318,42,510477,Одеська область
16736,510478,1195,8,675,615,60,510478,Одеська область
16737,510479,624,7,360,308,52,510479,Одеська область
16738,510480,102,1,68,66,2,510480,Одеська область
16739,510481,554,4,321,277,44,510481,Одеська область
16740,510482,277,1,147,127,20,510482,Одеська область
16741,510483,1333,14,717,603,114,510483,Одеська область
16742,510484,1799,13,1020,918,102,510484,Одеська область
16743,510485,557,11,328,296,32,510485,Одеська область
16744,510486,2408,33,1493,1300,193,510486,Одеська область
16745,510487,2313,29,1409,1209,200,510487,Одеська область
16746,510488,453,3,282,247,35,510488,Одеська область
16747,510489,414,2,269,244,25,510489,Одеська область
16748,510490,359,3,230,199,31,510490,Одеська область
16749,510491,131,0,73,70,3,510491,Одеська область
16750,510492,511,7,318,293,25,510492,Одеська область
16751,510493,586,5,363,321,42,510493,Одеська область
16752,510494,1837,21,1107,1031,76,510494,Одеська область
16753,510495,1439,15,824,760,64,510495,Одеська область
16754,510496,546,4,330,298,32,510496,Одеська область
16755,510497,1000,9,619,559,60,510497,Одеська область
16756,510498,1308,21,766,727,39,510498,Одеська область
16757,510521,1601,14,986,891,95,510521,Одеська область
16758,510522,19,0,18,14,4,510522,Одеська область
16759,510611,333,2,204,123,81,510611,Одеська область
16760,510612,691,3,400,331,69,510612,Одеська область
16761,510613,546,6,224,192,32,510613,Одеська область
16762,510614,597,5,302,236,66,510614,Одеська область
16763,510615,583,1,257,228,29,510615,Одеська область
16764,510616,268,3,132,115,17,510616,Одеська область
16765,510617,411,4,223,203,20,510617,Одеська область
16766,510618,669,6,381,335,46,510618,Одеська область
16767,510619,1063,9,548,490,58,510619,Одеська область
16768,510620,229,1,124,116,8,510620,Одеська область
16769,510621,1295,16,697,610,87,510621,Одеська область
16770,510622,257,2,144,123,21,510622,Одеська область
16771,510623,140,0,75,59,16,510623,Одеська область
16772,510624,462,7,250,229,21,510624,Одеська область
16773,510625,1082,15,568,513,55,510625,Одеська область
16774,510626,1101,10,641,566,75,510626,Одеська область
16775,510627,1755,13,1016,912,104,510627,Одеська область
16776,510628,949,5,501,455,46,510628,Одеська область
16777,510629,520,5,329,293,36,510629,Одеська область
16778,510630,125,3,67,47,20,510630,Одеська область
16779,510631,359,6,170,139,31,510631,Одеська область
16780,510632,258,4,204,176,28,510632,Одеська область
16781,510633,309,1,253,241,12,510633,Одеська область
16782,510634,160,0,127,91,36,510634,Одеська область
16783,510635,620,7,333,282,51,510635,Одеська область
16784,510636,381,3,220,202,18,510636,Одеська область
16785,510637,413,5,225,193,32,510637,Одеська область
16786,510638,981,4,545,468,77,510638,Одеська область
16787,510639,831,9,421,384,37,510639,Одеська область
16788,510640,209,4,94,80,14,510640,Одеська область
16789,510641,243,2,144,125,19,510641,Одеська область
16790,510642,424,10,262,211,51,510642,Одеська область
16791,510643,1293,13,766,648,118,510643,Одеська область
16792,510644,1128,7,637,594,43,510644,Одеська область
16793,510645,464,3,287,206,81,510645,Одеська область
16794,510646,285,2,167,145,22,510646,Одеська область
16795,510647,218,2,111,86,25,510647,Одеська область
16796,510648,494,0,281,249,32,510648,Одеська область
16797,510649,575,2,316,284,32,510649,Одеська область
16798,510650,615,7,335,267,68,510650,Одеська область
16799,510651,1857,13,1003,877,126,510651,Одеська область
16800,510652,950,4,534,483,51,510652,Одеська область
16801,510653,128,0,55,52,3,510653,Одеська область
16802,510655,150,0,95,73,22,510655,Одеська область
16803,510656,446,3,222,192,30,510656,Одеська область
16804,510657,274,0,127,117,10,510657,Одеська область
16805,510658,446,0,246,216,30,510658,Одеська область
16806,510659,204,3,106,84,22,510659,Одеська область
16807,510660,226,4,127,104,23,510660,Одеська область
16808,510661,426,1,237,211,26,510661,Одеська область
16809,510662,380,0,211,193,18,510662,Одеська область
16810,510663,422,6,222,202,20,510663,Одеська область
16811,510665,830,6,462,399,63,510665,Одеська область
16812,510667,822,6,435,363,72,510667,Одеська область
16813,510668,706,4,343,288,55,510668,Одеська область
16814,510669,588,8,354,326,28,510669,Одеська область
16815,510670,297,2,132,119,13,510670,Одеська область
16816,510671,109,0,63,52,11,510671,Одеська область
16817,510913,115,0,77,69,8,510913,Одеська область
16818,510914,269,1,129,98,31,510914,Одеська область
16819,510915,218,0,97,84,13,510915,Одеська область
16820,510916,537,8,295,258,37,510916,Одеська область
16821,510918,288,0,156,137,19,510918,Одеська область
16822,510919,1890,19,927,818,109,510919,Одеська область
16823,510920,627,3,303,266,37,510920,Одеська область
16824,510921,169,2,103,95,8,510921,Одеська область
16825,510922,243,4,159,119,40,510922,Одеська область
16826,510923,613,1,290,260,30,510923,Одеська область
16827,510924,488,6,274,255,19,510924,Одеська область
16828,510925,931,5,478,443,35,510925,Одеська область
16829,510926,974,7,464,404,60,510926,Одеська область
16830,510927,155,3,94,86,8,510927,Одеська область
16831,510928,488,4,257,207,50,510928,Одеська область
16832,510929,366,3,172,151,21,510929,Одеська область
16833,510930,580,1,315,293,22,510930,Одеська область
16834,510931,680,12,313,229,84,510931,Одеська область
16835,510932,390,2,203,183,20,510932,Одеська область
16836,510933,405,3,213,195,18,510933,Одеська область
16837,510934,760,4,440,363,77,510934,Одеська область
16838,510935,521,3,269,238,31,510935,Одеська область
16839,510936,210,2,121,110,11,510936,Одеська область
16840,510937,341,3,158,126,32,510937,Одеська область
16841,510938,801,8,431,399,32,510938,Одеська область
16842,510939,472,5,205,147,58,510939,Одеська область
16843,510940,952,2,560,491,69,510940,Одеська область
16844,510941,1644,6,931,808,123,510941,Одеська область
16845,510942,2266,23,1319,1168,151,510942,Одеська область
16846,510943,778,6,431,393,38,510943,Одеська область
16847,510944,54,2,41,40,1,510944,Одеська область
16848,511435,28,1,26,17,9,511435,Одеська область
16849,511436,14,0,14,10,4,511436,Одеська область
16850,511438,398,1,239,216,23,511438,Одеська область
16851,511439,215,0,124,104,20,511439,Одеська область
16852,511440,1251,15,685,613,72,511440,Одеська область
16853,511441,1071,8,613,537,76,511441,Одеська область
16854,510222,1279,12,791,739,52,510222,Одеська область
16855,510223,146,2,93,89,4,510223,Одеська область
16856,510230,1463,15,761,679,82,510230,Одеська область
16857,510237,1957,21,993,917,76,510237,Одеська область
16858,510238,1116,22,575,533,42,510238,Одеська область
16859,510241,1972,35,1097,1000,97,510241,Одеська область
16860,510242,1603,12,993,882,111,510242,Одеська область
16861,510243,1622,17,994,932,62,510243,Одеська область
16862,510246,1212,15,703,662,41,510246,Одеська область
16863,510248,1019,6,588,562,26,510248,Одеська область
16864,510249,1673,23,1037,980,57,510249,Одеська область
16865,510252,446,3,282,269,13,510252,Одеська область
16866,510257,907,11,597,532,65,510257,Одеська область
16867,510263,377,7,227,219,8,510263,Одеська область
16868,510264,409,2,265,251,14,510264,Одеська область
16869,510265,699,5,342,303,39,510265,Одеська область
16870,510268,362,4,217,206,11,510268,Одеська область
16871,510269,768,8,437,379,58,510269,Одеська область
16872,510276,2242,28,1298,1167,131,510276,Одеська область
16873,510277,311,3,170,164,6,510277,Одеська область
16874,510319,214,1,130,110,20,510319,Одеська область
16875,510320,948,14,440,411,29,510320,Одеська область
16876,510321,1516,23,802,727,75,510321,Одеська область
16877,510322,1665,18,911,834,77,510322,Одеська область
16878,510323,1366,17,767,686,81,510323,Одеська область
16879,510324,2319,16,1062,1029,33,510324,Одеська область
16880,510325,865,3,404,372,32,510325,Одеська область
16881,510326,695,5,314,292,22,510326,Одеська область
16882,510327,122,2,42,40,2,510327,Одеська область
16883,510328,558,6,279,253,26,510328,Одеська область
16884,510329,1876,21,774,690,84,510329,Одеська область
16885,510330,314,5,155,136,19,510330,Одеська область
16886,510331,1504,11,766,709,57,510331,Одеська область
16887,510332,320,0,221,190,31,510332,Одеська область
16888,510333,591,6,277,252,25,510333,Одеська область
16889,510334,583,4,286,262,24,510334,Одеська область
16890,510335,479,8,286,248,38,510335,Одеська область
16891,510336,766,4,440,409,31,510336,Одеська область
16892,510337,546,8,252,240,12,510337,Одеська область
16893,510338,427,3,225,185,40,510338,Одеська область
16894,510339,290,1,168,149,19,510339,Одеська область
16895,510340,444,2,233,228,5,510340,Одеська область
16896,510341,2339,32,1153,1029,124,510341,Одеська область
16897,510342,637,4,316,266,50,510342,Одеська область
16898,510343,430,3,239,207,32,510343,Одеська область
16899,510499,458,2,240,206,34,510499,Одеська область
16900,510500,298,3,166,143,23,510500,Одеська область
16901,510501,2522,41,1596,1456,140,510501,Одеська область
16902,510502,500,3,306,272,34,510502,Одеська область
16903,510503,1171,14,752,699,53,510503,Одеська область
16904,510504,1597,22,987,884,103,510504,Одеська область
16905,510505,1504,23,859,769,90,510505,Одеська область
16906,510506,1805,24,1066,962,104,510506,Одеська область
16907,510507,577,9,362,339,23,510507,Одеська область
16908,510508,846,9,531,483,48,510508,Одеська область
16909,510509,1821,25,1206,1095,111,510509,Одеська область
16910,510510,2546,21,1643,1472,171,510510,Одеська область
16911,510511,737,8,472,402,70,510511,Одеська область
16912,510512,2318,35,1408,1246,162,510512,Одеська область
16913,510513,1449,29,939,806,133,510513,Одеська область
16914,510514,2282,27,1369,1220,149,510514,Одеська область
16915,510515,714,8,434,384,50,510515,Одеська область
16916,510516,1080,7,726,654,72,510516,Одеська область
16917,510517,2128,32,1400,1272,128,510517,Одеська область
16918,510518,2254,48,1359,1008,351,510518,Одеська область
16919,510519,944,6,557,496,61,510519,Одеська область
16920,510520,667,5,407,377,30,510520,Одеська область
16921,510523,83,11,68,55,13,510523,Одеська область
16922,510727,2493,32,1275,1173,102,510727,Одеська область
16923,510728,2337,28,1156,1079,77,510728,Одеська область
16924,510729,2238,19,1190,1068,122,510729,Одеська область
16925,510730,2391,27,1350,1215,135,510730,Одеська область
16926,510731,2320,41,1236,1134,102,510731,Одеська область
16927,510732,2207,31,1054,978,76,510732,Одеська область
16928,510733,1726,12,836,794,42,510733,Одеська область
16929,510734,1466,15,655,605,50,510734,Одеська область
16930,510735,2296,22,1010,935,75,510735,Одеська область
16931,510736,331,10,212,172,40,510736,Одеська область
16932,510737,246,1,135,112,23,510737,Одеська область
16933,510738,892,7,402,369,33,510738,Одеська область
16934,510739,1800,22,1038,964,74,510739,Одеська область
16935,510740,503,4,279,269,10,510740,Одеська область
16936,510741,463,5,265,240,25,510741,Одеська область
16937,510742,892,5,494,456,38,510742,Одеська область
16938,510743,1050,9,645,606,39,510743,Одеська область
16939,510744,755,5,473,328,145,510744,Одеська область
16940,510745,617,5,339,280,59,510745,Одеська область
16941,510746,1453,13,623,593,30,510746,Одеська область
16942,510747,904,16,518,479,39,510747,Одеська область
16943,510748,607,10,345,320,25,510748,Одеська область
16944,510749,1441,38,738,674,64,510749,Одеська область
16945,510750,1455,12,731,699,32,510750,Одеська область
16946,510751,506,5,276,259,17,510751,Одеська область
16947,510752,809,11,419,354,65,510752,Одеська область
16948,510753,791,4,367,345,22,510753,Одеська область
16949,510754,1429,14,715,656,59,510754,Одеська область
16950,510755,437,1,155,122,33,510755,Одеська область
16951,510756,1789,19,966,864,102,510756,Одеська область
16952,510757,904,16,409,377,32,510757,Одеська область
16953,510758,1146,3,572,536,36,510758,Одеська область
16954,510759,391,0,227,215,12,510759,Одеська область
16955,510760,1168,8,637,612,25,510760,Одеська область
16956,510761,1433,12,675,608,67,510761,Одеська область
16957,510894,282,3,162,128,34,510894,Одеська область
16958,510895,215,2,49,45,4,510895,Одеська область
16959,510896,418,3,218,200,18,510896,Одеська область
16960,510897,1373,10,603,562,41,510897,Одеська область
16961,510898,1499,21,674,637,37,510898,Одеська область
16962,510899,655,4,303,264,39,510899,Одеська область
16963,510900,575,3,305,275,30,510900,Одеська область
16964,510901,611,4,262,244,18,510901,Одеська область
16965,510902,415,8,199,184,15,510902,Одеська область
16966,510903,438,2,223,170,53,510903,Одеська область
16967,510904,326,5,146,117,29,510904,Одеська область
16968,510905,269,1,130,113,17,510905,Одеська область
16969,510906,324,2,140,121,19,510906,Одеська область
16970,510907,774,12,337,313,24,510907,Одеська область
16971,510908,169,5,91,77,14,510908,Одеська область
16972,510909,1200,12,563,521,42,510909,Одеська область
16973,510910,484,3,264,241,23,510910,Одеська область
16974,510911,2430,28,1332,1207,125,510911,Одеська область
16975,510912,1753,15,919,857,62,510912,Одеська область
16976,511064,2122,29,1491,1348,143,511064,Одеська область
16977,511065,2150,31,1479,1315,164,511065,Одеська область
16978,511066,2148,37,1507,1330,177,511066,Одеська область
16979,511067,2477,40,1723,1527,196,511067,Одеська область
16980,511068,2510,26,1752,1582,170,511068,Одеська область
16981,511069,2429,50,1636,1473,163,511069,Одеська область
16982,511070,1984,35,1341,1206,135,511070,Одеська область
16983,511071,1992,34,1404,1246,158,511071,Одеська область
16984,511072,1955,20,1377,1231,146,511072,Одеська область
16985,511366,2433,38,1441,1317,124,511366,Одеська область
16986,511367,2368,46,1455,1314,141,511367,Одеська область
16987,511368,2236,24,1436,1273,163,511368,Одеська область
16988,511369,2133,39,1331,1208,123,511369,Одеська область
16989,511370,2202,30,1390,1226,164,511370,Одеська область
16990,511371,2266,29,1452,1252,200,511371,Одеська область
16991,511372,2170,35,1347,1214,133,511372,Одеська область
16992,511373,2144,20,1379,1242,137,511373,Одеська область
16993,511443,729,7,446,414,32,511443,Одеська область
16994,511452,2227,28,1307,1167,140,511452,Одеська область
16995,510224,916,7,567,534,33,510224,Одеська область
16996,510225,2249,29,1283,1191,92,510225,Одеська область
16997,510226,1917,18,1105,1037,68,510226,Одеська область
16998,510227,2042,13,1174,1070,104,510227,Одеська область
16999,510228,2234,24,1324,1196,128,510228,Одеська область
17000,510229,2296,26,1391,1309,82,510229,Одеська область
17001,510231,1243,14,677,640,37,510231,Одеська область
17002,510232,1118,16,627,566,61,510232,Одеська область
17003,510233,2192,22,1275,1114,161,510233,Одеська область
17004,510234,1519,17,928,830,98,510234,Одеська область
17005,510235,2045,27,1115,998,117,510235,Одеська область
17006,510236,802,8,448,427,21,510236,Одеська область
17007,510239,1674,14,966,951,15,510239,Одеська область
17008,510240,1778,17,858,825,33,510240,Одеська область
17009,510244,460,2,256,220,36,510244,Одеська область
17010,510245,1560,17,883,774,109,510245,Одеська область
17011,510247,1118,5,525,479,46,510247,Одеська область
17012,510250,267,3,153,142,11,510250,Одеська область
17013,510251,1020,5,505,470,35,510251,Одеська область
17014,510253,1524,14,821,740,81,510253,Одеська область
17015,510254,1514,16,865,778,87,510254,Одеська область
17016,510255,1191,7,713,655,58,510255,Одеська область
17017,510256,2047,26,1243,1086,157,510256,Одеська область
17018,510258,2191,29,1464,1322,142,510258,Одеська область
17019,510259,1923,20,936,840,96,510259,Одеська область
17020,510260,1992,31,1153,1079,74,510260,Одеська область
17021,510261,2117,18,1288,1181,107,510261,Одеська область
17022,510262,1285,12,821,761,60,510262,Одеська область
17023,510266,750,7,454,435,19,510266,Одеська область
17024,510267,289,4,175,167,8,510267,Одеська область
17025,510270,2139,27,1015,981,34,510270,Одеська область
17026,510271,1596,7,771,748,23,510271,Одеська область
17027,510272,2234,27,1307,1195,112,510272,Одеська область
17028,510273,2318,31,1418,1333,85,510273,Одеська область
17029,510274,2318,29,1235,1163,72,510274,Одеська область
17030,510275,1795,15,1182,1070,112,510275,Одеська область
17031,510278,481,5,288,236,52,510278,Одеська область
17032,510279,604,8,367,337,30,510279,Одеська область
17033,510280,1530,21,809,775,34,510280,Одеська область
17034,510281,1604,13,768,714,54,510281,Одеська область
17035,510282,31,0,25,22,3,510282,Одеська область
17036,510672,2109,21,1344,1226,118,510672,Одеська область
17037,510673,2195,27,1365,1275,90,510673,Одеська область
17038,510674,2155,23,1211,1108,103,510674,Одеська область
17039,510675,1734,20,945,863,82,510675,Одеська область
17040,510676,2081,35,1110,1014,96,510676,Одеська область
17041,510677,1861,30,1168,1093,75,510677,Одеська область
17042,510678,2362,16,1443,1283,160,510678,Одеська область
17043,510679,2341,23,1464,1318,146,510679,Одеська область
17044,510680,2307,25,1364,1233,131,510680,Одеська область
17045,510681,2374,25,1329,1236,93,510681,Одеська область
17046,510682,1762,18,1163,1052,111,510682,Одеська область
17047,510683,1779,12,1138,966,172,510683,Одеська область
17048,510684,2416,30,1371,1161,210,510684,Одеська область
17049,510685,1642,28,1018,897,121,510685,Одеська область
17050,510686,1217,14,738,675,63,510686,Одеська область
17051,510687,995,11,579,536,43,510687,Одеська область
17052,510688,365,3,252,232,20,510688,Одеська область
17053,510689,667,7,419,384,35,510689,Одеська область
17054,510690,1463,17,875,816,59,510690,Одеська область
17055,510691,1496,17,862,785,77,510691,Одеська область
17056,510692,1205,17,671,622,49,510692,Одеська область
17057,510693,1818,17,1053,966,87,510693,Одеська область
17058,510694,862,7,511,467,44,510694,Одеська область
17059,510695,1179,6,662,618,44,510695,Одеська область
17060,510696,1518,25,987,907,80,510696,Одеська область
17061,510697,1722,23,1075,969,106,510697,Одеська область
17062,510698,1449,9,913,799,114,510698,Одеська область
17063,510699,1507,12,844,767,77,510699,Одеська область
17064,510700,1866,10,1184,1092,92,510700,Одеська область
17065,510701,1225,17,690,642,48,510701,Одеська область
17066,510702,1257,18,707,646,61,510702,Одеська область
17067,510703,2122,17,1206,1114,92,510703,Одеська область
17068,510704,1840,21,1167,1080,87,510704,Одеська область
17069,510705,1289,3,723,658,65,510705,Одеська область
17070,510706,1347,11,850,772,78,510706,Одеська область
17071,511014,2123,52,1413,1278,135,511014,Одеська область
17072,511015,2324,47,1462,1301,161,511015,Одеська область
17073,511016,2180,40,1517,1339,178,511016,Одеська область
17074,511017,2271,31,1533,1363,170,511017,Одеська область
17075,511018,2140,48,1453,1298,155,511018,Одеська область
17076,511019,2293,32,1539,1327,212,511019,Одеська область
17077,511020,2333,40,1549,1341,208,511020,Одеська область
17078,511021,2240,38,1499,1310,189,511021,Одеська область
17079,511022,2190,36,1478,1329,149,511022,Одеська область
17080,511023,2546,45,1697,1468,229,511023,Одеська область
17081,511024,2237,30,1613,1434,179,511024,Одеська область
17082,511025,767,13,527,454,73,511025,Одеська область
17083,511026,2074,28,1403,1252,151,511026,Одеська область
17084,511027,2358,27,1527,1383,144,511027,Одеська область
17085,511028,739,8,480,452,28,511028,Одеська область
17086,511029,1589,27,1107,984,123,511029,Одеська область
17087,511030,1329,15,860,784,76,511030,Одеська область
17088,511031,1593,26,979,876,103,511031,Одеська область
17089,511032,1416,17,888,803,85,511032,Одеська область
17090,511033,1616,31,1085,940,145,511033,Одеська область
17091,511034,2366,28,1628,1448,180,511034,Одеська область
17092,511035,2603,42,1780,1587,193,511035,Одеська область
17093,511036,1943,24,1132,1059,73,511036,Одеська область
17094,511037,1885,16,909,828,81,511037,Одеська область
17095,511038,1625,26,1006,931,75,511038,Одеська область
17096,511039,1501,26,943,848,95,511039,Одеська область
17097,511040,1376,21,805,744,61,511040,Одеська область
17098,511041,918,5,546,506,40,511041,Одеська область
17099,511060,1864,25,1146,1049,97,511060,Одеська область
17100,511061,2242,17,1375,1240,135,511061,Одеська область
17101,511062,2245,34,1330,1212,118,511062,Одеська область
17102,511063,1064,23,628,570,58,511063,Одеська область
17103,511444,1901,25,1124,970,154,511444,Одеська область
17104,511445,13,0,11,10,1,511445,Одеська область
17105,511446,110,0,76,69,7,511446,Одеська область
17106,511449,1568,22,937,798,139,511449,Одеська область
17107,511453,2086,22,1331,1146,185,511453,Одеська область
17108,510168,308,1,211,184,27,510168,Одеська область
17109,510169,164,3,106,80,26,510169,Одеська область
17110,510170,139,2,87,63,24,510170,Одеська область
17111,510171,746,13,421,377,44,510171,Одеська область
17112,510172,385,4,236,216,20,510172,Одеська область
17113,510173,2334,30,1427,1325,102,510173,Одеська область
17114,510174,521,3,305,293,12,510174,Одеська область
17115,510175,108,0,94,86,8,510175,Одеська область
17116,510176,173,0,125,116,9,510176,Одеська область
17117,510177,450,6,355,341,14,510177,Одеська область
17118,510178,419,2,301,292,9,510178,Одеська область
17119,510179,140,2,70,60,10,510179,Одеська область
17120,510180,186,3,139,104,35,510180,Одеська область
17121,510181,438,3,242,237,5,510181,Одеська область
17122,510182,900,4,525,507,18,510182,Одеська область
17123,510183,2360,28,1296,1224,72,510183,Одеська область
17124,510184,2252,33,1239,1165,74,510184,Одеська область
17125,510185,1295,23,833,771,62,510185,Одеська область
17126,510186,563,12,292,266,26,510186,Одеська область
17127,510187,1039,9,552,511,41,510187,Одеська область
17128,510188,776,10,442,420,22,510188,Одеська область
17129,510189,1392,12,659,639,20,510189,Одеська область
17130,510190,1159,6,539,513,26,510190,Одеська область
17131,510191,944,11,522,486,36,510191,Одеська область
17132,510192,1012,5,539,505,34,510192,Одеська область
17133,510193,270,6,148,129,19,510193,Одеська область
17134,510194,2335,42,1281,1222,59,510194,Одеська область
17135,510195,526,2,405,389,16,510195,Одеська область
17136,510196,547,5,269,240,29,510196,Одеська область
17137,510197,739,10,378,363,15,510197,Одеська область
17138,510198,512,6,271,231,40,510198,Одеська область
17139,510199,260,4,179,161,18,510199,Одеська область
17140,510200,724,6,396,359,37,510200,Одеська область
17141,510201,261,4,132,116,16,510201,Одеська область
17142,510202,569,1,321,281,40,510202,Одеська область
17143,510203,99,0,56,49,7,510203,Одеська область
17144,510204,947,13,418,398,20,510204,Одеська область
17145,510205,1092,13,757,724,33,510205,Одеська область
17146,510206,194,2,178,162,16,510206,Одеська область
17147,510207,153,1,117,99,18,510207,Одеська область
17148,510208,111,0,83,78,5,510208,Одеська область
17149,510209,120,1,84,83,1,510209,Одеська область
17150,510210,653,5,379,348,31,510210,Одеська область
17151,510211,394,4,246,230,16,510211,Одеська область
17152,510212,89,0,55,54,1,510212,Одеська область
17153,510213,1885,23,934,895,39,510213,Одеська область
17154,510214,1875,17,1068,1026,42,510214,Одеська область
17155,510215,1131,21,539,506,33,510215,Одеська область
17156,510216,1278,11,710,607,103,510216,Одеська область
17157,510217,910,8,613,583,30,510217,Одеська область
17158,510218,1380,13,753,710,43,510218,Одеська область
17159,510219,2049,18,1086,1039,47,510219,Одеська область
17160,510220,2338,24,1348,1275,73,510220,Одеська область
17161,510221,801,14,555,529,26,510221,Одеська область
17162,510407,1522,10,808,736,72,510407,Одеська область
17163,510408,1110,20,551,501,50,510408,Одеська область
17164,510409,1313,14,677,616,61,510409,Одеська область
17165,510410,1488,28,759,698,61,510410,Одеська область
17166,510411,1416,18,695,642,53,510411,Одеська область
17167,510412,2316,40,1187,1072,115,510412,Одеська область
17168,510413,1512,19,784,717,67,510413,Одеська область
17169,510414,1215,11,545,489,56,510414,Одеська область
17170,510415,1177,12,646,580,66,510415,Одеська область
17171,510416,1645,26,891,794,97,510416,Одеська область
17172,510417,1067,10,530,470,60,510417,Одеська область
17173,510418,582,11,350,308,42,510418,Одеська область
17174,510419,2060,11,1020,959,61,510419,Одеська область
17175,510420,938,4,469,454,15,510420,Одеська область
17176,510421,1284,19,589,575,14,510421,Одеська область
17177,510422,1075,13,464,440,24,510422,Одеська область
17178,510423,1361,29,659,610,49,510423,Одеська область
17179,510425,1012,6,630,613,17,510425,Одеська область
17180,510426,1151,16,537,488,49,510426,Одеська область
17181,510427,420,3,185,155,30,510427,Одеська область
17182,510428,1265,21,663,630,33,510428,Одеська область
17183,510435,1292,10,676,602,74,510435,Одеська область
17184,510439,33,0,32,30,2,510439,Одеська область
17185,510440,18,0,18,16,2,510440,Одеська область
17186,510861,1678,34,969,840,129,510861,Одеська область
17187,510862,1973,21,1127,1001,126,510862,Одеська область
17188,510863,1266,15,668,590,78,510863,Одеська область
17189,510864,2065,21,1063,945,118,510864,Одеська область
17190,510865,1517,31,813,735,78,510865,Одеська область
17191,510866,792,4,418,393,25,510866,Одеська область
17192,510867,644,8,349,307,42,510867,Одеська область
17193,510868,311,1,209,192,17,510868,Одеська область
17194,510869,1452,12,710,647,63,510869,Одеська область
17195,510870,1301,11,718,687,31,510870,Одеська область
17196,510871,969,14,504,424,80,510871,Одеська область
17197,510872,823,11,414,387,27,510872,Одеська область
17198,510873,654,8,336,317,19,510873,Одеська область
17199,510874,597,7,306,276,30,510874,Одеська область
17200,510875,1672,28,927,872,55,510875,Одеська область
17201,510876,1395,30,771,721,50,510876,Одеська область
17202,510877,460,2,313,293,20,510877,Одеська область
17203,510878,200,5,127,105,22,510878,Одеська область
17204,510879,104,1,71,65,6,510879,Одеська область
17205,510880,112,0,99,90,9,510880,Одеська область
17206,510881,302,3,245,195,50,510881,Одеська область
17207,510882,1058,8,564,398,166,510882,Одеська область
17208,510883,593,8,309,268,41,510883,Одеська область
17209,510884,607,4,343,322,21,510884,Одеська область
17210,510885,1232,13,565,473,92,510885,Одеська область
17211,510886,56,1,23,19,4,510886,Одеська область
17212,510887,458,7,276,162,114,510887,Одеська область
17213,510888,1253,12,649,609,40,510888,Одеська область
17214,510889,517,6,284,246,38,510889,Одеська область
17215,510890,671,8,316,270,46,510890,Одеська область
17216,510891,400,2,218,190,28,510891,Одеська область
17217,510892,1100,13,605,529,76,510892,Одеська область
17218,510893,157,2,96,85,11,510893,Одеська область
17219,510945,1882,18,1029,909,120,510945,Одеська область
17220,510946,1374,21,798,740,58,510946,Одеська область
17221,510947,1819,34,1094,1010,84,510947,Одеська область
17222,510948,1873,24,1034,929,105,510948,Одеська область
17223,510949,1373,20,764,691,73,510949,Одеська область
17224,510950,1359,18,757,699,58,510950,Одеська область
17225,510951,1196,17,700,651,49,510951,Одеська область
17226,510952,1717,24,1019,960,59,510952,Одеська область
17227,510953,1937,32,1190,1111,79,510953,Одеська область
17228,510954,1597,32,881,819,62,510954,Одеська область
17229,510955,1979,28,1194,1097,97,510955,Одеська область
17230,510956,2037,26,1152,1072,80,510956,Одеська область
17231,510957,1765,33,996,933,63,510957,Одеська область
17232,510958,1674,29,1000,921,79,510958,Одеська область
17233,510959,2013,19,1168,1101,67,510959,Одеська область
17234,510960,1813,24,1079,988,91,510960,Одеська область
17235,510962,1294,12,777,721,56,510962,Одеська область
17236,510963,1611,26,983,902,81,510963,Одеська область
17237,510964,2149,34,1213,1136,77,510964,Одеська область
17238,510965,1860,18,1170,1089,81,510965,Одеська область
17239,510966,2219,28,1333,1207,126,510966,Одеська область
17240,510967,1733,28,1108,1019,89,510967,Одеська область
17241,510968,2039,37,1195,1078,117,510968,Одеська область
17242,510969,1628,18,902,803,99,510969,Одеська область
17243,510970,2295,27,1076,985,91,510970,Одеська область
17244,510971,2286,28,1088,1016,72,510971,Одеська область
17245,510972,37,0,32,29,3,510972,Одеська область
17246,510973,31,0,28,24,4,510973,Одеська область
17247,510974,33,0,33,31,2,510974,Одеська область
17248,510975,15,0,15,12,3,510975,Одеська область
17249,510976,11,0,9,9,0,510976,Одеська область
17250,510977,39,0,39,37,2,510977,Одеська область
17251,510033,2079,35,1062,1000,62,510033,Одеська область
17252,510034,1744,21,885,816,69,510034,Одеська область
17253,510035,1468,18,827,770,57,510035,Одеська область
17254,510036,1788,10,1035,933,102,510036,Одеська область
17255,510037,651,9,366,332,34,510037,Одеська область
17256,510038,647,2,377,360,17,510038,Одеська область
17257,510039,2436,19,1253,1145,108,510039,Одеська область
17258,510040,1347,14,731,668,63,510040,Одеська область
17259,510041,884,7,469,436,33,510041,Одеська область
17260,510042,176,2,94,87,7,510042,Одеська область
17261,510043,1126,19,908,624,284,510043,Одеська область
17262,510044,1056,42,765,510,255,510044,Одеська область
17263,510045,299,0,242,166,76,510045,Одеська область
17264,510046,632,7,386,348,38,510046,Одеська область
17265,510047,390,2,209,196,13,510047,Одеська область
17266,510048,832,3,473,456,17,510048,Одеська область
17267,510049,827,2,443,431,12,510049,Одеська область
17268,510050,884,5,511,471,40,510050,Одеська область
17269,510051,939,6,512,488,24,510051,Одеська область
17270,510052,338,3,216,170,46,510052,Одеська область
17271,510053,518,4,311,292,19,510053,Одеська область
17272,510054,1100,17,651,561,90,510054,Одеська область
17273,510055,953,9,890,556,334,510055,Одеська область
17274,510056,773,7,667,400,267,510056,Одеська область
17275,510057,1431,17,775,693,82,510057,Одеська область
17276,510058,513,5,305,278,27,510058,Одеська область
17277,510059,1309,7,738,656,82,510059,Одеська область
17278,510060,418,3,226,206,20,510060,Одеська область
17279,510061,318,0,165,151,14,510061,Одеська область
17280,510062,723,3,401,358,43,510062,Одеська область
17281,510063,1683,11,911,856,55,510063,Одеська область
17282,510064,754,6,441,407,34,510064,Одеська область
17283,510065,1046,12,587,540,47,510065,Одеська область
17284,510066,762,15,417,406,11,510066,Одеська область
17285,510067,834,10,486,420,66,510067,Одеська область
17286,510068,794,19,569,426,143,510068,Одеська область
17287,510069,75,0,43,31,12,510069,Одеська область
17288,510283,2235,79,1035,980,55,510283,Одеська область
17289,510284,1592,23,829,795,34,510284,Одеська область
17290,510285,1291,20,663,645,18,510285,Одеська область
17291,510286,1364,15,772,735,37,510286,Одеська область
17292,510287,1259,14,624,591,33,510287,Одеська область
17293,510288,1276,17,673,641,32,510288,Одеська область
17294,510289,1390,23,686,660,26,510289,Одеська область
17295,510290,1418,26,679,656,23,510290,Одеська область
17296,510296,1426,6,710,680,30,510296,Одеська область
17297,510298,879,5,443,411,32,510298,Одеська область
17298,510299,1801,17,1008,979,29,510299,Одеська область
17299,510300,1634,30,972,952,20,510300,Одеська область
17300,510301,1697,11,570,555,15,510301,Одеська область
17301,510302,1743,13,650,638,12,510302,Одеська область
17302,510303,1893,26,1078,1007,71,510303,Одеська область
17303,510304,1413,19,718,698,20,510304,Одеська область
17304,510305,1017,1,557,536,21,510305,Одеська область
17305,510306,1102,10,515,503,12,510306,Одеська область
17306,510307,1134,7,516,501,15,510307,Одеська область
17307,510308,1535,33,1142,1080,62,510308,Одеська область
17308,510309,1426,27,1149,1085,64,510309,Одеська область
17309,510310,112,0,94,85,9,510310,Одеська область
17310,510311,1470,14,689,678,11,510311,Одеська область
17311,510312,1434,13,710,700,10,510312,Одеська область
17312,510313,956,6,500,468,32,510313,Одеська область
17313,510314,1716,6,931,897,34,510314,Одеська область
17314,510315,1623,9,726,696,30,510315,Одеська область
17315,510317,2212,27,1066,1057,9,510317,Одеська область
17316,510318,2213,31,1150,1133,17,510318,Одеська область
17317,510424,1442,11,812,714,98,510424,Одеська область
17318,510429,2108,16,957,860,97,510429,Одеська область
17319,510430,1144,17,593,568,25,510430,Одеська область
17320,510432,532,2,294,277,17,510432,Одеська область
17321,510433,950,12,460,408,52,510433,Одеська область
17322,510434,1002,11,479,447,32,510434,Одеська область
17323,510436,1980,22,1152,923,229,510436,Одеська область
17324,510437,1921,40,1055,823,232,510437,Одеська область
17325,510438,983,9,509,469,40,510438,Одеська область
17326,510781,639,3,366,347,19,510781,Одеська область
17327,510782,647,7,349,317,32,510782,Одеська область
17328,510783,386,4,196,153,43,510783,Одеська область
17329,510784,2072,20,1201,1111,90,510784,Одеська область
17330,510785,2026,12,1235,1147,88,510785,Одеська область
17331,510786,961,8,686,578,108,510786,Одеська область
17332,510787,220,4,164,145,19,510787,Одеська область
17333,510788,1317,14,912,872,40,510788,Одеська область
17334,510789,1446,20,862,832,30,510789,Одеська область
17335,510790,134,2,72,70,2,510790,Одеська область
17336,510791,1336,3,774,616,158,510791,Одеська область
17337,510792,988,11,432,389,43,510792,Одеська область
17338,510793,246,0,107,100,7,510793,Одеська область
17339,510794,446,5,242,208,34,510794,Одеська область
17340,510795,794,15,442,423,19,510795,Одеська область
17341,510796,229,1,129,117,12,510796,Одеська область
17342,510797,398,0,206,180,26,510797,Одеська область
17343,510798,571,3,287,264,23,510798,Одеська область
17344,510799,273,0,93,76,17,510799,Одеська область
17345,510800,864,2,522,496,26,510800,Одеська область
17346,510801,1349,16,717,673,44,510801,Одеська область
17347,510802,714,5,313,293,20,510802,Одеська область
17348,510803,644,5,345,313,32,510803,Одеська область
17349,510804,741,12,410,358,52,510804,Одеська область
17350,510805,627,3,343,308,35,510805,Одеська область
17351,510806,677,9,378,338,40,510806,Одеська область
17352,510807,727,6,428,352,76,510807,Одеська область
17353,510808,598,6,321,291,30,510808,Одеська область
17354,510809,1179,13,674,547,127,510809,Одеська область
17355,510810,623,6,376,312,64,510810,Одеська область
17356,510811,896,20,602,532,70,510811,Одеська область
17357,510812,1155,9,501,475,26,510812,Одеська область
17358,510813,1388,9,767,733,34,510813,Одеська область
17359,510814,1236,13,528,476,52,510814,Одеська область
17360,510815,273,4,135,124,11,510815,Одеська область
17361,510816,948,13,513,434,79,510816,Одеська область
17362,510818,1975,25,1077,932,145,510818,Одеська область
17363,510819,2203,25,1264,1052,212,510819,Одеська область
17364,510820,64,1,51,47,4,510820,Одеська область
17365,510821,1261,8,570,546,24,510821,Одеська область
17366,510822,1046,20,546,524,22,510822,Одеська область
17367,510823,1107,7,434,417,17,510823,Одеська область
17368,510824,638,8,277,258,19,510824,Одеська область
17369,510825,1074,8,590,564,26,510825,Одеська область
17370,510826,726,3,412,395,17,510826,Одеська область
17371,510827,1114,6,555,548,7,510827,Одеська область
17372,510828,379,6,198,186,12,510828,Одеська область
17373,510829,399,3,205,193,12,510829,Одеська область
17374,510830,560,4,307,292,15,510830,Одеська область
17375,510831,945,6,410,393,17,510831,Одеська область
17376,510832,963,6,483,433,50,510832,Одеська область
17377,510833,463,6,185,176,9,510833,Одеська область
17378,510834,219,2,118,115,3,510834,Одеська область
17379,510835,470,1,229,226,3,510835,Одеська область
17380,510836,870,8,343,328,15,510836,Одеська область
17381,510837,508,4,302,284,18,510837,Одеська область
17382,510838,1042,6,462,448,14,510838,Одеська область
17383,510839,1064,9,599,576,23,510839,Одеська область
17384,510840,413,6,318,297,21,510840,Одеська область
17385,510841,506,5,278,262,16,510841,Одеська область
17386,510842,185,0,104,73,31,510842,Одеська область
17387,510843,1129,16,482,442,40,510843,Одеська область
17388,510844,445,2,247,236,11,510844,Одеська область
17389,510845,170,1,87,81,6,510845,Одеська область
17390,510846,1087,11,451,446,5,510846,Одеська область
17391,510847,633,2,348,322,26,510847,Одеська область
17392,510848,305,3,145,137,8,510848,Одеська область
17393,510849,1321,11,589,577,12,510849,Одеська область
17394,510850,980,7,460,446,14,510850,Одеська область
17395,510851,239,1,156,146,10,510851,Одеська область
17396,510852,1288,12,585,566,19,510852,Одеська область
17397,510853,1528,22,790,759,31,510853,Одеська область
17398,510854,2047,28,1161,1085,76,510854,Одеська область
17399,510855,980,12,557,538,19,510855,Одеська область
17400,510856,654,4,358,353,5,510856,Одеська область
17401,510857,218,1,93,86,7,510857,Одеська область
17402,510858,819,6,464,443,21,510858,Одеська область
17403,510859,364,1,255,191,64,510859,Одеська область
17404,510860,15,0,14,13,1,510860,Одеська область
17405,1,30,0,29,13,16,1,Одеська область
17406,2,288,25,263,251,12,2,Одеська область
17407,5,12,0,12,12,0,5,Одеська область
17408,7,12,0,12,11,1,7,Одеська область
17409,9,12,0,12,11,1,9,Одеська область
17410,11,11,0,11,6,5,11,Одеська область
17411,12,13,0,13,13,0,12,Одеська область
17412,16,12,0,12,12,0,16,Одеська область
17413,17,9,0,9,9,0,17,Одеська область
17414,20,9,0,9,9,0,20,Одеська область
17415,23,8,1,7,7,0,23,Одеська область
17416,24,8,0,8,8,0,24,Одеська область
17417,27,12,0,12,11,1,27,Одеська область
17418,28,6,0,6,5,1,28,Одеська область
17419,30,12,0,12,11,1,30,Одеська область
17420,33,11,0,11,11,0,33,Одеська область
17421,34,8,1,7,7,0,34,Одеська область
17422,510291,876,4,482,468,14,510291,Одеська область
17423,510292,1315,9,769,719,50,510292,Одеська область
17424,510293,1379,6,759,712,47,510293,Одеська область
17425,510294,1449,9,783,769,14,510294,Одеська область
17426,510295,1556,17,864,855,9,510295,Одеська область
17427,510297,906,18,467,429,38,510297,Одеська область
17428,510316,1744,20,909,893,16,510316,Одеська область
17429,510380,1461,8,868,836,32,510380,Одеська область
17430,510381,1306,14,775,751,24,510381,Одеська область
17431,510382,1389,16,825,753,72,510382,Одеська область
17432,510383,1321,19,776,700,76,510383,Одеська область
17433,510384,1012,15,535,519,16,510384,Одеська область
17434,510385,1236,18,919,897,22,510385,Одеська область
17435,510386,1405,33,917,883,34,510386,Одеська область
17436,510387,2336,19,991,941,50,510387,Одеська область
17437,510388,1575,8,856,830,26,510388,Одеська область
17438,510389,1989,18,936,822,114,510389,Одеська область
17439,510390,1639,24,924,855,69,510390,Одеська область
17440,510391,1108,10,580,547,33,510391,Одеська область
17441,510392,1624,19,979,882,97,510392,Одеська область
17442,510393,710,2,411,344,67,510393,Одеська область
17443,510394,1401,8,836,798,38,510394,Одеська область
17444,510395,632,6,344,316,28,510395,Одеська область
17445,510396,1946,20,820,755,65,510396,Одеська область
17446,510397,2023,28,909,877,32,510397,Одеська область
17447,510398,1263,8,619,542,77,510398,Одеська область
17448,510399,2151,15,1177,1068,109,510399,Одеська область
17449,510400,2134,19,1195,1155,40,510400,Одеська область
17450,510401,406,7,265,254,11,510401,Одеська область
17451,510402,1737,13,898,857,41,510402,Одеська область
17452,510403,1423,17,728,693,35,510403,Одеська область
17453,510404,1239,6,747,726,21,510404,Одеська область
17454,510405,1715,15,1072,1016,56,510405,Одеська область
17455,510406,41,0,37,28,9,510406,Одеська область
17456,510707,1479,18,688,665,23,510707,Одеська область
17457,510708,1420,11,679,638,41,510708,Одеська область
17458,510709,1374,22,683,657,26,510709,Одеська область
17459,510710,1468,25,780,747,33,510710,Одеська область
17460,510711,1234,8,687,641,46,510711,Одеська область
17461,510712,1212,12,576,535,41,510712,Одеська область
17462,510713,1208,16,632,583,49,510713,Одеська область
17463,510714,1687,15,862,820,42,510714,Одеська область
17464,510715,1542,23,709,687,22,510715,Одеська область
17465,510716,1836,35,881,828,53,510716,Одеська область
17466,510717,1471,21,658,628,30,510717,Одеська область
17467,510718,1869,18,925,895,30,510718,Одеська область
17468,510719,1945,16,1020,986,34,510719,Одеська область
17469,510720,2303,19,933,874,59,510720,Одеська область
17470,510721,1798,24,959,881,78,510721,Одеська область
17471,510722,2405,37,1186,1149,37,510722,Одеська область
17472,510723,2176,14,1037,1008,29,510723,Одеська область
17473,510724,1340,16,677,657,20,510724,Одеська область
17474,510725,45,1,44,42,2,510725,Одеська область
17475,510726,58,0,55,50,5,510726,Одеська область
17476,510978,2312,42,1403,1244,159,510978,Одеська область
17477,510979,2231,38,1258,1141,117,510979,Одеська область
17478,510980,2232,33,1275,1173,102,510980,Одеська область
17479,510981,2204,31,1254,1161,93,510981,Одеська область
17480,510982,2061,16,1228,1152,76,510982,Одеська область
17481,510983,2093,38,1204,1100,104,510983,Одеська область
17482,510984,1976,27,1160,1071,89,510984,Одеська область
17483,510985,2181,38,1290,1173,117,510985,Одеська область
17484,510986,2204,33,1265,1167,98,510986,Одеська область
17485,510987,1839,29,1093,1001,92,510987,Одеська область
17486,510988,1826,28,1039,957,82,510988,Одеська область
17487,510989,2050,24,1192,1104,88,510989,Одеська область
17488,510990,2321,34,1404,1296,108,510990,Одеська область
17489,510991,2169,34,1293,1170,123,510991,Одеська область
17490,510992,2268,37,1311,1214,97,510992,Одеська область
17491,510993,1491,25,901,833,68,510993,Одеська область
17492,510994,2413,41,1419,1278,141,510994,Одеська область
17493,510995,1999,27,1200,1086,114,510995,Одеська область
17494,510996,1871,25,1171,1056,115,510996,Одеська область
17495,510997,2248,40,1330,1221,109,510997,Одеська область
17496,510998,2238,45,1380,1225,155,510998,Одеська область
17497,510999,2110,31,1297,1169,128,510999,Одеська область
17498,511000,1941,34,1184,1080,104,511000,Одеська область
17499,511001,2077,26,1249,1131,118,511001,Одеська область
17500,511002,2094,11,1241,1127,114,511002,Одеська область
17501,511003,2352,49,1435,1293,142,511003,Одеська область
17502,511004,2055,39,1204,1063,141,511004,Одеська область
17503,511005,1323,14,838,731,107,511005,Одеська область
17504,511006,22,0,21,18,3,511006,Одеська область
17505,511007,22,0,20,17,3,511007,Одеська область
17506,511008,16,0,15,10,5,511008,Одеська область
17507,511009,82,0,76,69,7,511009,Одеська область
17508,511010,18,0,17,14,3,511010,Одеська область
17509,511011,13,0,13,11,2,511011,Одеська область
17510,511012,29,0,29,24,5,511012,Одеська область
17511,511451,1960,9,488,451,37,511451,Одеська область
17512,531188,1575,36,1058,847,211,531188,Полтавська область
17513,531189,2171,46,1433,1167,266,531189,Полтавська область
17514,531190,2046,37,1364,1119,245,531190,Полтавська область
17515,531191,2137,49,1460,1221,239,531191,Полтавська область
17516,531192,1823,33,1216,1051,165,531192,Полтавська область
17517,531193,2133,39,1445,1182,263,531193,Полтавська область
17518,531194,1505,18,1000,839,161,531194,Полтавська область
17519,531195,1835,34,1136,966,170,531195,Полтавська область
17520,531196,1367,28,838,702,136,531196,Полтавська область
17521,531197,1328,26,832,702,130,531197,Полтавська область
17522,531198,2037,47,1329,1130,199,531198,Полтавська область
17523,531199,1646,17,972,856,116,531199,Полтавська область
17524,531200,1300,16,836,708,128,531200,Полтавська область
17525,531201,1521,13,998,850,148,531201,Полтавська область
17526,531202,2429,45,1603,1327,276,531202,Полтавська область
17527,531203,2427,59,1652,1344,308,531203,Полтавська область
17528,531204,2349,46,1629,1348,281,531204,Полтавська область
17529,531205,2407,42,1649,1318,331,531205,Полтавська область
17530,531206,2179,44,1485,1178,307,531206,Полтавська область
17531,531207,1684,26,1177,964,213,531207,Полтавська область
17532,531208,2263,43,1584,1300,284,531208,Полтавська область
17533,531209,1910,26,1282,1089,193,531209,Полтавська область
17534,531210,11,0,11,11,0,531210,Полтавська область
17535,531211,505,25,480,452,28,531211,Полтавська область
17536,531212,2251,34,1417,1106,311,531212,Полтавська область
17537,531213,1628,31,1030,814,216,531213,Полтавська область
17538,531214,1543,42,985,774,211,531214,Полтавська область
17539,531215,1307,29,848,667,181,531215,Полтавська область
17540,531216,2143,48,1308,1014,294,531216,Полтавська область
17541,531217,1428,11,602,556,46,531217,Полтавська область
17542,531218,2179,34,1385,1106,279,531218,Полтавська область
17543,531219,2059,42,1406,1093,313,531219,Полтавська область
17544,531220,1864,30,1199,975,224,531220,Полтавська область
17545,531221,1816,25,1098,917,181,531221,Полтавська область
17546,531222,1175,25,786,657,129,531222,Полтавська область
17547,531223,1988,46,1188,1018,170,531223,Полтавська область
17548,531224,2244,28,1416,1209,207,531224,Полтавська область
17549,531225,1866,35,1211,968,243,531225,Полтавська область
17550,531226,2113,38,1369,1161,208,531226,Полтавська область
17551,531227,1232,18,797,666,131,531227,Полтавська область
17552,531228,1957,17,1216,1018,198,531228,Полтавська область
17553,531229,2171,39,1453,1260,193,531229,Полтавська область
17554,531230,2066,25,1340,1098,242,531230,Полтавська область
17555,531231,671,5,424,357,67,531231,Полтавська область
17556,531232,2052,30,1325,1134,191,531232,Полтавська область
17557,531233,1916,35,1280,1072,208,531233,Полтавська область
17558,531234,2360,40,1570,1301,269,531234,Полтавська область
17559,531235,2441,45,1609,1363,246,531235,Полтавська область
17560,531236,2180,39,1532,1280,252,531236,Полтавська область
17561,531237,2290,49,1518,1253,265,531237,Полтавська область
17562,531238,1985,29,1355,1119,236,531238,Полтавська область
17563,531239,2135,41,1459,1229,230,531239,Полтавська область
17564,531240,2341,40,1640,1341,299,531240,Полтавська область
17565,531241,2481,40,1723,1396,327,531241,Полтавська область
17566,531242,2410,40,1644,1352,292,531242,Полтавська область
17567,531243,2225,33,1525,1278,247,531243,Полтавська область
17568,531244,2023,48,1301,1082,219,531244,Полтавська область
17569,531245,2168,39,1504,1249,255,531245,Полтавська область
17570,531246,2194,45,1487,1244,243,531246,Полтавська область
17571,531247,2239,51,1435,1197,238,531247,Полтавська область
17572,531248,2144,41,1352,1120,232,531248,Полтавська область
17573,531249,1859,56,1199,970,229,531249,Полтавська область
17574,531250,2173,30,1511,1271,240,531250,Полтавська область
17575,531251,1959,34,1286,1073,213,531251,Полтавська область
17576,531252,2255,24,1386,1178,208,531252,Полтавська область
17577,531253,2082,32,1399,1181,218,531253,Полтавська область
17578,531254,2267,40,1490,1229,261,531254,Полтавська область
17579,531255,563,19,391,321,70,531255,Полтавська область
17580,531256,2047,39,1376,1173,203,531256,Полтавська область
17581,531257,1915,42,1304,1089,215,531257,Полтавська область
17582,531258,2226,48,1426,1190,236,531258,Полтавська область
17583,531259,2328,46,1564,1301,263,531259,Полтавська область
17584,531260,2124,35,1461,1198,263,531260,Полтавська область
17585,531261,2109,34,1457,1172,285,531261,Полтавська область
17586,531262,2221,47,1505,1265,240,531262,Полтавська область
17587,531263,29,1,25,23,2,531263,Полтавська область
17588,531264,46,1,45,36,9,531264,Полтавська область
17589,531265,91,3,70,63,7,531265,Полтавська область
17590,531266,32,0,32,28,4,531266,Полтавська область
17591,531267,18,0,17,12,5,531267,Полтавська область
17592,531268,54,2,47,42,5,531268,Полтавська область
17593,531269,31,1,26,23,3,531269,Полтавська область
17594,531270,29,2,26,20,6,531270,Полтавська область
17595,531271,16,0,15,14,1,531271,Полтавська область
17596,531272,150,3,144,133,11,531272,Полтавська область
17597,1,678,46,628,598,30,1,Полтавська область
17598,530354,1496,19,941,784,157,530354,Полтавська область
17599,530355,646,11,405,340,65,530355,Полтавська область
17600,530356,698,13,443,378,65,530356,Полтавська область
17601,530357,954,13,522,448,74,530357,Полтавська область
17602,530358,1011,9,650,562,88,530358,Полтавська область
17603,530359,1407,10,894,803,91,530359,Полтавська область
17604,530360,1766,24,1040,875,165,530360,Полтавська область
17605,530361,1471,23,903,763,140,530361,Полтавська область
17606,530362,147,3,89,61,28,530362,Полтавська область
17607,530363,677,15,498,426,72,530363,Полтавська область
17608,530364,968,9,657,583,74,530364,Полтавська область
17609,530365,631,10,385,312,73,530365,Полтавська область
17610,530366,101,1,67,60,7,530366,Полтавська область
17611,530367,289,1,199,170,29,530367,Полтавська область
17612,530368,398,1,272,224,48,530368,Полтавська область
17613,530369,270,3,182,164,18,530369,Полтавська область
17614,530371,120,0,96,86,10,530371,Полтавська область
17615,530372,345,0,242,230,12,530372,Полтавська область
17616,530373,60,0,41,35,6,530373,Полтавська область
17617,530374,135,3,85,77,8,530374,Полтавська область
17618,530375,727,5,542,488,54,530375,Полтавська область
17619,530376,146,0,92,78,14,530376,Полтавська область
17620,530377,269,1,177,152,25,530377,Полтавська область
17621,530378,153,1,89,74,15,530378,Полтавська область
17622,530724,1287,15,835,721,114,530724,Полтавська область
17623,530725,489,7,350,304,46,530725,Полтавська область
17624,530726,346,5,229,177,52,530726,Полтавська область
17625,530727,476,6,287,232,55,530727,Полтавська область
17626,530728,573,8,354,310,44,530728,Полтавська область
17627,530729,2368,42,1464,1238,226,530729,Полтавська область
17628,530730,749,13,414,360,54,530730,Полтавська область
17629,530731,495,3,318,269,49,530731,Полтавська область
17630,530732,728,12,416,342,74,530732,Полтавська область
17631,530733,321,1,183,154,29,530733,Полтавська область
17632,530734,377,3,244,208,36,530734,Полтавська область
17633,530735,853,11,577,515,62,530735,Полтавська область
17634,530736,1233,12,726,652,74,530736,Полтавська область
17635,530737,1582,30,958,798,160,530737,Полтавська область
17636,530738,750,13,475,412,63,530738,Полтавська область
17637,530739,527,2,301,265,36,530739,Полтавська область
17638,530740,844,8,467,376,91,530740,Полтавська область
17639,530741,1082,22,635,519,116,530741,Полтавська область
17640,530742,895,11,549,475,74,530742,Полтавська область
17641,530743,1417,23,875,762,113,530743,Полтавська область
17642,530744,1351,10,848,735,113,530744,Полтавська область
17643,530745,1137,10,749,649,100,530745,Полтавська область
17644,530746,973,10,565,488,77,530746,Полтавська область
17645,530747,488,4,307,268,39,530747,Полтавська область
17646,530748,327,3,211,183,28,530748,Полтавська область
17647,530749,915,16,601,505,96,530749,Полтавська область
17648,530750,287,3,149,131,18,530750,Полтавська область
17649,530751,221,1,134,107,27,530751,Полтавська область
17650,530752,1377,28,859,722,137,530752,Полтавська область
17651,530753,180,2,113,95,18,530753,Полтавська область
17652,530754,675,6,422,374,48,530754,Полтавська область
17653,530755,1340,17,836,734,102,530755,Полтавська область
17654,530756,1056,12,695,597,98,530756,Полтавська область
17655,530757,1552,20,976,790,186,530757,Полтавська область
17656,530758,1960,22,1273,1023,250,530758,Полтавська область
17657,530759,657,5,432,375,57,530759,Полтавська область
17658,530760,546,4,360,316,44,530760,Полтавська область
17659,530761,1804,20,1111,971,140,530761,Полтавська область
17660,530762,837,7,478,404,74,530762,Полтавська область
17661,530763,1850,19,1227,1053,174,530763,Полтавська область
17662,530764,1865,17,1196,1015,181,530764,Полтавська область
17663,530765,874,16,611,537,74,530765,Полтавська область
17664,530766,307,1,192,172,20,530766,Полтавська область
17665,530767,233,4,115,94,21,530767,Полтавська область
17666,530768,505,1,336,269,67,530768,Полтавська область
17667,530769,500,4,316,272,44,530769,Полтавська область
17668,530770,965,15,656,554,102,530770,Полтавська область
17669,530771,1826,16,1207,1020,187,530771,Полтавська область
17670,530772,557,12,351,290,61,530772,Полтавська область
17671,530773,682,7,452,364,88,530773,Полтавська область
17672,530774,1852,31,1225,1016,209,530774,Полтавська область
17673,530775,2177,31,1408,1106,302,530775,Полтавська область
17674,530776,2260,25,1483,1188,295,530776,Полтавська область
17675,530777,257,6,251,224,27,530777,Полтавська область
17676,530778,239,5,234,215,19,530778,Полтавська область
17677,530779,99,3,94,87,7,530779,Полтавська область
17678,531138,2015,37,1209,969,240,531138,Полтавська область
17679,531139,1256,9,616,494,122,531139,Полтавська область
17680,531140,1432,16,736,628,108,531140,Полтавська область
17681,531141,1259,18,848,660,188,531141,Полтавська область
17682,531142,1961,42,1274,976,298,531142,Полтавська область
17683,531143,1968,25,1223,1039,184,531143,Полтавська область
17684,531144,1949,34,1282,1062,220,531144,Полтавська область
17685,531145,2140,34,1453,1215,238,531145,Полтавська область
17686,531146,2324,46,1508,1244,264,531146,Полтавська область
17687,531147,1995,26,1285,1061,224,531147,Полтавська область
17688,531148,2446,53,1646,1403,243,531148,Полтавська область
17689,531149,1910,31,1352,1063,289,531149,Полтавська область
17690,531150,2371,27,1487,1253,234,531150,Полтавська область
17691,531151,963,9,584,462,122,531151,Полтавська область
17692,531152,1219,17,766,674,92,531152,Полтавська область
17693,531153,1010,14,636,546,90,531153,Полтавська область
17694,531154,1948,30,1221,1046,175,531154,Полтавська область
17695,531155,1294,22,735,611,124,531155,Полтавська область
17696,531156,1972,32,1289,1072,217,531156,Полтавська область
17697,531157,2273,36,1392,1158,234,531157,Полтавська область
17698,531158,2092,42,1231,1010,221,531158,Полтавська область
17699,531159,2395,57,1591,1220,371,531159,Полтавська область
17700,531160,2099,22,1358,1107,251,531160,Полтавська область
17701,531161,2095,34,1343,1079,264,531161,Полтавська область
17702,531162,1901,41,1187,966,221,531162,Полтавська область
17703,531163,2202,52,1547,1260,287,531163,Полтавська область
17704,531164,2013,31,1319,1032,287,531164,Полтавська область
17705,531165,2328,28,1542,1304,238,531165,Полтавська область
17706,531166,2142,33,1456,1187,269,531166,Полтавська область
17707,531167,2272,51,1453,1221,232,531167,Полтавська область
17708,531168,2203,31,1411,1192,219,531168,Полтавська область
17709,531169,2047,32,1327,1135,192,531169,Полтавська область
17710,531170,1829,29,1121,869,252,531170,Полтавська область
17711,531171,2004,40,1291,1091,200,531171,Полтавська область
17712,531172,1988,33,1305,1105,200,531172,Полтавська область
17713,531173,2063,36,1344,1132,212,531173,Полтавська область
17714,531174,2161,45,1486,1212,274,531174,Полтавська область
17715,531175,2322,58,1433,1216,217,531175,Полтавська область
17716,531176,2125,38,1439,1197,242,531176,Полтавська область
17717,531177,1682,33,1097,909,188,531177,Полтавська область
17718,531178,2122,38,1348,1134,214,531178,Полтавська область
17719,531179,23,0,23,19,4,531179,Полтавська область
17720,531180,231,14,194,153,41,531180,Полтавська область
17721,531181,41,1,25,21,4,531181,Полтавська область
17722,531182,22,2,20,18,2,531182,Полтавська область
17723,531183,11,0,11,9,2,531183,Полтавська область
17724,531184,16,0,15,13,2,531184,Полтавська область
17725,531185,19,1,18,12,6,531185,Полтавська область
17726,531186,18,0,17,14,3,531186,Полтавська область
17727,531187,48,1,43,37,6,531187,Полтавська область
17728,531276,1369,17,817,681,136,531276,Полтавська область
17729,531278,1206,18,801,681,120,531278,Полтавська область
17730,531040,1724,20,989,795,194,531040,Полтавська область
17731,531041,1663,27,1055,824,231,531041,Полтавська область
17732,531042,1712,23,1087,821,266,531042,Полтавська область
17733,531043,1679,18,1083,826,257,531043,Полтавська область
17734,531044,1883,37,1215,940,275,531044,Полтавська область
17735,531045,1786,32,1191,914,277,531045,Полтавська область
17736,531046,1281,22,832,664,168,531046,Полтавська область
17737,531047,740,22,468,389,79,531047,Полтавська область
17738,531048,1516,27,1004,791,213,531048,Полтавська область
17739,531049,804,11,490,403,87,531049,Полтавська область
17740,531050,1952,29,1169,947,222,531050,Полтавська область
17741,531051,956,20,583,462,121,531051,Полтавська область
17742,531052,614,14,388,332,56,531052,Полтавська область
17743,531053,1671,26,1048,840,208,531053,Полтавська область
17744,531054,1637,32,1062,862,200,531054,Полтавська область
17745,531055,1987,27,1300,1079,221,531055,Полтавська область
17746,531056,2346,24,1614,1304,310,531056,Полтавська область
17747,531057,2159,37,1449,1143,306,531057,Полтавська область
17748,531058,2155,31,1463,1183,280,531058,Полтавська область
17749,531059,1738,23,1133,902,231,531059,Полтавська область
17750,531060,2288,35,1564,1275,289,531060,Полтавська область
17751,531061,2154,30,1413,1151,262,531061,Полтавська область
17752,531062,2299,19,1509,1249,260,531062,Полтавська область
17753,531063,2173,35,1463,1184,279,531063,Полтавська область
17754,531064,2004,35,1353,1076,277,531064,Полтавська область
17755,531065,1924,34,1203,964,239,531065,Полтавська область
17756,531066,1965,32,1239,998,241,531066,Полтавська область
17757,531067,1935,33,1281,1026,255,531067,Полтавська область
17758,531068,1835,25,1251,960,291,531068,Полтавська область
17759,531069,2046,26,1209,1029,180,531069,Полтавська область
17760,531070,2396,51,1517,1268,249,531070,Полтавська область
17761,531071,1914,25,1180,979,201,531071,Полтавська область
17762,531072,1862,25,1124,936,188,531072,Полтавська область
17763,531073,1793,35,1147,930,217,531073,Полтавська область
17764,531074,1109,18,667,559,108,531074,Полтавська область
17765,531075,1826,30,1193,988,205,531075,Полтавська область
17766,531076,1458,21,932,721,211,531076,Полтавська область
17767,531077,2020,19,1155,978,177,531077,Полтавська область
17768,531078,1716,27,1081,870,211,531078,Полтавська область
17769,531079,1349,27,875,725,150,531079,Полтавська область
17770,531080,2245,36,1400,1179,221,531080,Полтавська область
17771,531081,1959,28,1239,1031,208,531081,Полтавська область
17772,531082,2119,39,1450,1202,248,531082,Полтавська область
17773,531083,2257,31,1472,1205,267,531083,Полтавська область
17774,531084,2139,40,1456,1177,279,531084,Полтавська область
17775,531085,2128,27,1402,1134,268,531085,Полтавська область
17776,531099,66,0,53,47,6,531099,Полтавська область
17777,531100,31,2,29,24,5,531100,Полтавська область
17778,531101,1067,17,714,558,156,531101,Полтавська область
17779,531102,1063,13,678,543,135,531102,Полтавська область
17780,531103,1855,23,1185,955,230,531103,Полтавська область
17781,531104,1123,23,669,534,135,531104,Полтавська область
17782,531105,992,17,638,506,132,531105,Полтавська область
17783,531106,1122,25,712,549,163,531106,Полтавська область
17784,531107,1646,36,1081,852,229,531107,Полтавська область
17785,531108,1510,34,964,738,226,531108,Полтавська область
17786,531109,1441,13,919,759,160,531109,Полтавська область
17787,531110,1928,30,1275,1053,222,531110,Полтавська область
17788,531111,1540,27,988,824,164,531111,Полтавська область
17789,531112,2010,38,1343,1083,260,531112,Полтавська область
17790,531113,2004,25,1345,1133,212,531113,Полтавська область
17791,531114,662,9,399,335,64,531114,Полтавська область
17792,531115,989,4,547,481,66,531115,Полтавська область
17793,531116,1958,27,1238,1051,187,531116,Полтавська область
17794,531117,1730,27,1088,927,161,531117,Полтавська область
17795,531118,1364,26,819,682,137,531118,Полтавська область
17796,531119,1523,28,913,780,133,531119,Полтавська область
17797,531120,1445,25,797,692,105,531120,Полтавська область
17798,531121,1418,21,769,658,111,531121,Полтавська область
17799,531122,1382,15,827,702,125,531122,Полтавська область
17800,531123,1462,18,860,706,154,531123,Полтавська область
17801,531124,1572,25,949,810,139,531124,Полтавська область
17802,531125,1365,18,780,673,107,531125,Полтавська область
17803,531126,1419,25,824,678,146,531126,Полтавська область
17804,531127,1571,31,1043,859,184,531127,Полтавська область
17805,531128,2116,38,1370,1133,237,531128,Полтавська область
17806,531129,2207,44,1462,1190,272,531129,Полтавська область
17807,531130,1443,18,972,795,177,531130,Полтавська область
17808,531131,1284,29,807,669,138,531131,Полтавська область
17809,531132,1439,28,869,745,124,531132,Полтавська область
17810,531133,1450,24,901,758,143,531133,Полтавська область
17811,531134,1518,26,1009,864,145,531134,Полтавська область
17812,531135,1800,33,1136,936,200,531135,Полтавська область
17813,531136,113,7,106,102,4,531136,Полтавська область
17814,530177,1432,23,940,799,141,530177,Полтавська область
17815,530178,1462,24,946,796,150,530178,Полтавська область
17816,530179,1695,17,1108,961,147,530179,Полтавська область
17817,530180,2006,20,1293,1135,158,530180,Полтавська область
17818,530181,163,6,96,83,13,530181,Полтавська область
17819,530182,294,4,194,160,34,530182,Полтавська область
17820,530183,315,0,210,186,24,530183,Полтавська область
17821,530184,415,3,266,229,37,530184,Полтавська область
17822,530185,806,3,518,413,105,530185,Полтавська область
17823,530186,845,14,607,533,74,530186,Полтавська область
17824,530187,213,0,140,126,14,530187,Полтавська область
17825,530188,204,7,119,106,13,530188,Полтавська область
17826,530189,727,8,414,354,60,530189,Полтавська область
17827,530190,697,9,455,415,40,530190,Полтавська область
17828,530191,282,2,173,147,26,530191,Полтавська область
17829,530192,258,3,175,148,27,530192,Полтавська область
17830,530193,716,10,451,425,26,530193,Полтавська область
17831,530194,425,2,287,257,30,530194,Полтавська область
17832,530195,1813,26,1117,961,156,530195,Полтавська область
17833,530196,177,0,105,92,13,530196,Полтавська область
17834,530197,539,6,374,334,40,530197,Полтавська область
17835,530198,1948,23,1269,1088,181,530198,Полтавська область
17836,530199,1848,31,1232,1042,190,530199,Полтавська область
17837,530200,1656,32,1046,905,141,530200,Полтавська область
17838,530201,1471,14,967,850,117,530201,Полтавська область
17839,530202,596,9,385,341,44,530202,Полтавська область
17840,530203,183,2,145,119,26,530203,Полтавська область
17841,530204,289,5,169,143,26,530204,Полтавська область
17842,530205,1089,14,729,641,88,530205,Полтавська область
17843,530206,1160,20,778,692,86,530206,Полтавська область
17844,530207,1097,25,687,621,66,530207,Полтавська область
17845,530208,921,13,588,517,71,530208,Полтавська область
17846,530209,266,1,160,140,20,530209,Полтавська область
17847,530210,244,2,160,144,16,530210,Полтавська область
17848,530211,417,4,284,254,30,530211,Полтавська область
17849,530212,715,13,478,426,52,530212,Полтавська область
17850,530213,452,2,297,264,33,530213,Полтавська область
17851,530214,181,1,130,109,21,530214,Полтавська область
17852,530215,1164,8,829,767,62,530215,Полтавська область
17853,530216,306,0,236,214,22,530216,Полтавська область
17854,530217,644,6,479,444,35,530217,Полтавська область
17855,530218,136,0,80,68,12,530218,Полтавська область
17856,530219,393,9,251,229,22,530219,Полтавська область
17857,530220,436,2,292,267,25,530220,Полтавська область
17858,530221,838,15,540,492,48,530221,Полтавська область
17859,530222,379,4,230,204,26,530222,Полтавська область
17860,530223,135,0,79,75,4,530223,Полтавська область
17861,530224,371,3,271,232,39,530224,Полтавська область
17862,530225,323,2,229,208,21,530225,Полтавська область
17863,530226,237,11,162,150,12,530226,Полтавська область
17864,530227,367,2,202,178,24,530227,Полтавська область
17865,530228,89,0,62,51,11,530228,Полтавська область
17866,530229,408,6,298,259,39,530229,Полтавська область
17867,530230,125,1,91,82,9,530230,Полтавська область
17868,530231,625,6,408,364,44,530231,Полтавська область
17869,530232,219,3,150,140,10,530232,Полтавська область
17870,530233,608,10,421,355,66,530233,Полтавська область
17871,530234,267,1,163,130,33,530234,Полтавська область
17872,530235,621,4,389,346,43,530235,Полтавська область
17873,530236,723,15,440,373,67,530236,Полтавська область
17874,530237,853,13,613,568,45,530237,Полтавська область
17875,530238,403,9,281,256,25,530238,Полтавська область
17876,530239,455,4,306,271,35,530239,Полтавська область
17877,530240,556,9,365,336,29,530240,Полтавська область
17878,530241,549,4,341,290,51,530241,Полтавська область
17879,530242,218,4,162,148,14,530242,Полтавська область
17880,530560,702,8,451,402,49,530560,Полтавська область
17881,530561,435,3,296,244,52,530561,Полтавська область
17882,530562,685,7,458,386,72,530562,Полтавська область
17883,530563,1255,8,776,665,111,530563,Полтавська область
17884,530564,1390,11,793,674,119,530564,Полтавська область
17885,530565,307,0,202,177,25,530565,Полтавська область
17886,530566,1173,13,705,604,101,530566,Полтавська область
17887,530567,985,10,584,512,72,530567,Полтавська область
17888,530568,702,14,390,314,76,530568,Полтавська область
17889,530569,116,1,76,66,10,530569,Полтавська область
17890,530570,611,10,426,345,81,530570,Полтавська область
17891,530571,825,6,494,435,59,530571,Полтавська область
17892,530572,509,10,315,260,55,530572,Полтавська область
17893,530573,220,3,137,121,16,530573,Полтавська область
17894,530574,813,9,490,432,58,530574,Полтавська область
17895,530575,802,6,477,430,47,530575,Полтавська область
17896,530576,144,0,88,79,9,530576,Полтавська область
17897,530577,445,3,295,249,46,530577,Полтавська область
17898,530578,139,2,114,83,31,530578,Полтавська область
17899,530579,1199,9,772,673,99,530579,Полтавська область
17900,530580,459,3,310,280,30,530580,Полтавська область
17901,530581,1274,6,785,689,96,530581,Полтавська область
17902,530583,1968,29,1053,896,157,530583,Полтавська область
17903,530585,308,3,205,151,54,530585,Полтавська область
17904,530586,697,36,536,458,78,530586,Полтавська область
17905,530587,163,5,131,102,29,530587,Полтавська область
17906,530588,66,0,61,40,21,530588,Полтавська область
17907,530589,80,3,72,48,24,530589,Полтавська область
17908,530590,312,7,202,178,24,530590,Полтавська область
17909,530591,152,1,108,94,14,530591,Полтавська область
17910,530592,283,3,173,154,19,530592,Полтавська область
17911,530593,106,1,74,58,16,530593,Полтавська область
17912,530594,1358,15,711,580,131,530594,Полтавська область
17913,530595,163,2,111,91,20,530595,Полтавська область
17914,530596,318,2,208,161,47,530596,Полтавська область
17915,530597,343,8,223,171,52,530597,Полтавська область
17916,530598,274,1,203,151,52,530598,Полтавська область
17917,530599,439,2,240,213,27,530599,Полтавська область
17918,530600,111,0,75,62,13,530600,Полтавська область
17919,530601,556,8,298,260,38,530601,Полтавська область
17920,530602,795,7,444,384,60,530602,Полтавська область
17921,530603,257,3,177,152,25,530603,Полтавська область
17922,530604,286,2,199,179,20,530604,Полтавська область
17923,530780,1649,28,1038,878,160,530780,Полтавська область
17924,530781,1284,17,826,681,145,530781,Полтавська область
17925,530782,1483,26,962,818,144,530782,Полтавська область
17926,530783,1047,15,668,576,92,530783,Полтавська область
17927,530784,1150,12,761,657,104,530784,Полтавська область
17928,530785,311,4,196,181,15,530785,Полтавська область
17929,530786,821,15,539,453,86,530786,Полтавська область
17930,530787,309,5,225,201,24,530787,Полтавська область
17931,530788,198,0,126,98,28,530788,Полтавська область
17932,530789,610,4,370,337,33,530789,Полтавська область
17933,530790,287,1,147,126,21,530790,Полтавська область
17934,530791,975,14,620,553,67,530791,Полтавська область
17935,530792,829,7,570,525,45,530792,Полтавська область
17936,530793,222,1,145,131,14,530793,Полтавська область
17937,530794,370,3,260,221,39,530794,Полтавська область
17938,530795,147,6,100,78,22,530795,Полтавська область
17939,530796,486,1,287,244,43,530796,Полтавська область
17940,530797,387,1,245,209,36,530797,Полтавська область
17941,530798,365,7,255,232,23,530798,Полтавська область
17942,530799,399,3,283,238,45,530799,Полтавська область
17943,530800,380,6,260,226,34,530800,Полтавська область
17944,530801,195,2,133,101,32,530801,Полтавська область
17945,530802,313,6,231,206,25,530802,Полтавська область
17946,530803,188,2,143,136,7,530803,Полтавська область
17947,530804,391,7,261,214,47,530804,Полтавська область
17948,530805,262,5,189,159,30,530805,Полтавська область
17949,530806,502,3,300,251,49,530806,Полтавська область
17950,530807,775,5,432,360,72,530807,Полтавська область
17951,530808,378,4,246,221,25,530808,Полтавська область
17952,530809,570,4,347,310,37,530809,Полтавська область
17953,530810,505,8,314,266,48,530810,Полтавська область
17954,530811,696,1,444,366,78,530811,Полтавська область
17955,530812,483,3,298,273,25,530812,Полтавська область
17956,530813,222,2,155,130,25,530813,Полтавська область
17957,530814,362,5,258,219,39,530814,Полтавська область
17958,530815,298,2,220,188,32,530815,Полтавська область
17959,530816,307,4,225,208,17,530816,Полтавська область
17960,530817,242,7,167,143,24,530817,Полтавська область
17961,530960,1951,21,1273,1094,179,530960,Полтавська область
17962,530962,1935,19,1283,1080,203,530962,Полтавська область
17963,530964,261,2,192,170,22,530964,Полтавська область
17964,530965,276,6,209,180,29,530965,Полтавська область
17965,530966,404,1,280,263,17,530966,Полтавська область
17966,530967,356,3,241,222,19,530967,Полтавська область
17967,530968,456,3,308,285,23,530968,Полтавська область
17968,530969,607,3,413,364,49,530969,Полтавська область
17969,530970,258,1,168,149,19,530970,Полтавська область
17970,530971,721,7,487,428,59,530971,Полтавська область
17971,530972,765,8,491,438,53,530972,Полтавська область
17972,530973,476,6,319,284,35,530973,Полтавська область
17973,530974,530,1,381,336,45,530974,Полтавська область
17974,530975,452,7,264,235,29,530975,Полтавська область
17975,530976,385,4,255,217,38,530976,Полтавська область
17976,530977,778,8,494,432,62,530977,Полтавська область
17977,530978,549,6,335,302,33,530978,Полтавська область
17978,530979,1023,18,648,566,82,530979,Полтавська область
17979,530980,427,10,274,240,34,530980,Полтавська область
17980,530981,1795,28,1120,988,132,530981,Полтавська область
17981,530982,1489,14,974,853,121,530982,Полтавська область
17982,531022,1967,20,1283,1104,179,531022,Полтавська область
17983,531023,1404,22,892,766,126,531023,Полтавська область
17984,531024,1809,39,1165,1053,112,531024,Полтавська область
17985,531025,1810,26,1086,928,158,531025,Полтавська область
17986,531026,1847,42,1193,993,200,531026,Полтавська область
17987,531027,1678,30,1054,854,200,531027,Полтавська область
17988,531028,1759,35,1112,940,172,531028,Полтавська область
17989,531029,1805,25,1087,941,146,531029,Полтавська область
17990,531030,1832,26,1114,934,180,531030,Полтавська область
17991,531031,1953,34,1247,1064,183,531031,Полтавська область
17992,531032,1302,30,843,706,137,531032,Полтавська область
17993,531033,1685,28,988,896,92,531033,Полтавська область
17994,531034,1891,28,1270,1055,215,531034,Полтавська область
17995,531035,1677,16,1049,893,156,531035,Полтавська область
17996,531036,1825,24,1107,954,153,531036,Полтавська область
17997,531037,1418,21,846,724,122,531037,Полтавська область
17998,531038,1877,43,1155,962,193,531038,Полтавська область
17999,531039,1975,35,1188,994,194,531039,Полтавська область
18000,530001,2205,38,1350,1171,179,530001,Полтавська область
18001,530002,2032,22,1205,1043,162,530002,Полтавська область
18002,530003,315,2,182,170,12,530003,Полтавська область
18003,530004,333,3,210,181,29,530004,Полтавська область
18004,530005,282,3,192,164,28,530005,Полтавська область
18005,530006,162,2,102,80,22,530006,Полтавська область
18006,530007,288,1,188,143,45,530007,Полтавська область
18007,530008,133,4,88,73,15,530008,Полтавська область
18008,530009,196,1,129,93,36,530009,Полтавська область
18009,530010,1870,29,1151,1008,143,530010,Полтавська область
18010,530011,425,6,284,238,46,530011,Полтавська область
18011,530012,643,9,404,345,59,530012,Полтавська область
18012,530013,723,8,511,407,104,530013,Полтавська область
18013,530014,195,2,151,126,25,530014,Полтавська область
18014,530015,383,9,263,227,36,530015,Полтавська область
18015,530016,538,4,355,305,50,530016,Полтавська область
18016,530017,259,7,181,150,31,530017,Полтавська область
18017,530018,300,4,235,199,36,530018,Полтавська область
18018,530019,233,2,173,144,29,530019,Полтавська область
18019,530020,543,4,346,302,44,530020,Полтавська область
18020,530021,339,8,201,185,16,530021,Полтавська область
18021,530022,122,0,72,59,13,530022,Полтавська область
18022,530023,932,8,598,514,84,530023,Полтавська область
18023,530024,416,7,302,256,46,530024,Полтавська область
18024,530025,221,5,156,125,31,530025,Полтавська область
18025,530026,983,4,551,496,55,530026,Полтавська область
18026,530027,137,2,65,54,11,530027,Полтавська область
18027,530028,620,6,424,367,57,530028,Полтавська область
18028,530029,396,7,238,206,32,530029,Полтавська область
18029,530030,1430,18,854,744,110,530030,Полтавська область
18030,530031,136,2,106,89,17,530031,Полтавська область
18031,530032,252,0,202,185,17,530032,Полтавська область
18032,530033,121,3,104,91,13,530033,Полтавська область
18033,530034,488,8,332,294,38,530034,Полтавська область
18034,530035,246,5,156,134,22,530035,Полтавська область
18035,530474,1673,32,1082,950,132,530474,Полтавська область
18036,530475,1525,19,908,759,149,530475,Полтавська область
18037,530476,1122,17,680,589,91,530476,Полтавська область
18038,530477,861,15,568,480,88,530477,Полтавська область
18039,530478,239,1,123,107,16,530478,Полтавська область
18040,530479,486,7,330,290,40,530479,Полтавська область
18041,530480,575,9,373,297,76,530480,Полтавська область
18042,530481,373,7,255,228,27,530481,Полтавська область
18043,530482,447,2,287,230,57,530482,Полтавська область
18044,530483,1191,8,617,519,98,530483,Полтавська область
18045,530484,418,4,259,204,55,530484,Полтавська область
18046,530485,1002,9,540,482,58,530485,Полтавська область
18047,530486,216,1,128,108,20,530486,Полтавська область
18048,530487,127,4,83,65,18,530487,Полтавська область
18049,530489,686,13,395,308,87,530489,Полтавська область
18050,530490,415,8,248,197,51,530490,Полтавська область
18051,530491,1074,18,663,546,117,530491,Полтавська область
18052,530492,153,3,91,71,20,530492,Полтавська область
18053,530493,484,6,333,298,35,530493,Полтавська область
18054,530494,168,1,98,72,26,530494,Полтавська область
18055,530504,319,4,209,180,29,530504,Полтавська область
18056,530505,187,2,122,95,27,530505,Полтавська область
18057,530506,359,4,230,191,39,530506,Полтавська область
18058,530522,907,4,547,453,94,530522,Полтавська область
18059,530523,652,13,370,324,46,530523,Полтавська область
18060,530524,206,4,129,103,26,530524,Полтавська область
18061,530525,590,9,358,298,60,530525,Полтавська область
18062,530526,206,6,118,99,19,530526,Полтавська область
18063,530527,586,17,394,314,80,530527,Полтавська область
18064,530528,138,6,97,65,32,530528,Полтавська область
18065,530529,366,5,303,263,40,530529,Полтавська область
18066,530530,350,4,212,180,32,530530,Полтавська область
18067,530531,353,6,230,189,41,530531,Полтавська область
18068,530654,1872,31,1133,951,182,530654,Полтавська область
18069,530655,1159,26,667,522,145,530655,Полтавська область
18070,530656,224,1,169,124,45,530656,Полтавська область
18071,530657,1391,20,837,654,183,530657,Полтавська область
18072,530658,779,9,510,402,108,530658,Полтавська область
18073,530659,666,11,406,319,87,530659,Полтавська область
18074,530660,1001,15,612,519,93,530660,Полтавська область
18075,530661,307,2,208,161,47,530661,Полтавська область
18076,530662,439,4,261,219,42,530662,Полтавська область
18077,530663,629,12,462,362,100,530663,Полтавська область
18078,530664,963,8,584,448,136,530664,Полтавська область
18079,530665,221,2,131,98,33,530665,Полтавська область
18080,530666,136,4,88,72,16,530666,Полтавська область
18081,530667,159,1,107,86,21,530667,Полтавська область
18082,530668,66,0,41,26,15,530668,Полтавська область
18083,530669,994,21,605,512,93,530669,Полтавська область
18084,530670,864,9,503,447,56,530670,Полтавська область
18085,530671,379,3,267,203,64,530671,Полтавська область
18086,530672,154,0,102,78,24,530672,Полтавська область
18087,530673,623,4,387,322,65,530673,Полтавська область
18088,530674,477,7,298,247,51,530674,Полтавська область
18089,530675,229,3,150,137,13,530675,Полтавська область
18090,530676,408,3,248,185,63,530676,Полтавська область
18091,530677,546,6,400,318,82,530677,Полтавська область
18092,530678,602,10,437,350,87,530678,Полтавська область
18093,530679,536,8,365,332,33,530679,Полтавська область
18094,530680,450,4,271,206,65,530680,Полтавська область
18095,530681,518,4,400,332,68,530681,Полтавська область
18096,530682,516,2,345,256,89,530682,Полтавська область
18097,530683,174,1,127,114,13,530683,Полтавська область
18098,530684,187,0,140,126,14,530684,Полтавська область
18099,530685,721,9,468,393,75,530685,Полтавська область
18100,530686,234,5,153,122,31,530686,Полтавська область
18101,530687,504,10,326,264,62,530687,Полтавська область
18102,530818,678,12,430,337,93,530818,Полтавська область
18103,530819,431,5,253,197,56,530819,Полтавська область
18104,530820,494,6,308,223,85,530820,Полтавська область
18105,530821,337,5,216,168,48,530821,Полтавська область
18106,530822,733,11,396,336,60,530822,Полтавська область
18107,530823,790,21,497,414,83,530823,Полтавська область
18108,530824,619,11,356,279,77,530824,Полтавська область
18109,530825,457,10,266,211,55,530825,Полтавська область
18110,530826,76,3,46,36,10,530826,Полтавська область
18111,530827,93,1,51,44,7,530827,Полтавська область
18112,530828,342,3,275,235,40,530828,Полтавська область
18113,530829,116,0,93,79,14,530829,Полтавська область
18114,530830,439,5,247,182,65,530830,Полтавська область
18115,530831,154,3,121,104,17,530831,Полтавська область
18116,530832,425,4,252,176,76,530832,Полтавська область
18117,530833,692,6,429,356,73,530833,Полтавська область
18118,530834,224,5,162,109,53,530834,Полтавська область
18119,530835,198,4,126,102,24,530835,Полтавська область
18120,530836,313,12,193,150,43,530836,Полтавська область
18121,530837,111,5,71,56,15,530837,Полтавська область
18122,530839,946,7,578,434,144,530839,Полтавська область
18123,530840,510,4,307,216,91,530840,Полтавська область
18124,530841,178,1,109,77,32,530841,Полтавська область
18125,530842,521,3,342,277,65,530842,Полтавська область
18126,530843,178,0,113,84,29,530843,Полтавська область
18127,530844,454,11,266,206,60,530844,Полтавська область
18128,530845,149,2,101,86,15,530845,Полтавська область
18129,530846,296,2,184,137,47,530846,Полтавська область
18130,530847,313,3,218,196,22,530847,Полтавська область
18131,530848,120,0,97,88,9,530848,Полтавська область
18132,530849,518,7,305,221,84,530849,Полтавська область
18133,530850,190,4,122,100,22,530850,Полтавська область
18134,530851,178,6,148,108,40,530851,Полтавська область
18135,530852,265,2,158,115,43,530852,Полтавська область
18136,530853,451,2,273,220,53,530853,Полтавська область
18137,530854,314,6,192,154,38,530854,Полтавська область
18138,530855,142,2,72,46,26,530855,Полтавська область
18139,530856,229,0,137,111,26,530856,Полтавська область
18140,530857,133,1,103,72,31,530857,Полтавська область
18141,530858,261,3,187,149,38,530858,Полтавська область
18142,530859,1428,25,894,765,129,530859,Полтавська область
18143,530860,2175,27,1273,1079,194,530860,Полтавська область
18144,530861,1729,28,1105,925,180,530861,Полтавська область
18145,530862,25,0,22,18,4,530862,Полтавська область
18146,530863,1667,22,1116,923,193,530863,Полтавська область
18147,530864,1735,28,1115,950,165,530864,Полтавська область
18148,530865,1887,32,1212,1065,147,530865,Полтавська область
18149,530866,1217,14,755,639,116,530866,Полтавська область
18150,530867,1847,26,1188,992,196,530867,Полтавська область
18151,530868,1255,8,793,660,133,530868,Полтавська область
18152,530869,1099,20,640,548,92,530869,Полтавська область
18153,530870,559,6,328,280,48,530870,Полтавська область
18154,530871,206,4,163,134,29,530871,Полтавська область
18155,530872,302,2,204,164,40,530872,Полтавська область
18156,530873,481,3,326,271,55,530873,Полтавська область
18157,530874,1567,33,1008,841,167,530874,Полтавська область
18158,530875,79,1,73,60,13,530875,Полтавська область
18159,530876,83,3,49,37,12,530876,Полтавська область
18160,530877,127,0,101,81,20,530877,Полтавська область
18161,530878,321,4,190,176,14,530878,Полтавська область
18162,530879,682,4,433,371,62,530879,Полтавська область
18163,530880,361,2,229,199,30,530880,Полтавська область
18164,530881,511,6,371,310,61,530881,Полтавська область
18165,530882,265,3,187,168,19,530882,Полтавська область
18166,530883,679,6,445,385,60,530883,Полтавська область
18167,530884,430,4,273,232,41,530884,Полтавська область
18168,530885,723,7,486,398,88,530885,Полтавська область
18169,530886,377,2,281,236,45,530886,Полтавська область
18170,530887,280,5,194,173,21,530887,Полтавська область
18171,530888,158,1,121,106,15,530888,Полтавська область
18172,530889,323,2,231,195,36,530889,Полтавська область
18173,530890,408,9,305,270,35,530890,Полтавська область
18174,530891,318,2,256,227,29,530891,Полтавська область
18175,530892,938,19,586,491,95,530892,Полтавська область
18176,530893,355,4,249,210,39,530893,Полтавська область
18177,530894,329,5,228,180,48,530894,Полтавська область
18178,530895,74,1,64,45,19,530895,Полтавська область
18179,530896,193,0,156,123,33,530896,Полтавська область
18180,530897,256,2,127,107,20,530897,Полтавська область
18181,530898,371,3,246,198,48,530898,Полтавська область
18182,530899,145,0,118,104,14,530899,Полтавська область
18183,530900,481,3,324,252,72,530900,Полтавська область
18184,530901,157,0,87,69,18,530901,Полтавська область
18185,530902,451,5,296,255,41,530902,Полтавська область
18186,530903,552,6,355,292,63,530903,Полтавська область
18187,530904,163,1,141,107,34,530904,Полтавська область
18188,530905,947,9,545,472,73,530905,Полтавська область
18189,530906,173,3,124,89,35,530906,Полтавська область
18190,530907,105,1,71,56,15,530907,Полтавська область
18191,530908,467,7,302,260,42,530908,Полтавська область
18192,530909,295,3,167,121,46,530909,Полтавська область
18193,530910,210,3,140,121,19,530910,Полтавська область
18194,530911,158,2,80,68,12,530911,Полтавська область
18195,530912,382,7,261,225,36,530912,Полтавська область
18196,531002,1931,44,1276,1048,228,531002,Полтавська область
18197,531003,1893,30,1212,1046,166,531003,Полтавська область
18198,531004,1762,29,1109,925,184,531004,Полтавська область
18199,531005,1978,51,1276,1067,209,531005,Полтавська область
18200,531006,1801,28,1119,919,200,531006,Полтавська область
18201,531007,1901,36,1127,925,202,531007,Полтавська область
18202,531008,1873,32,1171,946,225,531008,Полтавська область
18203,531009,1784,37,1071,872,199,531009,Полтавська область
18204,531010,1816,23,1191,957,234,531010,Полтавська область
18205,531011,1962,36,1214,993,221,531011,Полтавська область
18206,531012,2070,32,1320,1101,219,531012,Полтавська область
18207,531013,1863,37,1153,949,204,531013,Полтавська область
18208,531014,1788,30,1106,916,190,531014,Полтавська область
18209,531015,1789,18,1070,909,161,531015,Полтавська область
18210,531016,1958,28,1171,1001,170,531016,Полтавська область
18211,531017,1805,30,1100,922,178,531017,Полтавська область
18212,531018,1946,29,1204,1017,187,531018,Полтавська область
18213,531019,1821,42,1136,932,204,531019,Полтавська область
18214,531020,1967,27,1167,964,203,531020,Полтавська область
18215,531021,1926,24,1179,1028,151,531021,Полтавська область
18216,530243,2083,29,1254,1063,191,530243,Полтавська область
18217,530244,1790,20,1078,929,149,530244,Полтавська область
18218,530245,2022,29,1156,992,164,530245,Полтавська область
18219,530246,1900,28,1000,863,137,530246,Полтавська область
18220,530247,2365,30,1307,1163,144,530247,Полтавська область
18221,530248,1558,11,808,722,86,530248,Полтавська область
18222,530249,1938,24,1111,996,115,530249,Полтавська область
18223,530250,921,7,566,501,65,530250,Полтавська область
18224,530251,922,11,456,405,51,530251,Полтавська область
18225,530252,1126,5,649,593,56,530252,Полтавська область
18226,530253,592,2,396,332,64,530253,Полтавська область
18227,530254,2264,18,1294,1205,89,530254,Полтавська область
18228,530255,355,1,241,182,59,530255,Полтавська область
18229,530256,577,5,369,333,36,530256,Полтавська область
18230,530257,1455,11,837,738,99,530257,Полтавська область
18231,530258,849,7,511,457,54,530258,Полтавська область
18232,530259,843,10,505,451,54,530259,Полтавська область
18233,530260,1024,10,550,483,67,530260,Полтавська область
18234,530261,658,6,411,365,46,530261,Полтавська область
18235,530262,889,3,504,460,44,530262,Полтавська область
18236,530263,381,5,262,222,40,530263,Полтавська область
18237,530264,1122,7,650,617,33,530264,Полтавська область
18238,530265,426,5,201,187,14,530265,Полтавська область
18239,530266,574,11,345,296,49,530266,Полтавська область
18240,530267,702,7,406,353,53,530267,Полтавська область
18241,530268,1412,17,863,780,83,530268,Полтавська область
18242,530269,777,5,449,402,47,530269,Полтавська область
18243,530270,476,4,298,267,31,530270,Полтавська область
18244,530271,255,2,193,155,38,530271,Полтавська область
18245,530272,452,5,260,232,28,530272,Полтавська область
18246,530273,563,3,391,345,46,530273,Полтавська область
18247,530274,1111,6,776,701,75,530274,Полтавська область
18248,530275,727,4,456,391,65,530275,Полтавська область
18249,530276,218,3,148,131,17,530276,Полтавська область
18250,530277,195,2,116,97,19,530277,Полтавська область
18251,530278,341,0,202,179,23,530278,Полтавська область
18252,530279,263,3,161,135,26,530279,Полтавська область
18253,530280,494,9,331,279,52,530280,Полтавська область
18254,530281,316,3,219,187,32,530281,Полтавська область
18255,530282,219,1,170,151,19,530282,Полтавська область
18256,530283,497,1,311,270,41,530283,Полтавська область
18257,530284,504,5,326,295,31,530284,Полтавська область
18258,530285,295,1,213,187,26,530285,Полтавська область
18259,530286,302,5,203,178,25,530286,Полтавська область
18260,530287,114,0,83,74,9,530287,Полтавська область
18261,530288,441,12,308,274,34,530288,Полтавська область
18262,530289,544,5,326,294,32,530289,Полтавська область
18263,530290,468,3,269,208,61,530290,Полтавська область
18264,530291,686,8,411,358,53,530291,Полтавська область
18265,530292,442,5,297,263,34,530292,Полтавська область
18266,530293,314,3,223,183,40,530293,Полтавська область
18267,530294,222,11,162,143,19,530294,Полтавська область
18268,530295,178,2,131,109,22,530295,Полтавська область
18269,530296,1580,7,1060,884,176,530296,Полтавська область
18270,530297,1240,12,777,684,93,530297,Полтавська область
18271,530298,1445,15,969,815,154,530298,Полтавська область
18272,530299,1436,23,957,822,135,530299,Полтавська область
18273,530300,1816,17,1178,1005,173,530300,Полтавська область
18274,530301,1338,24,846,699,147,530301,Полтавська область
18275,530302,418,17,292,247,45,530302,Полтавська область
18276,530303,218,3,193,155,38,530303,Полтавська область
18277,530304,200,0,186,134,52,530304,Полтавська область
18278,530305,697,11,471,391,80,530305,Полтавська область
18279,530306,698,9,395,358,37,530306,Полтавська область
18280,530307,323,3,209,177,32,530307,Полтавська область
18281,530308,87,1,58,48,10,530308,Полтавська область
18282,530309,412,3,296,276,20,530309,Полтавська область
18283,530310,425,4,257,214,43,530310,Полтавська область
18284,530311,847,12,472,401,71,530311,Полтавська область
18285,530312,310,5,150,116,34,530312,Полтавська область
18286,530313,1111,21,692,625,67,530313,Полтавська область
18287,530314,509,3,321,286,35,530314,Полтавська область
18288,530315,1164,9,685,607,78,530315,Полтавська область
18289,530316,2038,34,1131,989,142,530316,Полтавська область
18290,530317,107,0,70,52,18,530317,Полтавська область
18291,530318,217,2,140,107,33,530318,Полтавська область
18292,530319,462,20,247,202,45,530319,Полтавська область
18293,530320,344,7,220,193,27,530320,Полтавська область
18294,530321,467,7,319,291,28,530321,Полтавська область
18295,530322,460,4,281,198,83,530322,Полтавська область
18296,530323,519,3,346,317,29,530323,Полтавська область
18297,530324,149,0,106,91,15,530324,Полтавська область
18298,530325,47,1,29,26,3,530325,Полтавська область
18299,530326,1954,30,1191,957,234,530326,Полтавська область
18300,530327,1312,9,748,621,127,530327,Полтавська область
18301,530328,334,5,184,156,28,530328,Полтавська область
18302,530329,1202,8,689,543,146,530329,Полтавська область
18303,530330,1063,9,600,495,105,530330,Полтавська область
18304,530331,870,13,465,385,80,530331,Полтавська область
18305,530332,334,3,218,189,29,530332,Полтавська область
18306,530333,189,1,112,85,27,530333,Полтавська область
18307,530334,360,3,231,192,39,530334,Полтавська область
18308,530335,213,3,144,126,18,530335,Полтавська область
18309,530336,110,2,68,55,13,530336,Полтавська область
18310,530337,286,3,188,155,33,530337,Полтавська область
18311,530338,1360,16,817,691,126,530338,Полтавська область
18312,530339,314,5,195,147,48,530339,Полтавська область
18313,530340,517,4,327,249,78,530340,Полтавська область
18314,530341,262,1,154,115,39,530341,Полтавська область
18315,530342,390,7,268,213,55,530342,Полтавська область
18316,530343,161,3,95,85,10,530343,Полтавська область
18317,530344,501,2,304,215,89,530344,Полтавська область
18318,530345,474,5,275,196,79,530345,Полтавська область
18319,530346,552,9,327,278,49,530346,Полтавська область
18320,530347,465,4,313,276,37,530347,Полтавська область
18321,530348,267,4,187,116,71,530348,Полтавська область
18322,530349,295,2,162,142,20,530349,Полтавська область
18323,530350,701,2,384,318,66,530350,Полтавська область
18324,530351,582,12,354,256,98,530351,Полтавська область
18325,530352,93,4,56,38,18,530352,Полтавська область
18326,530353,475,4,277,226,51,530353,Полтавська область
18327,530532,1369,13,853,698,155,530532,Полтавська область
18328,530533,1659,28,1078,881,197,530533,Полтавська область
18329,530534,281,3,173,148,25,530534,Полтавська область
18330,530535,382,4,224,166,58,530535,Полтавська область
18331,530536,123,0,71,52,19,530536,Полтавська область
18332,530537,649,8,434,373,61,530537,Полтавська область
18333,530538,435,3,267,208,59,530538,Полтавська область
18334,530539,212,0,127,104,23,530539,Полтавська область
18335,530540,429,5,265,236,29,530540,Полтавська область
18336,530541,1480,14,976,891,85,530541,Полтавська область
18337,530542,188,3,120,103,17,530542,Полтавська область
18338,530543,988,3,567,516,51,530543,Полтавська область
18339,530544,369,3,272,249,23,530544,Полтавська область
18340,530545,849,6,568,501,67,530545,Полтавська область
18341,530546,118,0,86,75,11,530546,Полтавська область
18342,530547,132,2,97,78,19,530547,Полтавська область
18343,530548,139,0,111,90,21,530548,Полтавська область
18344,530549,385,2,254,228,26,530549,Полтавська область
18345,530550,194,2,112,102,10,530550,Полтавська область
18346,530551,340,2,250,222,28,530551,Полтавська область
18347,530552,691,4,442,392,50,530552,Полтавська область
18348,530553,488,10,241,189,52,530553,Полтавська область
18349,530554,1709,22,1049,919,130,530554,Полтавська область
18350,530555,795,6,506,451,55,530555,Полтавська область
18351,530556,199,1,124,112,12,530556,Полтавська область
18352,530557,210,3,118,94,24,530557,Полтавська область
18353,530558,224,0,138,117,21,530558,Полтавська область
18354,530559,121,5,112,107,5,530559,Полтавська область
18355,530605,1595,21,1018,854,164,530605,Полтавська область
18356,530606,798,7,507,420,87,530606,Полтавська область
18357,530607,1608,18,1026,880,146,530607,Полтавська область
18358,530608,1340,18,850,723,127,530608,Полтавська область
18359,530609,620,7,362,302,60,530609,Полтавська область
18360,530610,167,0,134,118,16,530610,Полтавська область
18361,530611,129,0,86,82,4,530611,Полтавська область
18362,530612,422,6,254,219,35,530612,Полтавська область
18363,530613,284,2,181,138,43,530613,Полтавська область
18364,530614,333,3,203,190,13,530614,Полтавська область
18365,530615,186,4,148,122,26,530615,Полтавська область
18366,530616,252,5,182,163,19,530616,Полтавська область
18367,530617,171,1,131,117,14,530617,Полтавська область
18368,530618,832,11,623,562,61,530618,Полтавська область
18369,530619,87,2,66,60,6,530619,Полтавська область
18370,530620,39,4,30,28,2,530620,Полтавська область
18371,530621,684,5,392,357,35,530621,Полтавська область
18372,530622,376,3,232,186,46,530622,Полтавська область
18373,530623,552,8,354,310,44,530623,Полтавська область
18374,530624,560,1,361,322,39,530624,Полтавська область
18375,530625,94,3,69,67,2,530625,Полтавська область
18376,530626,121,0,105,102,3,530626,Полтавська область
18377,530627,214,1,149,131,18,530627,Полтавська область
18378,530628,112,0,77,68,9,530628,Полтавська область
18379,530629,1128,17,716,633,83,530629,Полтавська область
18380,530630,330,3,227,192,35,530630,Полтавська область
18381,530631,370,3,233,199,34,530631,Полтавська область
18382,530632,780,7,543,481,62,530632,Полтавська область
18383,530633,1324,8,761,692,69,530633,Полтавська область
18384,530634,560,5,363,320,43,530634,Полтавська область
18385,530635,524,5,325,283,42,530635,Полтавська область
18386,530636,1565,15,980,886,94,530636,Полтавська область
18387,530637,427,7,274,222,52,530637,Полтавська область
18388,530638,370,2,223,198,25,530638,Полтавська область
18389,530639,485,3,316,259,57,530639,Полтавська область
18390,530640,218,1,127,109,18,530640,Полтавська область
18391,530641,1797,21,1091,1006,85,530641,Полтавська область
18392,530642,415,8,251,207,44,530642,Полтавська область
18393,530643,181,2,101,81,20,530643,Полтавська область
18394,530644,710,4,489,419,70,530644,Полтавська область
18395,530645,389,4,273,210,63,530645,Полтавська область
18396,530646,417,1,239,208,31,530646,Полтавська область
18397,530647,413,6,245,215,30,530647,Полтавська область
18398,530648,539,7,338,281,57,530648,Полтавська область
18399,530649,352,5,231,195,36,530649,Полтавська область
18400,530650,189,3,118,101,17,530650,Полтавська область
18401,530651,127,2,79,76,3,530651,Полтавська область
18402,530652,540,2,377,333,44,530652,Полтавська область
18403,530653,342,10,219,193,26,530653,Полтавська область
18404,530933,1582,16,909,810,99,530933,Полтавська область
18405,530934,1283,14,743,665,78,530934,Полтавська область
18406,530935,434,4,282,245,37,530935,Полтавська область
18407,530936,861,12,544,491,53,530936,Полтавська область
18408,530937,1463,17,907,785,122,530937,Полтавська область
18409,530938,1521,15,945,831,114,530938,Полтавська область
18410,530939,902,5,533,468,65,530939,Полтавська область
18411,530940,285,0,194,161,33,530940,Полтавська область
18412,530941,320,1,183,161,22,530941,Полтавська область
18413,530942,735,10,477,397,80,530942,Полтавська область
18414,530943,167,4,96,86,10,530943,Полтавська область
18415,530944,436,4,310,267,43,530944,Полтавська область
18416,530945,487,1,320,271,49,530945,Полтавська область
18417,530946,364,4,276,250,26,530946,Полтавська область
18418,530947,280,3,202,178,24,530947,Полтавська область
18419,530948,497,2,321,278,43,530948,Полтавська область
18420,530949,322,4,221,194,27,530949,Полтавська область
18421,530950,301,2,203,168,35,530950,Полтавська область
18422,530951,321,5,249,221,28,530951,Полтавська область
18423,530952,604,1,354,315,39,530952,Полтавська область
18424,530953,176,3,121,110,11,530953,Полтавська область
18425,530954,200,0,136,125,11,530954,Полтавська область
18426,530955,614,4,386,334,52,530955,Полтавська область
18427,530956,832,9,555,515,40,530956,Полтавська область
18428,530957,1155,11,675,610,65,530957,Полтавська область
18429,530958,627,5,402,363,39,530958,Полтавська область
18430,530959,612,9,380,343,37,530959,Полтавська область
18431,531273,96,0,53,46,7,531273,Полтавська область
18432,530089,1772,16,1026,881,145,530089,Полтавська область
18433,530090,1708,24,997,836,161,530090,Полтавська область
18434,530091,1928,25,1176,935,241,530091,Полтавська область
18435,530092,2244,35,1409,1106,303,530092,Полтавська область
18436,530093,1776,19,1014,862,152,530093,Полтавська область
18437,530094,365,2,231,176,55,530094,Полтавська область
18438,530095,470,2,250,200,50,530095,Полтавська область
18439,530096,1711,18,858,731,127,530096,Полтавська область
18440,530097,2115,23,1110,946,164,530097,Полтавська область
18441,530098,2280,33,1342,1117,225,530098,Полтавська область
18442,530099,586,8,365,289,76,530099,Полтавська область
18443,530100,506,6,312,248,64,530100,Полтавська область
18444,530101,362,11,221,177,44,530101,Полтавська область
18445,530102,1098,18,678,531,147,530102,Полтавська область
18446,530103,217,0,163,128,35,530103,Полтавська область
18447,530104,203,3,112,78,34,530104,Полтавська область
18448,530105,1085,7,645,561,84,530105,Полтавська область
18449,530106,566,6,361,305,56,530106,Полтавська область
18450,530107,589,4,411,358,53,530107,Полтавська область
18451,530108,672,6,404,321,83,530108,Полтавська область
18452,530109,393,2,308,285,23,530109,Полтавська область
18453,530110,367,2,254,208,46,530110,Полтавська область
18454,530111,143,2,99,80,19,530111,Полтавська область
18455,530112,354,4,237,157,80,530112,Полтавська область
18456,530113,340,7,232,190,42,530113,Полтавська область
18457,530114,236,5,171,144,27,530114,Полтавська область
18458,530115,472,3,306,265,41,530115,Полтавська область
18459,530116,618,7,373,338,35,530116,Полтавська область
18460,530117,1325,24,803,717,86,530117,Полтавська область
18461,530118,477,2,323,289,34,530118,Полтавська область
18462,530119,276,4,151,134,17,530119,Полтавська область
18463,530120,164,0,115,99,16,530120,Полтавська область
18464,530121,415,3,236,201,35,530121,Полтавська область
18465,530122,102,1,62,55,7,530122,Полтавська область
18466,530123,718,15,438,375,63,530123,Полтавська область
18467,530124,174,1,123,114,9,530124,Полтавська область
18468,530125,651,9,403,372,31,530125,Полтавська область
18469,530126,551,11,341,270,71,530126,Полтавська область
18470,530127,478,5,322,251,71,530127,Полтавська область
18471,530128,108,0,73,59,14,530128,Полтавська область
18472,530129,615,8,333,279,54,530129,Полтавська область
18473,530130,290,2,213,188,25,530130,Полтавська область
18474,530131,865,14,563,432,131,530131,Полтавська область
18475,530132,630,12,399,323,76,530132,Полтавська область
18476,530133,518,7,318,283,35,530133,Полтавська область
18477,530134,574,5,394,351,43,530134,Полтавська область
18478,530135,512,3,338,298,40,530135,Полтавська область
18479,530136,134,2,64,59,5,530136,Полтавська область
18480,530137,514,6,307,258,49,530137,Полтавська область
18481,530138,1048,11,591,524,67,530138,Полтавська область
18482,530139,1008,13,587,488,99,530139,Полтавська область
18483,530140,268,5,174,141,33,530140,Полтавська область
18484,530141,373,4,247,227,20,530141,Полтавська область
18485,530142,105,0,76,71,5,530142,Полтавська область
18486,530143,565,7,414,362,52,530143,Полтавська область
18487,530144,186,0,124,110,14,530144,Полтавська область
18488,530145,30,1,28,21,7,530145,Полтавська область
18489,530379,1899,24,1086,944,142,530379,Полтавська область
18490,530380,194,2,91,74,17,530380,Полтавська область
18491,530381,793,14,486,439,47,530381,Полтавська область
18492,530382,1530,17,904,761,143,530382,Полтавська область
18493,530383,589,5,297,237,60,530383,Полтавська область
18494,530384,769,9,461,369,92,530384,Полтавська область
18495,530385,366,4,219,186,33,530385,Полтавська область
18496,530386,240,0,156,134,22,530386,Полтавська область
18497,530387,504,7,283,237,46,530387,Полтавська область
18498,530388,1650,26,909,788,121,530388,Полтавська область
18499,530389,609,16,394,322,72,530389,Полтавська область
18500,530390,1687,15,934,825,109,530390,Полтавська область
18501,530391,990,6,518,423,95,530391,Полтавська область
18502,530392,294,4,158,124,34,530392,Полтавська область
18503,530393,318,6,214,184,30,530393,Полтавська область
18504,530394,465,2,322,272,50,530394,Полтавська область
18505,530395,651,9,368,325,43,530395,Полтавська область
18506,530396,149,2,104,82,22,530396,Полтавська область
18507,530397,1559,21,861,717,144,530397,Полтавська область
18508,530398,1351,15,796,640,156,530398,Полтавська область
18509,530399,145,0,111,85,26,530399,Полтавська область
18510,530400,1405,28,893,707,186,530400,Полтавська область
18511,530401,253,1,136,101,35,530401,Полтавська область
18512,530402,2213,33,1388,1097,291,530402,Полтавська область
18513,530403,1828,35,1143,926,217,530403,Полтавська область
18514,530404,1523,19,883,723,160,530404,Полтавська область
18515,530405,1391,22,837,698,139,530405,Полтавська область
18516,530406,1021,8,584,500,84,530406,Полтавська область
18517,530407,342,3,212,178,34,530407,Полтавська область
18518,530408,744,10,478,392,86,530408,Полтавська область
18519,530409,136,0,81,69,12,530409,Полтавська область
18520,530410,1171,16,708,616,92,530410,Полтавська область
18521,530411,350,5,257,231,26,530411,Полтавська область
18522,530412,1912,24,1109,910,199,530412,Полтавська область
18523,530413,1364,29,845,761,84,530413,Полтавська область
18524,530414,909,9,623,549,74,530414,Полтавська область
18525,530415,689,10,458,367,91,530415,Полтавська область
18526,530416,254,1,141,115,26,530416,Полтавська область
18527,530983,2478,30,1676,1459,217,530983,Полтавська область
18528,530984,1750,33,1067,949,118,530984,Полтавська область
18529,530985,1937,32,1278,1115,163,530985,Полтавська область
18530,530986,2028,25,1418,1245,173,530986,Полтавська область
18531,530987,1791,25,1276,1074,202,530987,Полтавська область
18532,530988,1901,22,1313,1151,162,530988,Полтавська область
18533,530989,2146,35,1467,1255,212,530989,Полтавська область
18534,530990,2171,21,1530,1332,198,530990,Полтавська область
18535,530991,2056,21,1407,1220,187,530991,Полтавська область
18536,530992,2007,38,1389,1207,182,530992,Полтавська область
18537,530993,2054,21,1442,1257,185,530993,Полтавська область
18538,530994,1800,19,1217,1059,158,530994,Полтавська область
18539,530995,1899,29,1290,1148,142,530995,Полтавська область
18540,530996,1963,24,1216,1074,142,530996,Полтавська область
18541,530997,1979,30,1381,1203,178,530997,Полтавська область
18542,530998,2122,31,1474,1283,191,530998,Полтавська область
18543,530999,1703,31,1219,1040,179,530999,Полтавська область
18544,531000,2108,27,1204,1029,175,531000,Полтавська область
18545,531086,2195,37,1470,1228,242,531086,Полтавська область
18546,531087,2100,28,1348,1090,258,531087,Полтавська область
18547,531088,1813,37,1184,972,212,531088,Полтавська область
18548,531089,2029,38,1375,1157,218,531089,Полтавська область
18549,531090,2014,30,1351,1121,230,531090,Полтавська область
18550,531091,2309,45,1607,1338,269,531091,Полтавська область
18551,531092,2259,27,1508,1263,245,531092,Полтавська область
18552,531093,2238,29,1474,1250,224,531093,Полтавська область
18553,531094,2265,40,1376,1163,213,531094,Полтавська область
18554,531095,2344,35,1467,1257,210,531095,Полтавська область
18555,531096,1651,20,1050,878,172,531096,Полтавська область
18556,531097,1838,25,1226,1048,178,531097,Полтавська область
18557,531098,2220,40,1461,1231,230,531098,Полтавська область
18558,531274,2047,29,1404,1190,214,531274,Полтавська область
18559,531275,1860,12,1313,1165,148,531275,Полтавська область
18560,530036,1574,22,1023,861,162,530036,Полтавська область
18561,530037,1032,11,607,514,93,530037,Полтавська область
18562,530038,1323,14,788,672,116,530038,Полтавська область
18563,530039,1538,20,953,841,112,530039,Полтавська область
18564,530040,1432,34,929,798,131,530040,Полтавська область
18565,530041,1593,24,1003,871,132,530041,Полтавська область
18566,530042,1639,34,1031,916,115,530042,Полтавська область
18567,530043,1894,27,1276,1114,162,530043,Полтавська область
18568,530044,1648,25,1009,846,163,530044,Полтавська область
18569,530045,928,18,541,465,76,530045,Полтавська область
18570,530046,1158,21,719,645,74,530046,Полтавська область
18571,530047,1011,13,679,585,94,530047,Полтавська область
18572,530048,882,8,578,494,84,530048,Полтавська область
18573,530049,879,10,590,543,47,530049,Полтавська область
18574,530050,241,2,237,211,26,530050,Полтавська область
18575,530051,497,10,358,297,61,530051,Полтавська область
18576,530052,628,5,407,359,48,530052,Полтавська область
18577,530053,954,9,596,545,51,530053,Полтавська область
18578,530054,329,4,183,158,25,530054,Полтавська область
18579,530055,1782,33,997,922,75,530055,Полтавська область
18580,530056,324,2,212,185,27,530056,Полтавська область
18581,530057,676,2,379,295,84,530057,Полтавська область
18582,530058,865,19,567,488,79,530058,Полтавська область
18583,530059,478,7,313,282,31,530059,Полтавська область
18584,530060,754,18,468,412,56,530060,Полтавська область
18585,530061,164,3,97,85,12,530061,Полтавська область
18586,530062,590,3,387,336,51,530062,Полтавська область
18587,530063,266,2,172,146,26,530063,Полтавська область
18588,530064,370,4,222,188,34,530064,Полтавська область
18589,530065,72,1,46,43,3,530065,Полтавська область
18590,530066,76,3,52,47,5,530066,Полтавська область
18591,530067,1158,6,710,651,59,530067,Полтавська область
18592,530068,1083,14,615,580,35,530068,Полтавська область
18593,530069,360,3,219,200,19,530069,Полтавська область
18594,530070,778,12,469,388,81,530070,Полтавська область
18595,530071,1089,13,626,574,52,530071,Полтавська область
18596,530072,791,9,491,443,48,530072,Полтавська область
18597,530073,608,8,385,329,56,530073,Полтавська область
18598,530074,1269,18,919,741,178,530074,Полтавська область
18599,530075,785,11,532,463,69,530075,Полтавська область
18600,530076,742,7,435,355,80,530076,Полтавська область
18601,530077,496,5,282,253,29,530077,Полтавська область
18602,530078,972,14,596,554,42,530078,Полтавська область
18603,530079,616,8,351,308,43,530079,Полтавська область
18604,530080,332,4,193,181,12,530080,Полтавська область
18605,530081,522,7,298,252,46,530081,Полтавська область
18606,530082,174,1,106,82,24,530082,Полтавська область
18607,530083,288,2,188,149,39,530083,Полтавська область
18608,530084,204,1,137,106,31,530084,Полтавська область
18609,530085,662,2,411,343,68,530085,Полтавська область
18610,530086,413,5,258,212,46,530086,Полтавська область
18611,530087,139,0,90,70,20,530087,Полтавська область
18612,530088,452,163,147,126,21,530088,Полтавська область
18613,530146,1109,12,653,543,110,530146,Полтавська область
18614,530147,469,6,258,219,39,530147,Полтавська область
18615,530148,925,19,552,457,95,530148,Полтавська область
18616,530149,1262,14,760,597,163,530149,Полтавська область
18617,530150,901,12,511,399,112,530150,Полтавська область
18618,530151,804,12,507,406,101,530151,Полтавська область
18619,530152,1188,19,729,586,143,530152,Полтавська область
18620,530153,1417,18,753,651,102,530153,Полтавська область
18621,530154,908,12,519,424,95,530154,Полтавська область
18622,530155,259,2,134,110,24,530155,Полтавська область
18623,530156,392,6,234,188,46,530156,Полтавська область
18624,530157,260,3,136,88,48,530157,Полтавська область
18625,530158,697,11,382,248,134,530158,Полтавська область
18626,530159,312,2,185,128,57,530159,Полтавська область
18627,530160,517,5,322,253,69,530160,Полтавська область
18628,530161,334,3,231,198,33,530161,Полтавська область
18629,530162,416,2,265,210,55,530162,Полтавська область
18630,530163,409,0,247,203,44,530163,Полтавська область
18631,530164,537,7,357,291,66,530164,Полтавська область
18632,530165,135,1,117,91,26,530165,Полтавська область
18633,530166,497,10,270,204,66,530166,Полтавська область
18634,530167,488,5,295,253,42,530167,Полтавська область
18635,530168,519,8,267,192,75,530168,Полтавська область
18636,530169,828,9,497,388,109,530169,Полтавська область
18637,530171,268,3,162,120,42,530171,Полтавська область
18638,530172,621,8,393,326,67,530172,Полтавська область
18639,530173,792,3,428,342,86,530173,Полтавська область
18640,530175,687,4,356,288,68,530175,Полтавська область
18641,530176,96,0,66,52,14,530176,Полтавська область
18642,530417,1377,25,832,687,145,530417,Полтавська область
18643,530418,1848,21,1146,931,215,530418,Полтавська область
18644,530419,2268,41,1422,1165,257,530419,Полтавська область
18645,530420,1899,21,1155,968,187,530420,Полтавська область
18646,530421,1298,19,797,640,157,530421,Полтавська область
18647,530422,325,3,223,192,31,530422,Полтавська область
18648,530423,1903,20,1152,954,198,530423,Полтавська область
18649,530424,1677,27,1011,860,151,530424,Полтавська область
18650,530426,2053,32,1200,991,209,530426,Полтавська область
18651,530427,527,10,335,283,52,530427,Полтавська область
18652,530428,504,4,304,237,67,530428,Полтавська область
18653,530429,143,2,87,60,27,530429,Полтавська область
18654,530430,241,3,145,115,30,530430,Полтавська область
18655,530431,297,4,173,112,61,530431,Полтавська область
18656,530432,686,8,373,273,100,530432,Полтавська область
18657,530433,199,0,133,110,23,530433,Полтавська область
18658,530434,254,5,160,143,17,530434,Полтавська область
18659,530435,230,2,156,133,23,530435,Полтавська область
18660,530436,256,7,149,127,22,530436,Полтавська область
18661,530437,95,3,57,38,19,530437,Полтавська область
18662,530438,803,5,457,408,49,530438,Полтавська область
18663,530439,759,10,443,368,75,530439,Полтавська область
18664,530440,233,2,130,97,33,530440,Полтавська область
18665,530441,240,1,144,116,28,530441,Полтавська область
18666,530444,680,7,441,377,64,530444,Полтавська область
18667,530445,451,3,279,225,54,530445,Полтавська область
18668,530446,119,2,71,60,11,530446,Полтавська область
18669,530447,444,7,270,227,43,530447,Полтавська область
18670,530448,220,0,159,139,20,530448,Полтавська область
18671,530449,133,2,77,59,18,530449,Полтавська область
18672,530450,497,4,284,245,39,530450,Полтавська область
18673,530452,347,3,196,160,36,530452,Полтавська область
18674,530453,529,3,303,238,65,530453,Полтавська область
18675,530454,368,6,225,179,46,530454,Полтавська область
18676,530455,282,3,185,143,42,530455,Полтавська область
18677,530456,781,7,468,397,71,530456,Полтавська область
18678,530457,829,8,439,384,55,530457,Полтавська область
18679,530458,194,1,87,55,32,530458,Полтавська область
18680,530459,592,4,382,296,86,530459,Полтавська область
18681,530460,408,7,263,216,47,530460,Полтавська область
18682,530461,358,5,232,205,27,530461,Полтавська область
18683,530462,62,0,49,34,15,530462,Полтавська область
18684,530463,161,4,96,79,17,530463,Полтавська область
18685,530464,873,10,541,464,77,530464,Полтавська область
18686,530465,679,7,420,360,60,530465,Полтавська область
18687,530466,434,10,279,230,49,530466,Полтавська область
18688,530467,161,2,111,90,21,530467,Полтавська область
18689,530468,968,8,670,560,110,530468,Полтавська область
18690,530469,331,8,224,196,28,530469,Полтавська область
18691,530470,358,6,212,168,44,530470,Полтавська область
18692,530471,173,2,110,92,18,530471,Полтавська область
18693,530472,767,3,530,462,68,530472,Полтавська область
18694,530473,93,0,71,62,9,530473,Полтавська область
18695,530495,589,5,347,284,63,530495,Полтавська область
18696,530496,590,8,429,361,68,530496,Полтавська область
18697,530497,106,6,63,49,14,530497,Полтавська область
18698,530498,207,4,138,110,28,530498,Полтавська область
18699,530499,132,1,81,69,12,530499,Полтавська область
18700,530500,589,2,352,272,80,530500,Полтавська область
18701,530501,326,3,164,120,44,530501,Полтавська область
18702,530502,184,3,120,93,27,530502,Полтавська область
18703,530503,114,3,76,61,15,530503,Полтавська область
18704,530507,741,8,473,373,100,530507,Полтавська область
18705,530508,419,4,294,257,37,530508,Полтавська область
18706,530509,117,1,52,46,6,530509,Полтавська область
18707,530510,105,1,67,48,19,530510,Полтавська область
18708,530511,839,9,571,460,111,530511,Полтавська область
18709,530512,524,5,315,258,57,530512,Полтавська область
18710,530513,305,2,179,149,30,530513,Полтавська область
18711,530514,185,4,118,100,18,530514,Полтавська область
18712,530515,253,1,144,116,28,530515,Полтавська область
18713,530516,212,3,143,105,38,530516,Полтавська область
18714,530517,370,5,220,179,41,530517,Полтавська область
18715,530518,227,2,163,119,44,530518,Полтавська область
18716,530520,258,4,185,161,24,530520,Полтавська область
18717,530521,212,2,145,109,36,530521,Полтавська область
18718,530689,927,14,582,450,132,530689,Полтавська область
18719,530690,331,1,241,219,22,530690,Полтавська область
18720,530691,199,2,157,120,37,530691,Полтавська область
18721,530692,177,1,99,78,21,530692,Полтавська область
18722,530693,237,0,173,152,21,530693,Полтавська область
18723,530694,1379,21,811,680,131,530694,Полтавська область
18724,530695,377,5,221,181,40,530695,Полтавська область
18725,530697,340,7,212,182,30,530697,Полтавська область
18726,530698,487,8,277,247,30,530698,Полтавська область
18727,530699,172,4,104,67,37,530699,Полтавська область
18728,530700,145,10,97,78,19,530700,Полтавська область
18729,530701,675,5,396,324,72,530701,Полтавська область
18730,530702,376,3,272,215,57,530702,Полтавська область
18731,530703,232,5,132,116,16,530703,Полтавська область
18732,530704,290,0,190,142,48,530704,Полтавська область
18733,530705,136,1,111,79,32,530705,Полтавська область
18734,530706,504,8,300,231,69,530706,Полтавська область
18735,530707,383,9,225,185,40,530707,Полтавська область
18736,530708,393,4,233,185,48,530708,Полтавська область
18737,530709,247,2,175,139,36,530709,Полтавська область
18738,530710,111,2,68,47,21,530710,Полтавська область
18739,530711,96,2,61,47,14,530711,Полтавська область
18740,530712,648,11,415,319,96,530712,Полтавська область
18741,530713,715,7,428,351,77,530713,Полтавська область
18742,530714,437,3,250,210,40,530714,Полтавська область
18743,530715,404,3,246,213,33,530715,Полтавська область
18744,530716,1808,25,1023,827,196,530716,Полтавська область
18745,530717,2054,27,1188,991,197,530717,Полтавська область
18746,530718,2260,31,1342,1093,249,530718,Полтавська область
18747,530719,2152,19,1296,1091,205,530719,Полтавська область
18748,530720,2345,28,1370,1135,235,530720,Полтавська область
18749,530722,2008,23,1182,973,209,530722,Полтавська область
18750,530723,630,6,326,261,65,530723,Полтавська область
18751,530913,303,3,186,162,24,530913,Полтавська область
18752,530914,257,1,163,125,38,530914,Полтавська область
18753,530915,718,12,441,362,79,530915,Полтавська область
18754,530916,171,2,109,94,15,530916,Полтавська область
18755,530917,256,2,174,148,26,530917,Полтавська область
18756,530918,618,4,328,261,67,530918,Полтавська область
18757,530919,322,3,211,179,32,530919,Полтавська область
18758,530920,562,1,344,291,53,530920,Полтавська область
18759,530921,577,6,325,270,55,530921,Полтавська область
18760,530922,313,1,195,154,41,530922,Полтавська область
18761,530923,375,2,205,177,28,530923,Полтавська область
18762,530924,245,2,149,123,26,530924,Полтавська область
18763,530925,439,9,275,211,64,530925,Полтавська область
18764,530926,300,1,191,159,32,530926,Полтавська область
18765,530927,259,5,171,102,69,530927,Полтавська область
18766,530928,180,0,112,81,31,530928,Полтавська область
18767,530929,703,11,401,329,72,530929,Полтавська область
18768,530930,332,3,208,165,43,530930,Полтавська область
18769,530931,983,12,574,461,113,530931,Полтавська область
18770,530932,1218,16,684,570,114,530932,Полтавська область
18771,531277,163,1,102,79,23,531277,Полтавська область
18772,1,331,33,298,266,32,1,Рівненська область
18773,560901,2120,43,1358,815,543,560901,Рівненська область
18774,560902,2070,35,1274,806,468,560902,Рівненська область
18775,560903,2097,41,1356,746,610,560903,Рівненська область
18776,560904,2015,26,1098,755,343,560904,Рівненська область
18777,560905,1690,31,1100,699,401,560905,Рівненська область
18778,560906,1592,30,1032,594,438,560906,Рівненська область
18779,560907,2202,39,1347,846,501,560907,Рівненська область
18780,560908,1826,41,1163,692,471,560908,Рівненська область
18781,560909,2189,34,1354,806,548,560909,Рівненська область
18782,560910,1889,38,1239,768,471,560910,Рівненська область
18783,560911,1241,21,694,437,257,560911,Рівненська область
18784,560912,2068,40,1259,745,514,560912,Рівненська область
18785,560913,2037,31,1184,715,469,560913,Рівненська область
18786,560915,2082,42,1361,799,562,560915,Рівненська область
18787,560916,1940,42,1160,750,410,560916,Рівненська область
18788,560917,2006,29,1269,779,490,560917,Рівненська область
18789,560918,2286,40,1416,877,539,560918,Рівненська область
18790,560919,2067,39,1248,745,503,560919,Рівненська область
18791,560920,2208,45,1343,776,567,560920,Рівненська область
18792,560921,1719,35,1099,656,443,560921,Рівненська область
18793,560922,1877,27,1184,755,429,560922,Рівненська область
18794,560923,2034,34,1294,809,485,560923,Рівненська область
18795,560924,1585,20,962,534,428,560924,Рівненська область
18796,560925,1880,23,1124,727,397,560925,Рівненська область
18797,560926,1036,38,668,410,258,560926,Рівненська область
18798,560927,1594,32,964,591,373,560927,Рівненська область
18799,560928,2196,33,1094,656,438,560928,Рівненська область
18800,560929,1806,44,1183,727,456,560929,Рівненська область
18801,560930,1695,35,1127,666,461,560930,Рівненська область
18802,560931,695,13,457,292,165,560931,Рівненська область
18803,560932,1478,28,915,512,403,560932,Рівненська область
18804,560933,2193,50,1412,851,561,560933,Рівненська область
18805,560934,2048,53,1393,782,611,560934,Рівненська область
18806,560935,1568,19,1005,634,371,560935,Рівненська область
18807,560936,1331,34,907,532,375,560936,Рівненська область
18808,560937,651,17,415,259,156,560937,Рівненська область
18809,560938,1132,16,718,438,280,560938,Рівненська область
18810,560939,2206,49,1401,863,538,560939,Рівненська область
18811,560940,1699,48,1159,646,513,560940,Рівненська область
18812,560941,1556,19,1019,620,399,560941,Рівненська область
18813,560942,1071,9,652,364,288,560942,Рівненська область
18814,560943,2330,53,1402,792,610,560943,Рівненська область
18815,560944,1886,21,791,547,244,560944,Рівненська область
18816,560945,2022,25,1024,598,426,560945,Рівненська область
18817,560946,1457,36,943,590,353,560946,Рівненська область
18818,560947,1964,41,1257,767,490,560947,Рівненська область
18819,560948,832,16,484,312,172,560948,Рівненська область
18820,560949,1915,41,1261,770,491,560949,Рівненська область
18821,560950,2286,38,1067,675,392,560950,Рівненська область
18822,560951,2453,67,1511,809,702,560951,Рівненська область
18823,560952,1943,31,1271,755,516,560952,Рівненська область
18824,560953,1859,34,1143,706,437,560953,Рівненська область
18825,560954,1621,25,895,570,325,560954,Рівненська область
18826,560955,1815,17,1128,662,466,560955,Рівненська область
18827,560956,2231,48,1396,835,561,560956,Рівненська область
18828,560957,1946,34,1157,696,461,560957,Рівненська область
18829,560958,976,20,651,409,242,560958,Рівненська область
18830,560959,662,13,377,234,143,560959,Рівненська область
18831,560960,1765,31,1026,673,353,560960,Рівненська область
18832,560961,2110,40,1369,838,531,560961,Рівненська область
18833,560962,2387,28,1581,914,667,560962,Рівненська область
18834,560963,2147,39,1380,881,499,560963,Рівненська область
18835,560964,1630,40,928,528,400,560964,Рівненська область
18836,560965,1866,40,1135,696,439,560965,Рівненська область
18837,560966,1835,34,1205,698,507,560966,Рівненська область
18838,560967,2230,48,1423,766,657,560967,Рівненська область
18839,560968,1613,39,1111,619,492,560968,Рівненська область
18840,560969,1339,18,519,344,175,560969,Рівненська область
18841,560970,909,12,398,227,171,560970,Рівненська область
18842,560971,2044,55,1301,712,589,560971,Рівненська область
18843,560972,1512,27,966,541,425,560972,Рівненська область
18844,560973,2084,36,1435,832,603,560973,Рівненська область
18845,560974,2195,47,1379,799,580,560974,Рівненська область
18846,560984,2090,34,1340,866,474,560984,Рівненська область
18847,560985,1361,38,812,508,304,560985,Рівненська область
18848,560986,2085,36,1324,816,508,560986,Рівненська область
18849,560987,2078,37,1332,828,504,560987,Рівненська область
18850,560988,1871,41,1123,687,436,560988,Рівненська область
18851,560989,2105,41,1319,740,579,560989,Рівненська область
18852,560990,1003,11,646,378,268,560990,Рівненська область
18853,560991,1980,43,1268,740,528,560991,Рівненська область
18854,560992,2018,39,1205,725,480,560992,Рівненська область
18855,560993,2270,50,1461,848,613,560993,Рівненська область
18856,560994,2414,39,1351,814,537,560994,Рівненська область
18857,560995,19,0,18,9,9,560995,Рівненська область
18858,560996,49,1,44,24,20,560996,Рівненська область
18859,560997,74,4,62,38,24,560997,Рівненська область
18860,560998,56,3,52,34,18,560998,Рівненська область
18861,560999,18,1,16,12,4,560999,Рівненська область
18862,561000,164,6,143,82,61,561000,Рівненська область
18863,561001,41,1,39,27,12,561001,Рівненська область
18864,561002,167,9,156,103,53,561002,Рівненська область
18865,561003,1169,16,687,439,248,561003,Рівненська область
18866,561004,1614,37,1009,586,423,561004,Рівненська область
18867,561005,1597,22,1064,658,406,561005,Рівненська область
18868,561006,1585,31,1025,641,384,561006,Рівненська область
18869,561007,1066,24,688,376,312,561007,Рівненська область
18870,561011,1562,35,1035,540,495,561011,Рівненська область
18871,561013,787,17,513,307,206,561013,Рівненська область
18872,560105,2075,25,1260,702,558,560105,Рівненська область
18873,560106,1785,33,1041,607,434,560106,Рівненська область
18874,560107,1762,28,998,593,405,560107,Рівненська область
18875,560108,210,0,124,89,35,560108,Рівненська область
18876,560109,739,8,366,234,132,560109,Рівненська область
18877,560110,1352,15,689,396,293,560110,Рівненська область
18878,560111,298,3,204,97,107,560111,Рівненська область
18879,560112,320,2,172,123,49,560112,Рівненська область
18880,560113,522,5,308,118,190,560113,Рівненська область
18881,560114,503,11,334,174,160,560114,Рівненська область
18882,560115,1447,15,787,542,245,560115,Рівненська область
18883,560116,485,5,293,171,122,560116,Рівненська область
18884,560117,386,10,281,118,163,560117,Рівненська область
18885,560118,382,12,264,141,123,560118,Рівненська область
18886,560119,121,7,83,36,47,560119,Рівненська область
18887,560120,373,6,226,112,114,560120,Рівненська область
18888,560121,293,4,221,139,82,560121,Рівненська область
18889,560122,236,3,166,83,83,560122,Рівненська область
18890,560123,161,0,125,66,59,560123,Рівненська область
18891,560124,166,4,119,65,54,560124,Рівненська область
18892,560125,469,12,326,191,135,560125,Рівненська область
18893,560126,242,6,144,76,68,560126,Рівненська область
18894,560127,368,1,232,132,100,560127,Рівненська область
18895,560128,424,5,268,172,96,560128,Рівненська область
18896,560129,154,2,110,73,37,560129,Рівненська область
18897,560130,357,1,225,154,71,560130,Рівненська область
18898,560131,840,3,534,281,253,560131,Рівненська область
18899,560132,388,1,196,117,79,560132,Рівненська область
18900,560133,236,3,152,56,96,560133,Рівненська область
18901,560134,291,1,164,79,85,560134,Рівненська область
18902,560135,385,6,229,105,124,560135,Рівненська область
18903,560136,433,4,259,86,173,560136,Рівненська область
18904,560137,116,4,82,49,33,560137,Рівненська область
18905,560138,302,5,167,101,66,560138,Рівненська область
18906,560139,119,0,87,50,37,560139,Рівненська область
18907,560140,255,3,178,71,107,560140,Рівненська область
18908,560141,216,0,142,75,67,560141,Рівненська область
18909,560142,323,3,184,108,76,560142,Рівненська область
18910,560143,209,0,129,68,61,560143,Рівненська область
18911,560144,451,9,263,143,120,560144,Рівненська область
18912,560145,129,1,81,47,34,560145,Рівненська область
18913,560146,515,11,319,188,131,560146,Рівненська область
18914,560147,273,0,185,98,87,560147,Рівненська область
18915,560148,349,6,188,127,61,560148,Рівненська область
18916,560149,121,1,69,48,21,560149,Рівненська область
18917,560150,918,13,590,363,227,560150,Рівненська область
18918,560151,742,18,462,277,185,560151,Рівненська область
18919,560152,609,13,327,177,150,560152,Рівненська область
18920,560153,275,3,178,85,93,560153,Рівненська область
18921,560154,1707,41,918,552,366,560154,Рівненська область
18922,560155,196,1,137,73,64,560155,Рівненська область
18923,560156,466,5,318,175,143,560156,Рівненська область
18924,560403,2197,48,1188,823,365,560403,Рівненська область
18925,560404,1943,31,1130,736,394,560404,Рівненська область
18926,560405,1887,26,979,626,353,560405,Рівненська область
18927,560406,299,2,176,137,39,560406,Рівненська область
18928,560407,429,5,289,185,104,560407,Рівненська область
18929,560408,393,9,223,132,91,560408,Рівненська область
18930,560409,612,16,353,225,128,560409,Рівненська область
18931,560410,380,5,215,150,65,560410,Рівненська область
18932,560411,110,1,86,50,36,560411,Рівненська область
18933,560412,1456,16,827,559,268,560412,Рівненська область
18934,560413,353,10,217,138,79,560413,Рівненська область
18935,560414,304,4,179,111,68,560414,Рівненська область
18936,560415,172,2,124,84,40,560415,Рівненська область
18937,560416,820,4,433,297,136,560416,Рівненська область
18938,560417,854,12,522,323,199,560417,Рівненська область
18939,560418,380,2,202,108,94,560418,Рівненська область
18940,560419,487,8,289,188,101,560419,Рівненська область
18941,560420,626,9,356,253,103,560420,Рівненська область
18942,560421,509,6,235,161,74,560421,Рівненська область
18943,560422,320,2,191,88,103,560422,Рівненська область
18944,560423,487,5,257,220,37,560423,Рівненська область
18945,560424,336,11,227,128,99,560424,Рівненська область
18946,560425,1022,6,560,390,170,560425,Рівненська область
18947,560426,1042,11,652,379,273,560426,Рівненська область
18948,560427,924,4,478,369,109,560427,Рівненська область
18949,560428,643,2,362,211,151,560428,Рівненська область
18950,560429,123,0,85,34,51,560429,Рівненська область
18951,560430,1760,14,964,663,301,560430,Рівненська область
18952,560431,588,13,332,178,154,560431,Рівненська область
18953,560432,431,3,267,147,120,560432,Рівненська область
18954,560433,300,2,147,95,52,560433,Рівненська область
18955,560434,245,4,123,97,26,560434,Рівненська область
18956,560435,418,5,311,194,117,560435,Рівненська область
18957,560436,519,10,295,215,80,560436,Рівненська область
18958,560437,115,0,74,53,21,560437,Рівненська область
18959,560438,397,4,214,134,80,560438,Рівненська область
18960,560439,417,7,275,150,125,560439,Рівненська область
18961,560440,471,3,270,114,156,560440,Рівненська область
18962,560441,94,0,70,27,43,560441,Рівненська область
18963,560442,120,3,52,30,22,560442,Рівненська область
18964,560443,250,3,168,92,76,560443,Рівненська область
18965,560444,523,3,268,175,93,560444,Рівненська область
18966,560445,286,5,151,95,56,560445,Рівненська область
18967,560569,476,4,256,154,102,560569,Рівненська область
18968,560570,199,0,126,78,48,560570,Рівненська область
18969,560571,283,3,180,95,85,560571,Рівненська область
18970,560572,128,0,79,34,45,560572,Рівненська область
18971,560573,1218,16,713,478,235,560573,Рівненська область
18972,560574,248,2,175,85,90,560574,Рівненська область
18973,560575,394,4,238,142,96,560575,Рівненська область
18974,560576,498,4,296,157,139,560576,Рівненська область
18975,560577,784,12,430,235,195,560577,Рівненська область
18976,560578,544,12,312,178,134,560578,Рівненська область
18977,560579,329,7,213,85,128,560579,Рівненська область
18978,560580,354,6,221,112,109,560580,Рівненська область
18979,560581,126,1,83,40,43,560581,Рівненська область
18980,560582,1141,16,632,398,234,560582,Рівненська область
18981,560583,403,6,219,154,65,560583,Рівненська область
18982,560584,417,7,260,152,108,560584,Рівненська область
18983,560585,1239,15,648,296,352,560585,Рівненська область
18984,560586,782,8,459,230,229,560586,Рівненська область
18985,560587,260,0,172,80,92,560587,Рівненська область
18986,560588,245,4,145,69,76,560588,Рівненська область
18987,560589,448,4,270,156,114,560589,Рівненська область
18988,560590,294,1,175,137,38,560590,Рівненська область
18989,560591,194,1,127,88,39,560591,Рівненська область
18990,560592,244,5,141,85,56,560592,Рівненська область
18991,560593,1501,18,792,425,367,560593,Рівненська область
18992,560594,651,5,352,223,129,560594,Рівненська область
18993,560595,982,12,550,338,212,560595,Рівненська область
18994,560596,247,1,140,81,59,560596,Рівненська область
18995,560597,356,8,180,125,55,560597,Рівненська область
18996,560598,425,6,263,97,166,560598,Рівненська область
18997,560599,890,11,469,186,283,560599,Рівненська область
18998,560600,357,2,235,136,99,560600,Рівненська область
18999,560601,833,9,521,304,217,560601,Рівненська область
19000,560602,414,7,280,166,114,560602,Рівненська область
19001,560603,187,1,122,30,92,560603,Рівненська область
19002,560604,256,5,143,70,73,560604,Рівненська область
19003,560605,111,2,85,51,34,560605,Рівненська область
19004,560606,785,10,430,271,159,560606,Рівненська область
19005,560607,974,8,509,349,160,560607,Рівненська область
19006,560608,654,6,354,211,143,560608,Рівненська область
19007,560655,2398,30,1425,871,554,560655,Рівненська область
19008,560656,635,5,406,225,181,560656,Рівненська область
19009,560657,291,3,167,102,65,560657,Рівненська область
19010,560658,736,7,385,236,149,560658,Рівненська область
19011,560659,267,4,159,95,64,560659,Рівненська область
19012,560660,89,0,38,17,21,560660,Рівненська область
19013,560661,1232,13,775,489,286,560661,Рівненська область
19014,560662,428,7,267,156,111,560662,Рівненська область
19015,560663,992,15,709,354,355,560663,Рівненська область
19016,560664,1805,29,999,588,411,560664,Рівненська область
19017,560665,859,19,616,356,260,560665,Рівненська область
19018,560666,888,12,496,352,144,560666,Рівненська область
19019,560667,170,0,111,42,69,560667,Рівненська область
19020,560668,75,1,48,24,24,560668,Рівненська область
19021,560669,1822,31,1161,646,515,560669,Рівненська область
19022,560670,2304,52,1370,791,579,560670,Рівненська область
19023,560671,1378,17,889,505,384,560671,Рівненська область
19024,560672,60,0,43,24,19,560672,Рівненська область
19025,560673,175,4,120,82,38,560673,Рівненська область
19026,560674,204,1,137,93,44,560674,Рівненська область
19027,560675,738,9,438,266,172,560675,Рівненська область
19028,560676,189,6,118,64,54,560676,Рівненська область
19029,560677,167,1,79,49,30,560677,Рівненська область
19030,560678,1092,17,727,403,324,560678,Рівненська область
19031,560679,256,4,178,130,48,560679,Рівненська область
19032,560680,829,10,523,256,267,560680,Рівненська область
19033,560681,438,7,264,127,137,560681,Рівненська область
19034,560682,1077,23,660,405,255,560682,Рівненська область
19035,560683,430,5,257,171,86,560683,Рівненська область
19036,560684,993,13,583,379,204,560684,Рівненська область
19037,560685,915,15,570,323,247,560685,Рівненська область
19038,560686,562,9,337,197,140,560686,Рівненська область
19039,560687,1961,39,1112,734,378,560687,Рівненська область
19040,560688,2267,38,1372,891,481,560688,Рівненська область
19041,560689,757,16,419,279,140,560689,Рівненська область
19042,560690,275,6,175,93,82,560690,Рівненська область
19043,560691,2085,36,1230,691,539,560691,Рівненська область
19044,560692,1758,41,1031,502,529,560692,Рівненська область
19045,560693,1313,20,867,450,417,560693,Рівненська область
19046,560694,389,12,243,158,85,560694,Рівненська область
19047,560695,1124,16,615,359,256,560695,Рівненська область
19048,560696,842,6,464,264,200,560696,Рівненська область
19049,560697,260,1,155,103,52,560697,Рівненська область
19050,560698,441,8,275,178,97,560698,Рівненська область
19051,560699,84,1,48,27,21,560699,Рівненська область
19052,560700,759,9,504,300,204,560700,Рівненська область
19053,560701,748,32,408,264,144,560701,Рівненська область
19054,560702,183,2,129,89,40,560702,Рівненська область
19055,560703,1928,32,1142,722,420,560703,Рівненська область
19056,560704,466,5,279,156,123,560704,Рівненська область
19057,560705,2259,32,1288,750,538,560705,Рівненська область
19058,560706,1147,16,598,387,211,560706,Рівненська область
19059,560707,266,3,187,102,85,560707,Рівненська область
19060,560708,341,1,180,109,71,560708,Рівненська область
19061,560709,269,1,181,115,66,560709,Рівненська область
19062,560710,413,3,228,125,103,560710,Рівненська область
19063,560711,95,1,79,47,32,560711,Рівненська область
19064,560712,708,7,385,237,148,560712,Рівненська область
19065,560713,1409,25,821,463,358,560713,Рівненська область
19066,560714,347,8,235,153,82,560714,Рівненська область
19067,560715,208,1,138,83,55,560715,Рівненська область
19068,560716,175,1,110,73,37,560716,Рівненська область
19069,560717,512,8,307,195,112,560717,Рівненська область
19070,560718,2376,35,1297,801,496,560718,Рівненська область
19071,560719,844,11,524,278,246,560719,Рівненська область
19072,560720,2033,18,1201,702,499,560720,Рівненська область
19073,560721,728,8,419,232,187,560721,Рівненська область
19074,560722,2062,21,1164,842,322,560722,Рівненська область
19075,560723,2222,28,1300,867,433,560723,Рівненська область
19076,560724,1621,20,890,572,318,560724,Рівненська область
19077,560725,2079,37,1316,824,492,560725,Рівненська область
19078,560726,1639,29,1004,631,373,560726,Рівненська область
19079,560727,1857,23,1204,732,472,560727,Рівненська область
19080,560728,1459,17,875,502,373,560728,Рівненська область
19081,560729,1855,16,1086,596,490,560729,Рівненська область
19082,560730,108,3,98,54,44,560730,Рівненська область
19083,560731,22,0,22,13,9,560731,Рівненська область
19084,560732,408,34,373,333,40,560732,Рівненська область
19085,560733,272,12,260,234,26,560733,Рівненська область
19086,560894,1667,24,1004,606,398,560894,Рівненська область
19087,560895,1702,34,971,597,374,560895,Рівненська область
19088,560896,1698,28,920,532,388,560896,Рівненська область
19089,560897,1740,33,1016,566,450,560897,Рівненська область
19090,560898,1302,25,770,521,249,560898,Рівненська область
19091,560899,1717,18,1008,706,302,560899,Рівненська область
19092,560900,163,10,142,84,58,560900,Рівненська область
19093,560975,2172,56,1395,808,587,560975,Рівненська область
19094,560976,2011,49,1313,784,529,560976,Рівненська область
19095,560977,1903,42,1234,732,502,560977,Рівненська область
19096,560978,1600,34,1045,597,448,560978,Рівненська область
19097,560979,2006,43,1240,726,514,560979,Рівненська область
19098,560980,1509,36,905,588,317,560980,Рівненська область
19099,560981,1563,29,967,584,383,560981,Рівненська область
19100,560982,1836,36,1084,679,405,560982,Рівненська область
19101,560983,1282,19,708,465,243,560983,Рівненська область
19102,561009,675,5,416,281,135,561009,Рівненська область
19103,561014,479,7,321,198,123,561014,Рівненська область
19104,560157,680,7,435,248,187,560157,Рівненська область
19105,560158,570,2,345,239,106,560158,Рівненська область
19106,560159,1292,32,809,466,343,560159,Рівненська область
19107,560160,716,13,472,309,163,560160,Рівненська область
19108,560161,403,5,265,135,130,560161,Рівненська область
19109,560162,247,5,146,73,73,560162,Рівненська область
19110,560163,934,9,577,374,203,560163,Рівненська область
19111,560164,524,7,381,177,204,560164,Рівненська область
19112,560165,253,3,149,72,77,560165,Рівненська область
19113,560166,714,8,475,247,228,560166,Рівненська область
19114,560167,213,1,154,71,83,560167,Рівненська область
19115,560168,576,5,396,247,149,560168,Рівненська область
19116,560169,102,2,63,39,24,560169,Рівненська область
19117,560170,124,2,83,40,43,560170,Рівненська область
19118,560171,318,3,189,81,108,560171,Рівненська область
19119,560172,746,10,473,276,197,560172,Рівненська область
19120,560173,283,2,198,117,81,560173,Рівненська область
19121,560174,296,2,186,93,93,560174,Рівненська область
19122,560175,330,2,224,142,82,560175,Рівненська область
19123,560176,726,9,471,271,200,560176,Рівненська область
19124,560177,225,1,133,73,60,560177,Рівненська область
19125,560178,587,17,291,189,102,560178,Рівненська область
19126,560179,280,7,175,100,75,560179,Рівненська область
19127,560180,644,9,459,262,197,560180,Рівненська область
19128,560181,622,10,448,283,165,560181,Рівненська область
19129,560182,1650,22,1004,634,370,560182,Рівненська область
19130,560183,1250,19,791,560,231,560183,Рівненська область
19131,560184,821,9,519,367,152,560184,Рівненська область
19132,560185,513,11,339,226,113,560185,Рівненська область
19133,560186,125,2,100,59,41,560186,Рівненська область
19134,560187,642,11,375,228,147,560187,Рівненська область
19135,560188,124,1,75,44,31,560188,Рівненська область
19136,560189,277,2,196,140,56,560189,Рівненська область
19137,560190,880,12,533,336,197,560190,Рівненська область
19138,560191,231,4,146,99,47,560191,Рівненська область
19139,560192,180,2,109,40,69,560192,Рівненська область
19140,560193,292,4,191,85,106,560193,Рівненська область
19141,560194,760,4,390,244,146,560194,Рівненська область
19142,560195,409,6,277,146,131,560195,Рівненська область
19143,560196,175,0,111,38,73,560196,Рівненська область
19144,560197,340,1,202,135,67,560197,Рівненська область
19145,560198,251,11,179,71,108,560198,Рівненська область
19146,560199,119,3,78,53,25,560199,Рівненська область
19147,560200,366,1,212,129,83,560200,Рівненська область
19148,560201,177,3,120,85,35,560201,Рівненська область
19149,560202,457,7,308,195,113,560202,Рівненська область
19150,560203,273,4,179,127,52,560203,Рівненська область
19151,560204,286,7,223,155,68,560204,Рівненська область
19152,560205,351,8,253,123,130,560205,Рівненська область
19153,560206,1890,29,1163,705,458,560206,Рівненська область
19154,560207,173,2,134,82,52,560207,Рівненська область
19155,560208,212,2,159,105,54,560208,Рівненська область
19156,560209,527,6,326,204,122,560209,Рівненська область
19157,560210,432,12,274,141,133,560210,Рівненська область
19158,560211,273,2,181,93,88,560211,Рівненська область
19159,560212,458,4,297,163,134,560212,Рівненська область
19160,560213,443,4,259,133,126,560213,Рівненська область
19161,560214,224,9,156,72,84,560214,Рівненська область
19162,560215,462,17,287,190,97,560215,Рівненська область
19163,560216,311,3,232,114,118,560216,Рівненська область
19164,560217,676,8,455,288,167,560217,Рівненська область
19165,560218,340,6,198,112,86,560218,Рівненська область
19166,560219,1182,10,710,419,291,560219,Рівненська область
19167,560220,103,3,61,22,39,560220,Рівненська область
19168,560221,199,2,152,57,95,560221,Рівненська область
19169,560222,358,6,267,180,87,560222,Рівненська область
19170,560223,447,5,291,206,85,560223,Рівненська область
19171,560224,284,3,178,102,76,560224,Рівненська область
19172,560225,752,5,589,289,300,560225,Рівненська область
19173,560226,1332,15,902,516,386,560226,Рівненська область
19174,560227,114,0,65,47,18,560227,Рівненська область
19175,560228,330,0,195,110,85,560228,Рівненська область
19176,560229,159,0,124,62,62,560229,Рівненська область
19177,560230,550,6,344,211,133,560230,Рівненська область
19178,560231,247,3,186,123,63,560231,Рівненська область
19179,560232,270,3,176,115,61,560232,Рівненська область
19180,560233,141,5,96,68,28,560233,Рівненська область
19181,560234,557,9,342,165,177,560234,Рівненська область
19182,560235,252,8,147,77,70,560235,Рівненська область
19183,560236,2184,39,1291,692,599,560236,Рівненська область
19184,560237,152,3,95,43,52,560237,Рівненська область
19185,560238,389,5,262,135,127,560238,Рівненська область
19186,560239,124,3,74,45,29,560239,Рівненська область
19187,560240,683,13,447,310,137,560240,Рівненська область
19188,560241,172,2,117,80,37,560241,Рівненська область
19189,560242,1293,11,806,492,314,560242,Рівненська область
19190,560243,444,7,265,162,103,560243,Рівненська область
19191,560244,816,46,446,234,212,560244,Рівненська область
19192,560245,715,11,479,307,172,560245,Рівненська область
19193,560246,527,6,298,150,148,560246,Рівненська область
19194,560247,34,1,30,16,14,560247,Рівненська область
19195,560346,1967,39,1223,759,464,560346,Рівненська область
19196,560347,1802,34,1071,646,425,560347,Рівненська область
19197,560348,2072,37,1243,783,460,560348,Рівненська область
19198,560349,1922,39,1102,634,468,560349,Рівненська область
19199,560350,2248,52,1325,842,483,560350,Рівненська область
19200,560351,1277,17,677,467,210,560351,Рівненська область
19201,560352,1252,19,765,494,271,560352,Рівненська область
19202,560353,1689,20,1028,704,324,560353,Рівненська область
19203,560354,1074,30,645,380,265,560354,Рівненська область
19204,560355,1222,20,746,412,334,560355,Рівненська область
19205,560356,2246,40,1329,781,548,560356,Рівненська область
19206,560357,1411,25,728,507,221,560357,Рівненська область
19207,560358,1322,12,737,476,261,560358,Рівненська область
19208,560359,277,1,150,98,52,560359,Рівненська область
19209,560360,845,17,394,266,128,560360,Рівненська область
19210,560361,1025,14,601,353,248,560361,Рівненська область
19211,560362,1162,20,674,428,246,560362,Рівненська область
19212,560363,347,6,197,118,79,560363,Рівненська область
19213,560364,485,4,302,188,114,560364,Рівненська область
19214,560365,76,1,49,20,29,560365,Рівненська область
19215,560366,128,1,71,39,32,560366,Рівненська область
19216,560367,582,9,360,183,177,560367,Рівненська область
19217,560368,128,1,81,53,28,560368,Рівненська область
19218,560369,1368,15,750,515,235,560369,Рівненська область
19219,560370,690,4,406,197,209,560370,Рівненська область
19220,560371,599,12,382,209,173,560371,Рівненська область
19221,560372,1258,16,743,444,299,560372,Рівненська область
19222,560373,1299,14,755,419,336,560373,Рівненська область
19223,560374,1490,11,828,487,341,560374,Рівненська область
19224,560375,606,6,371,237,134,560375,Рівненська область
19225,560376,713,10,434,284,150,560376,Рівненська область
19226,560377,137,0,91,48,43,560377,Рівненська область
19227,560378,399,4,339,161,178,560378,Рівненська область
19228,560379,75,0,70,26,44,560379,Рівненська область
19229,560380,387,7,255,164,91,560380,Рівненська область
19230,560381,248,4,128,78,50,560381,Рівненська область
19231,560382,218,7,104,83,21,560382,Рівненська область
19232,560383,751,9,459,261,198,560383,Рівненська область
19233,560384,497,5,348,194,154,560384,Рівненська область
19234,560385,347,9,216,106,110,560385,Рівненська область
19235,560386,250,2,145,83,62,560386,Рівненська область
19236,560387,245,4,151,78,73,560387,Рівненська область
19237,560388,453,9,307,171,136,560388,Рівненська область
19238,560389,510,0,286,168,118,560389,Рівненська область
19239,560390,365,3,197,121,76,560390,Рівненська область
19240,560391,269,2,153,84,69,560391,Рівненська область
19241,560392,286,2,185,112,73,560392,Рівненська область
19242,560393,572,6,425,253,172,560393,Рівненська область
19243,560394,843,8,422,245,177,560394,Рівненська область
19244,560395,625,4,345,179,166,560395,Рівненська область
19245,560396,341,3,204,125,79,560396,Рівненська область
19246,560397,767,14,378,219,159,560397,Рівненська область
19247,560398,110,0,58,39,19,560398,Рівненська область
19248,560399,202,3,134,95,39,560399,Рівненська область
19249,560400,37,0,35,23,12,560400,Рівненська область
19250,560518,2054,32,1217,757,460,560518,Рівненська область
19251,560519,2022,38,1232,721,511,560519,Рівненська область
19252,560520,2262,41,1380,818,562,560520,Рівненська область
19253,560521,613,13,355,187,168,560521,Рівненська область
19254,560522,319,2,229,168,61,560522,Рівненська область
19255,560523,1120,12,682,409,273,560523,Рівненська область
19256,560524,515,1,327,202,125,560524,Рівненська область
19257,560525,626,8,450,296,154,560525,Рівненська область
19258,560526,444,10,288,198,90,560526,Рівненська область
19259,560527,495,2,255,114,141,560527,Рівненська область
19260,560528,192,1,108,67,41,560528,Рівненська область
19261,560529,397,8,251,181,70,560529,Рівненська область
19262,560530,203,3,136,52,84,560530,Рівненська область
19263,560531,729,17,400,215,185,560531,Рівненська область
19264,560532,396,5,229,139,90,560532,Рівненська область
19265,560533,291,3,160,95,65,560533,Рівненська область
19266,560534,624,9,385,222,163,560534,Рівненська область
19267,560535,228,1,154,98,56,560535,Рівненська область
19268,560536,420,7,270,185,85,560536,Рівненська область
19269,560537,123,1,79,44,35,560537,Рівненська область
19270,560538,471,4,307,191,116,560538,Рівненська область
19271,560539,119,0,75,37,38,560539,Рівненська область
19272,560540,141,3,89,47,42,560540,Рівненська область
19273,560541,311,3,202,118,84,560541,Рівненська область
19274,560542,788,4,469,250,219,560542,Рівненська область
19275,560544,1173,16,713,414,299,560544,Рівненська область
19276,560545,1211,16,723,412,311,560545,Рівненська область
19277,560546,243,0,167,72,95,560546,Рівненська область
19278,560547,409,1,236,143,93,560547,Рівненська область
19279,560548,802,12,483,281,202,560548,Рівненська область
19280,560549,309,4,206,131,75,560549,Рівненська область
19281,560550,1104,19,608,359,249,560550,Рівненська область
19282,560551,394,4,264,133,131,560551,Рівненська область
19283,560552,139,2,94,50,44,560552,Рівненська область
19284,560553,508,14,333,158,175,560553,Рівненська область
19285,560554,399,9,241,93,148,560554,Рівненська область
19286,560555,756,12,473,298,175,560555,Рівненська область
19287,560556,171,2,96,61,35,560556,Рівненська область
19288,560557,334,6,196,109,87,560557,Рівненська область
19289,560558,846,12,519,329,190,560558,Рівненська область
19290,560559,375,6,223,116,107,560559,Рівненська область
19291,560560,467,5,280,128,152,560560,Рівненська область
19292,560561,594,11,329,100,229,560561,Рівненська область
19293,560562,555,4,381,197,184,560562,Рівненська область
19294,560563,226,3,130,68,62,560563,Рівненська область
19295,560564,287,2,182,97,85,560564,Рівненська область
19296,560565,376,7,264,175,89,560565,Рівненська область
19297,560566,491,6,322,192,130,560566,Рівненська область
19298,560567,200,0,141,73,68,560567,Рівненська область
19299,560568,262,2,154,78,76,560568,Рівненська область
19300,560609,1971,30,1117,712,405,560609,Рівненська область
19301,560610,2039,27,1162,730,432,560610,Рівненська область
19302,560611,2039,30,1192,792,400,560611,Рівненська область
19303,560612,1501,25,867,544,323,560612,Рівненська область
19304,560613,522,6,278,122,156,560613,Рівненська область
19305,560614,397,6,232,136,96,560614,Рівненська область
19306,560615,629,4,403,239,164,560615,Рівненська область
19307,560616,259,5,182,80,102,560616,Рівненська область
19308,560617,159,0,104,65,39,560617,Рівненська область
19309,560618,224,3,137,64,73,560618,Рівненська область
19310,560619,1082,12,610,387,223,560619,Рівненська область
19311,560620,1045,11,602,383,219,560620,Рівненська область
19312,560621,184,3,127,53,74,560621,Рівненська область
19313,560622,185,2,128,78,50,560622,Рівненська область
19314,560623,861,15,508,334,174,560623,Рівненська область
19315,560624,390,3,219,100,119,560624,Рівненська область
19316,560625,275,4,181,68,113,560625,Рівненська область
19317,560626,545,1,357,155,202,560626,Рівненська область
19318,560627,511,6,318,232,86,560627,Рівненська область
19319,560628,1068,11,606,334,272,560628,Рівненська область
19320,560629,348,3,200,110,90,560629,Рівненська область
19321,560630,251,8,133,72,61,560630,Рівненська область
19322,560631,247,2,153,88,65,560631,Рівненська область
19323,560632,1179,23,674,370,304,560632,Рівненська область
19324,560633,287,8,182,82,100,560633,Рівненська область
19325,560634,789,7,504,299,205,560634,Рівненська область
19326,560635,506,7,321,168,153,560635,Рівненська область
19327,560636,968,11,586,307,279,560636,Рівненська область
19328,560638,252,3,178,93,85,560638,Рівненська область
19329,560639,1030,9,578,352,226,560639,Рівненська область
19330,560640,311,5,195,90,105,560640,Рівненська область
19331,560641,640,2,389,199,190,560641,Рівненська область
19332,560642,306,3,186,103,83,560642,Рівненська область
19333,560643,550,5,367,244,123,560643,Рівненська область
19334,560644,270,0,186,116,70,560644,Рівненська область
19335,560645,337,4,228,108,120,560645,Рівненська область
19336,560646,325,4,244,107,137,560646,Рівненська область
19337,560647,604,12,356,151,205,560647,Рівненська область
19338,560648,412,8,274,168,106,560648,Рівненська область
19339,560649,326,10,238,135,103,560649,Рівненська область
19340,560650,260,5,171,90,81,560650,Рівненська область
19341,560651,694,11,512,298,214,560651,Рівненська область
19342,560652,518,10,350,176,174,560652,Рівненська область
19343,560653,638,16,323,210,113,560653,Рівненська область
19344,560654,47,0,41,20,21,560654,Рівненська область
19345,560857,1431,20,801,504,297,560857,Рівненська область
19346,560858,1458,22,839,522,317,560858,Рівненська область
19347,560859,1461,42,870,541,329,560859,Рівненська область
19348,560860,1538,35,944,553,391,560860,Рівненська область
19349,560861,1508,28,880,586,294,560861,Рівненська область
19350,560862,1790,28,1043,626,417,560862,Рівненська область
19351,560863,1561,29,963,599,364,560863,Рівненська область
19352,560864,1726,26,987,656,331,560864,Рівненська область
19353,560865,1872,56,1085,699,386,560865,Рівненська область
19354,560866,1442,22,846,560,286,560866,Рівненська область
19355,560867,1483,39,933,553,380,560867,Рівненська область
19356,560868,1141,18,653,403,250,560868,Рівненська область
19357,560869,1575,30,907,543,364,560869,Рівненська область
19358,560870,1863,38,1160,716,444,560870,Рівненська область
19359,560871,1359,20,754,450,304,560871,Рівненська область
19360,560872,1577,27,897,548,349,560872,Рівненська область
19361,560873,1368,30,822,524,298,560873,Рівненська область
19362,560874,1184,16,754,431,323,560874,Рівненська область
19363,560875,15,0,15,9,6,560875,Рівненська область
19364,560876,42,2,37,22,15,560876,Рівненська область
19365,560049,2417,34,1325,720,605,560049,Рівненська область
19366,560050,2332,32,1223,667,556,560050,Рівненська область
19367,560051,2288,27,1326,790,536,560051,Рівненська область
19368,560052,2390,33,1363,834,529,560052,Рівненська область
19369,560053,1004,12,535,329,206,560053,Рівненська область
19370,560054,372,11,228,131,97,560054,Рівненська область
19371,560055,692,5,371,231,140,560055,Рівненська область
19372,560056,643,15,289,136,153,560056,Рівненська область
19373,560057,284,2,178,115,63,560057,Рівненська область
19374,560058,487,5,274,168,106,560058,Рівненська область
19375,560059,355,3,164,64,100,560059,Рівненська область
19376,560060,1468,13,611,315,296,560060,Рівненська область
19377,560061,124,1,64,30,34,560061,Рівненська область
19378,560062,382,4,188,94,94,560062,Рівненська область
19379,560063,838,8,414,235,179,560063,Рівненська область
19380,560064,634,6,303,145,158,560064,Рівненська область
19381,560065,746,6,415,256,159,560065,Рівненська область
19382,560066,427,4,226,103,123,560066,Рівненська область
19383,560067,2059,22,1131,652,479,560067,Рівненська область
19384,560068,347,5,198,104,94,560068,Рівненська область
19385,560069,1136,5,547,322,225,560069,Рівненська область
19386,560070,245,3,110,52,58,560070,Рівненська область
19387,560071,1432,10,784,451,333,560071,Рівненська область
19388,560072,461,16,254,129,125,560072,Рівненська область
19389,560073,515,19,299,143,156,560073,Рівненська область
19390,560074,1412,14,713,413,300,560074,Рівненська область
19391,560075,646,8,354,189,165,560075,Рівненська область
19392,560076,865,13,602,362,240,560076,Рівненська область
19393,560077,635,9,416,217,199,560077,Рівненська область
19394,560078,532,6,320,203,117,560078,Рівненська область
19395,560079,1449,16,767,178,589,560079,Рівненська область
19396,560080,383,1,274,95,179,560080,Рівненська область
19397,560081,596,10,361,194,167,560081,Рівненська область
19398,560082,168,4,105,41,64,560082,Рівненська область
19399,560083,760,2,418,251,167,560083,Рівненська область
19400,560084,231,0,151,84,67,560084,Рівненська область
19401,560085,444,7,250,153,97,560085,Рівненська область
19402,560086,183,0,99,53,46,560086,Рівненська область
19403,560087,1419,25,696,428,268,560087,Рівненська область
19404,560088,122,0,64,29,35,560088,Рівненська область
19405,560089,442,8,283,135,148,560089,Рівненська область
19406,560090,735,8,345,204,141,560090,Рівненська область
19407,560091,1054,8,643,366,277,560091,Рівненська область
19408,560092,1203,21,674,432,242,560092,Рівненська область
19409,560093,665,4,364,263,101,560093,Рівненська область
19410,560094,338,2,215,175,40,560094,Рівненська область
19411,560095,793,13,350,191,159,560095,Рівненська область
19412,560096,769,15,409,219,190,560096,Рівненська область
19413,560097,634,6,289,167,122,560097,Рівненська область
19414,560098,751,7,367,140,227,560098,Рівненська область
19415,560099,365,2,135,63,72,560099,Рівненська область
19416,560100,776,3,489,293,196,560100,Рівненська область
19417,560101,1424,19,659,398,261,560101,Рівненська область
19418,560102,669,12,354,267,87,560102,Рівненська область
19419,560103,205,1,131,77,54,560103,Рівненська область
19420,560104,142,7,135,112,23,560104,Рівненська область
19421,560248,1940,30,1169,709,460,560248,Рівненська область
19422,560249,1728,23,1018,623,395,560249,Рівненська область
19423,560250,1493,20,784,524,260,560250,Рівненська область
19424,560251,1780,18,1011,645,366,560251,Рівненська область
19425,560252,425,2,238,144,94,560252,Рівненська область
19426,560253,1222,18,723,481,242,560253,Рівненська область
19427,560254,216,2,142,108,34,560254,Рівненська область
19428,560255,441,3,296,193,103,560255,Рівненська область
19429,560256,317,3,214,132,82,560256,Рівненська область
19430,560257,1974,23,1215,683,532,560257,Рівненська область
19431,560258,643,3,342,264,78,560258,Рівненська область
19432,560259,101,10,60,26,34,560259,Рівненська область
19433,560260,548,6,351,168,183,560260,Рівненська область
19434,560261,1481,13,772,482,290,560261,Рівненська область
19435,560262,349,4,217,128,89,560262,Рівненська область
19436,560263,700,6,404,233,171,560263,Рівненська область
19437,560264,1257,15,613,408,205,560264,Рівненська область
19438,560265,1603,12,919,587,332,560265,Рівненська область
19439,560266,603,3,321,214,107,560266,Рівненська область
19440,560267,318,5,237,170,67,560267,Рівненська область
19441,560268,391,1,241,145,96,560268,Рівненська область
19442,560269,491,9,300,152,148,560269,Рівненська область
19443,560270,374,6,220,147,73,560270,Рівненська область
19444,560271,147,3,122,52,70,560271,Рівненська область
19445,560272,457,6,316,211,105,560272,Рівненська область
19446,560273,858,8,443,297,146,560273,Рівненська область
19447,560274,757,7,533,276,257,560274,Рівненська область
19448,560275,380,3,197,104,93,560275,Рівненська область
19449,560276,197,3,123,56,67,560276,Рівненська область
19450,560277,598,6,380,240,140,560277,Рівненська область
19451,560278,558,6,409,263,146,560278,Рівненська область
19452,560279,405,3,197,116,81,560279,Рівненська область
19453,560280,732,6,455,219,236,560280,Рівненська область
19454,560281,1074,9,496,321,175,560281,Рівненська область
19455,560282,468,5,288,81,207,560282,Рівненська область
19456,560283,1529,10,916,665,251,560283,Рівненська область
19457,560284,494,9,332,258,74,560284,Рівненська область
19458,560285,1407,16,782,428,354,560285,Рівненська область
19459,560286,375,6,210,137,73,560286,Рівненська область
19460,560287,385,3,252,112,140,560287,Рівненська область
19461,560288,200,7,147,58,89,560288,Рівненська область
19462,560289,1431,15,840,479,361,560289,Рівненська область
19463,560290,518,6,356,250,106,560290,Рівненська область
19464,560291,233,6,161,100,61,560291,Рівненська область
19465,560292,203,4,136,57,79,560292,Рівненська область
19466,560293,315,3,184,107,77,560293,Рівненська область
19467,560294,400,2,269,189,80,560294,Рівненська область
19468,560295,160,1,117,84,33,560295,Рівненська область
19469,560296,671,7,522,286,236,560296,Рівненська область
19470,560297,400,6,256,157,99,560297,Рівненська область
19471,560298,29,1,27,16,11,560298,Рівненська область
19472,560299,1368,8,803,612,191,560299,Рівненська область
19473,560300,1428,19,822,589,233,560300,Рівненська область
19474,560301,1480,12,836,617,219,560301,Рівненська область
19475,560302,683,4,351,278,73,560302,Рівненська область
19476,560303,547,2,360,288,72,560303,Рівненська область
19477,560304,164,0,109,76,33,560304,Рівненська область
19478,560305,1725,25,690,485,205,560305,Рівненська область
19479,560306,536,5,279,176,103,560306,Рівненська область
19480,560307,120,4,63,48,15,560307,Рівненська область
19481,560308,987,2,571,413,158,560308,Рівненська область
19482,560309,591,4,401,315,86,560309,Рівненська область
19483,560310,341,0,226,118,108,560310,Рівненська область
19484,560311,1296,16,678,480,198,560311,Рівненська область
19485,560312,365,2,233,150,83,560312,Рівненська область
19486,560313,58,0,42,21,21,560313,Рівненська область
19487,560314,117,0,84,72,12,560314,Рівненська область
19488,560315,454,2,291,178,113,560315,Рівненська область
19489,560316,208,6,155,97,58,560316,Рівненська область
19490,560317,233,2,163,90,73,560317,Рівненська область
19491,560318,917,8,514,434,80,560318,Рівненська область
19492,560319,509,1,357,303,54,560319,Рівненська область
19493,560320,323,4,205,163,42,560320,Рівненська область
19494,560321,685,4,435,299,136,560321,Рівненська область
19495,560322,477,8,284,133,151,560322,Рівненська область
19496,560323,726,3,478,332,146,560323,Рівненська область
19497,560324,273,0,209,141,68,560324,Рівненська область
19498,560325,437,4,293,191,102,560325,Рівненська область
19499,560326,377,0,205,156,49,560326,Рівненська область
19500,560327,405,4,280,162,118,560327,Рівненська область
19501,560328,726,14,457,379,78,560328,Рівненська область
19502,560329,46,0,37,29,8,560329,Рівненська область
19503,560330,434,6,265,203,62,560330,Рівненська область
19504,560331,775,11,435,258,177,560331,Рівненська область
19505,560332,72,0,47,34,13,560332,Рівненська область
19506,560333,45,0,28,22,6,560333,Рівненська область
19507,560334,586,8,342,252,90,560334,Рівненська область
19508,560335,285,2,166,139,27,560335,Рівненська область
19509,560336,395,13,237,151,86,560336,Рівненська область
19510,560337,371,7,224,150,74,560337,Рівненська область
19511,560338,105,0,74,47,27,560338,Рівненська область
19512,560339,86,0,64,45,19,560339,Рівненська область
19513,560340,141,3,91,58,33,560340,Рівненська область
19514,560341,1371,13,784,625,159,560341,Рівненська область
19515,560342,503,0,251,197,54,560342,Рівненська область
19516,560343,353,2,206,159,47,560343,Рівненська область
19517,560344,176,3,150,99,51,560344,Рівненська область
19518,560345,56,1,35,19,16,560345,Рівненська область
19519,560734,1418,20,744,557,187,560734,Рівненська область
19520,560735,1824,26,1057,810,247,560735,Рівненська область
19521,560736,1927,24,1080,803,277,560736,Рівненська область
19522,560737,1504,22,748,565,183,560737,Рівненська область
19523,560738,428,8,202,145,57,560738,Рівненська область
19524,560739,2066,24,1282,882,400,560739,Рівненська область
19525,560740,351,5,195,144,51,560740,Рівненська область
19526,560741,229,2,144,108,36,560741,Рівненська область
19527,560742,700,8,397,264,133,560742,Рівненська область
19528,560743,276,12,171,124,47,560743,Рівненська область
19529,560744,212,4,158,103,55,560744,Рівненська область
19530,560745,1050,14,561,401,160,560745,Рівненська область
19531,560746,531,10,309,199,110,560746,Рівненська область
19532,560747,480,3,309,214,95,560747,Рівненська область
19533,560748,1266,17,725,475,250,560748,Рівненська область
19534,560749,370,3,234,144,90,560749,Рівненська область
19535,560750,697,10,438,251,187,560750,Рівненська область
19536,560751,358,4,260,201,59,560751,Рівненська область
19537,560752,1876,22,894,635,259,560752,Рівненська область
19538,560753,468,8,262,134,128,560753,Рівненська область
19539,560754,1033,12,433,126,307,560754,Рівненська область
19540,560755,714,15,429,366,63,560755,Рівненська область
19541,560756,926,12,564,485,79,560756,Рівненська область
19542,560757,104,0,69,47,22,560757,Рівненська область
19543,560758,242,4,147,103,44,560758,Рівненська область
19544,560759,1978,17,1035,574,461,560759,Рівненська область
19545,560760,925,13,472,318,154,560760,Рівненська область
19546,560761,475,9,278,188,90,560761,Рівненська область
19547,560762,360,4,195,119,76,560762,Рівненська область
19548,560763,1392,27,839,623,216,560763,Рівненська область
19549,560764,806,8,427,298,129,560764,Рівненська область
19550,560765,408,16,287,217,70,560765,Рівненська область
19551,560766,2012,28,1149,956,193,560766,Рівненська область
19552,560767,1851,17,1001,825,176,560767,Рівненська область
19553,560768,205,0,142,100,42,560768,Рівненська область
19554,560769,619,5,372,296,76,560769,Рівненська область
19555,560770,731,2,462,354,108,560770,Рівненська область
19556,560771,158,2,117,64,53,560771,Рівненська область
19557,560772,829,7,530,312,218,560772,Рівненська область
19558,560773,2385,24,1222,801,421,560773,Рівненська область
19559,560774,1415,20,825,530,295,560774,Рівненська область
19560,560775,1178,10,610,469,141,560775,Рівненська область
19561,560776,509,5,428,291,137,560776,Рівненська область
19562,560879,1544,24,920,594,326,560879,Рівненська область
19563,560880,1701,24,1036,634,402,560880,Рівненська область
19564,560881,1584,37,961,559,402,560881,Рівненська область
19565,560882,1808,20,1138,697,441,560882,Рівненська область
19566,560883,1703,26,1072,616,456,560883,Рівненська область
19567,560884,1658,24,1064,660,404,560884,Рівненська область
19568,560885,1568,25,989,595,394,560885,Рівненська область
19569,560886,2283,31,1456,856,600,560886,Рівненська область
19570,560887,2324,27,1480,847,633,560887,Рівненська область
19571,560888,2296,34,1406,842,564,560888,Рівненська область
19572,560889,2239,35,1422,841,581,560889,Рівненська область
19573,560890,2113,39,1409,792,617,560890,Рівненська область
19574,560891,1970,31,1292,750,542,560891,Рівненська область
19575,560892,2089,44,1321,792,529,560892,Рівненська область
19576,560893,2004,21,1245,723,522,560893,Рівненська область
19577,561012,1243,13,907,493,414,561012,Рівненська область
19578,560001,1341,18,789,445,344,560001,Рівненська область
19579,560002,1347,36,761,496,265,560002,Рівненська область
19580,560003,1842,43,1060,656,404,560003,Рівненська область
19581,560004,1989,30,1177,703,474,560004,Рівненська область
19582,560005,1673,26,930,635,295,560005,Рівненська область
19583,560006,1363,10,685,496,189,560006,Рівненська область
19584,560007,564,5,279,203,76,560007,Рівненська область
19585,560008,521,6,308,220,88,560008,Рівненська область
19586,560009,92,0,75,39,36,560009,Рівненська область
19587,560010,868,13,532,358,174,560010,Рівненська область
19588,560011,1991,24,1002,685,317,560011,Рівненська область
19589,560012,645,5,402,250,152,560012,Рівненська область
19590,560013,435,3,268,96,172,560013,Рівненська область
19591,560014,309,4,198,131,67,560014,Рівненська область
19592,560015,1585,16,961,523,438,560015,Рівненська область
19593,560016,446,3,249,145,104,560016,Рівненська область
19594,560017,2119,32,1248,898,350,560017,Рівненська область
19595,560018,1055,12,592,414,178,560018,Рівненська область
19596,560019,991,9,623,396,227,560019,Рівненська область
19597,560020,792,6,383,141,242,560020,Рівненська область
19598,560021,618,12,309,208,101,560021,Рівненська область
19599,560022,1023,5,509,358,151,560022,Рівненська область
19600,560023,2065,24,1267,885,382,560023,Рівненська область
19601,560024,872,11,501,350,151,560024,Рівненська область
19602,560025,248,2,165,112,53,560025,Рівненська область
19603,560026,400,1,244,144,100,560026,Рівненська область
19604,560027,1218,14,639,414,225,560027,Рівненська область
19605,560028,478,13,227,141,86,560028,Рівненська область
19606,560029,621,6,357,280,77,560029,Рівненська область
19607,560030,201,2,125,88,37,560030,Рівненська область
19608,560031,370,7,233,163,70,560031,Рівненська область
19609,560032,1824,15,959,626,333,560032,Рівненська область
19610,560033,1206,10,609,291,318,560033,Рівненська область
19611,560034,1002,17,686,388,298,560034,Рівненська область
19612,560035,1018,4,509,346,163,560035,Рівненська область
19613,560036,1061,8,465,309,156,560036,Рівненська область
19614,560037,1069,12,505,321,184,560037,Рівненська область
19615,560038,2172,38,1103,696,407,560038,Рівненська область
19616,560039,243,2,149,96,53,560039,Рівненська область
19617,560040,135,5,102,65,37,560040,Рівненська область
19618,560041,1270,10,754,476,278,560041,Рівненська область
19619,560042,962,17,538,327,211,560042,Рівненська область
19620,560043,655,22,399,284,115,560043,Рівненська область
19621,560044,199,4,129,87,42,560044,Рівненська область
19622,560045,162,6,92,69,23,560045,Рівненська область
19623,560046,609,6,409,268,141,560046,Рівненська область
19624,560047,818,6,347,249,98,560047,Рівненська область
19625,560048,42,0,37,18,19,560048,Рівненська область
19626,560446,622,5,392,256,136,560446,Рівненська область
19627,560447,440,6,244,178,66,560447,Рівненська область
19628,560448,367,4,262,136,126,560448,Рівненська область
19629,560449,544,6,362,231,131,560449,Рівненська область
19630,560450,696,5,446,272,174,560450,Рівненська область
19631,560451,398,4,254,152,102,560451,Рівненська область
19632,560452,183,1,121,80,41,560452,Рівненська область
19633,560453,506,7,278,174,104,560453,Рівненська область
19634,560454,511,6,342,163,179,560454,Рівненська область
19635,560455,1543,17,1116,504,612,560455,Рівненська область
19636,560456,843,17,590,268,322,560456,Рівненська область
19637,560457,145,0,92,34,58,560457,Рівненська область
19638,560459,236,3,154,83,71,560459,Рівненська область
19639,560460,602,10,340,124,216,560460,Рівненська область
19640,560461,261,11,139,46,93,560461,Рівненська область
19641,560462,707,8,451,244,207,560462,Рівненська область
19642,560463,151,2,113,38,75,560463,Рівненська область
19643,560464,277,0,158,73,85,560464,Рівненська область
19644,560465,1153,10,714,359,355,560465,Рівненська область
19645,560466,254,3,178,65,113,560466,Рівненська область
19646,560467,615,1,343,221,122,560467,Рівненська область
19647,560468,124,0,77,45,32,560468,Рівненська область
19648,560469,158,3,100,28,72,560469,Рівненська область
19649,560470,615,2,342,222,120,560470,Рівненська область
19650,560471,707,7,433,317,116,560471,Рівненська область
19651,560472,1181,13,717,425,292,560472,Рівненська область
19652,560473,64,0,33,20,13,560473,Рівненська область
19653,560474,476,4,296,175,121,560474,Рівненська область
19654,560475,132,5,82,40,42,560475,Рівненська область
19655,560476,205,4,125,78,47,560476,Рівненська область
19656,560477,135,0,94,61,33,560477,Рівненська область
19657,560478,518,7,396,184,212,560478,Рівненська область
19658,560479,158,3,113,47,66,560479,Рівненська область
19659,560480,196,2,120,70,50,560480,Рівненська область
19660,560481,486,4,263,186,77,560481,Рівненська область
19661,560482,185,3,115,72,43,560482,Рівненська область
19662,560483,409,4,226,161,65,560483,Рівненська область
19663,560484,1002,10,583,350,233,560484,Рівненська область
19664,560485,132,0,103,59,44,560485,Рівненська область
19665,560486,185,4,106,82,24,560486,Рівненська область
19666,560487,106,1,67,46,21,560487,Рівненська область
19667,560489,311,2,153,83,70,560489,Рівненська область
19668,560490,677,8,357,187,170,560490,Рівненська область
19669,560491,538,4,313,217,96,560491,Рівненська область
19670,560492,161,1,83,58,25,560492,Рівненська область
19671,560493,592,8,325,193,132,560493,Рівненська область
19672,560494,275,3,137,98,39,560494,Рівненська область
19673,560495,235,3,137,91,46,560495,Рівненська область
19674,560496,863,6,510,271,239,560496,Рівненська область
19675,560497,462,7,259,151,108,560497,Рівненська область
19676,560498,88,0,55,26,29,560498,Рівненська область
19677,560499,1429,17,742,453,289,560499,Рівненська область
19678,560500,144,0,121,58,63,560500,Рівненська область
19679,560501,460,7,289,148,141,560501,Рівненська область
19680,560502,316,3,179,100,79,560502,Рівненська область
19681,560503,593,7,330,213,117,560503,Рівненська область
19682,560504,2158,41,1167,744,423,560504,Рівненська область
19683,560505,2140,36,1206,750,456,560505,Рівненська область
19684,560506,1173,16,668,435,233,560506,Рівненська область
19685,560507,1827,22,1121,651,470,560507,Рівненська область
19686,560508,1611,23,912,608,304,560508,Рівненська область
19687,560509,1957,24,1112,755,357,560509,Рівненська область
19688,560510,753,5,418,299,119,560510,Рівненська область
19689,560511,1873,30,1068,685,383,560511,Рівненська область
19690,560512,2145,45,1214,728,486,560512,Рівненська область
19691,560513,1734,23,955,599,356,560513,Рівненська область
19692,560514,2024,35,1128,660,468,560514,Рівненська область
19693,560515,2055,22,1149,670,479,560515,Рівненська область
19694,560516,2230,27,1286,772,514,560516,Рівненська область
19695,560517,34,0,29,16,13,560517,Рівненська область
19696,560777,446,5,240,165,75,560777,Рівненська область
19697,560778,1133,22,655,475,180,560778,Рівненська область
19698,560779,1129,16,659,454,205,560779,Рівненська область
19699,560780,935,11,523,391,132,560780,Рівненська область
19700,560781,1076,13,635,475,160,560781,Рівненська область
19701,560782,1005,16,578,398,180,560782,Рівненська область
19702,560783,1299,24,640,435,205,560783,Рівненська область
19703,560784,1177,17,740,558,182,560784,Рівненська область
19704,560785,1350,14,775,594,181,560785,Рівненська область
19705,560786,1073,11,650,472,178,560786,Рівненська область
19706,560787,922,20,536,407,129,560787,Рівненська область
19707,560788,1387,20,822,608,214,560788,Рівненська область
19708,560789,1360,12,790,591,199,560789,Рівненська область
19709,560790,1320,11,755,566,189,560790,Рівненська область
19710,560791,1243,18,705,520,185,560791,Рівненська область
19711,560792,1292,12,786,586,200,560792,Рівненська область
19712,560793,1552,20,807,571,236,560793,Рівненська область
19713,560794,2106,22,1141,899,242,560794,Рівненська область
19714,560795,1113,16,573,469,104,560795,Рівненська область
19715,560796,2363,29,1337,1089,248,560796,Рівненська область
19716,560797,1547,19,718,629,89,560797,Рівненська область
19717,560798,1329,23,824,505,319,560798,Рівненська область
19718,560799,1543,33,816,494,322,560799,Рівненська область
19719,560800,504,11,240,176,64,560800,Рівненська область
19720,560801,218,2,145,74,71,560801,Рівненська область
19721,560802,145,2,86,60,26,560802,Рівненська область
19722,560803,114,0,69,34,35,560803,Рівненська область
19723,560804,89,1,50,29,21,560804,Рівненська область
19724,560805,1813,25,1223,740,483,560805,Рівненська область
19725,560806,497,4,310,146,164,560806,Рівненська область
19726,560807,215,5,153,95,58,560807,Рівненська область
19727,560808,1405,18,617,407,210,560808,Рівненська область
19728,560809,365,5,226,157,69,560809,Рівненська область
19729,560810,215,1,136,115,21,560810,Рівненська область
19730,560811,466,1,199,151,48,560811,Рівненська область
19731,560812,1604,21,953,720,233,560812,Рівненська область
19732,560813,938,13,510,462,48,560813,Рівненська область
19733,560814,387,6,222,110,112,560814,Рівненська область
19734,560815,1586,17,785,572,213,560815,Рівненська область
19735,560816,352,7,164,93,71,560816,Рівненська область
19736,560817,1535,11,932,633,299,560817,Рівненська область
19737,560818,719,7,476,367,109,560818,Рівненська область
19738,560819,460,5,286,201,85,560819,Рівненська область
19739,560820,1011,6,447,342,105,560820,Рівненська область
19740,560821,455,3,248,200,48,560821,Рівненська область
19741,560822,1872,12,880,604,276,560822,Рівненська область
19742,560823,298,4,144,71,73,560823,Рівненська область
19743,560824,189,0,124,88,36,560824,Рівненська область
19744,560825,457,8,267,187,80,560825,Рівненська область
19745,560826,171,1,106,51,55,560826,Рівненська область
19746,560827,141,1,77,53,24,560827,Рівненська область
19747,560828,915,7,453,323,130,560828,Рівненська область
19748,560829,279,6,156,108,48,560829,Рівненська область
19749,560830,219,2,134,97,37,560830,Рівненська область
19750,560831,1704,13,954,684,270,560831,Рівненська область
19751,560832,862,12,410,312,98,560832,Рівненська область
19752,560833,364,3,211,167,44,560833,Рівненська область
19753,560834,140,0,94,52,42,560834,Рівненська область
19754,560835,2361,23,1260,974,286,560835,Рівненська область
19755,560836,548,6,319,246,73,560836,Рівненська область
19756,560837,95,2,60,44,16,560837,Рівненська область
19757,560838,628,1,299,199,100,560838,Рівненська область
19758,560839,1165,3,484,294,190,560839,Рівненська область
19759,560840,634,7,352,243,109,560840,Рівненська область
19760,560841,1054,4,642,527,115,560841,Рівненська область
19761,560842,1189,19,487,365,122,560842,Рівненська область
19762,560843,808,17,324,169,155,560843,Рівненська область
19763,560844,1639,19,892,675,217,560844,Рівненська область
19764,560845,85,2,43,34,9,560845,Рівненська область
19765,560846,2399,38,1223,784,439,560846,Рівненська область
19766,560847,796,15,442,250,192,560847,Рівненська область
19767,560848,833,13,479,275,204,560848,Рівненська область
19768,560849,702,5,313,180,133,560849,Рівненська область
19769,560850,1679,9,715,273,442,560850,Рівненська область
19770,560851,613,3,300,147,153,560851,Рівненська область
19771,560852,2077,15,974,777,197,560852,Рівненська область
19772,560853,27,0,24,16,8,560853,Рівненська область
19773,560854,31,0,31,19,12,560854,Рівненська область
19774,560855,32,0,29,23,6,560855,Рівненська область
19775,560856,473,39,434,399,35,560856,Рівненська область
19776,561008,329,6,171,60,111,561008,Рівненська область
19777,561010,1928,20,1079,706,373,561010,Рівненська область
19778,1,482,57,425,404,21,1,Сумська область
19779,590884,1437,26,882,670,212,590884,Сумська область
19780,590885,2373,36,1596,1164,432,590885,Сумська область
19781,590886,1484,39,962,716,246,590886,Сумська область
19782,590887,2174,32,1467,1137,330,590887,Сумська область
19783,590888,2263,45,1497,1083,414,590888,Сумська область
19784,590889,2102,33,1307,1029,278,590889,Сумська область
19785,590890,1627,32,1058,811,247,590890,Сумська область
19786,590891,1500,27,954,759,195,590891,Сумська область
19787,590892,2133,37,1416,1071,345,590892,Сумська область
19788,590893,1593,14,878,711,167,590893,Сумська область
19789,590894,2283,35,1459,1173,286,590894,Сумська область
19790,590895,2244,36,1405,1124,281,590895,Сумська область
19791,590926,747,16,509,388,121,590926,Сумська область
19792,590927,2183,34,1465,1125,340,590927,Сумська область
19793,590928,2149,32,1488,1187,301,590928,Сумська область
19794,590929,2039,31,1355,1089,266,590929,Сумська область
19795,590930,2167,27,1369,1078,291,590930,Сумська область
19796,590931,2227,28,1416,1104,312,590931,Сумська область
19797,590932,1957,33,1278,1046,232,590932,Сумська область
19798,590933,2277,30,1512,1202,310,590933,Сумська область
19799,590934,2158,39,1471,1155,316,590934,Сумська область
19800,590935,1819,37,1155,948,207,590935,Сумська область
19801,590936,1737,33,1143,894,249,590936,Сумська область
19802,590937,2045,43,1354,1054,300,590937,Сумська область
19803,590938,1931,44,1258,979,279,590938,Сумська область
19804,590939,2291,36,1484,1144,340,590939,Сумська область
19805,590940,1475,15,1040,817,223,590940,Сумська область
19806,590941,9,0,9,8,1,590941,Сумська область
19807,590942,40,0,40,37,3,590942,Сумська область
19808,590943,20,1,18,14,4,590943,Сумська область
19809,590947,1603,14,724,559,165,590947,Сумська область
19810,590948,1371,29,824,598,226,590948,Сумська область
19811,590949,1760,31,1221,916,305,590949,Сумська область
19812,590950,1507,20,932,762,170,590950,Сумська область
19813,590951,1814,26,1159,960,199,590951,Сумська область
19814,590952,1929,18,1058,859,199,590952,Сумська область
19815,590953,1932,25,1145,944,201,590953,Сумська область
19816,590954,2194,48,1481,1130,351,590954,Сумська область
19817,590955,1981,40,1306,968,338,590955,Сумська область
19818,590956,2130,33,1350,1093,257,590956,Сумська область
19819,590957,2266,53,1435,1113,322,590957,Сумська область
19820,590958,2142,45,1419,1106,313,590958,Сумська область
19821,590959,2141,37,1421,1103,318,590959,Сумська область
19822,590960,2192,26,1467,1170,297,590960,Сумська область
19823,590961,2269,41,1471,1169,302,590961,Сумська область
19824,590962,2306,36,1495,1157,338,590962,Сумська область
19825,590963,2304,51,1524,1190,334,590963,Сумська область
19826,590964,2407,39,1565,1276,289,590964,Сумська область
19827,590965,2303,28,1478,1155,323,590965,Сумська область
19828,590966,2267,31,1463,1158,305,590966,Сумська область
19829,590967,1908,25,1222,1003,219,590967,Сумська область
19830,590968,1510,21,1003,836,167,590968,Сумська область
19831,590969,1960,39,1276,1003,273,590969,Сумська область
19832,590970,2247,37,1465,1152,313,590970,Сумська область
19833,590971,2402,40,1579,1254,325,590971,Сумська область
19834,590972,2041,22,1323,1116,207,590972,Сумська область
19835,590973,1946,52,1234,973,261,590973,Сумська область
19836,590974,1891,32,1270,993,277,590974,Сумська область
19837,590975,1882,34,1208,953,255,590975,Сумська область
19838,590976,1696,33,1137,883,254,590976,Сумська область
19839,590977,2229,28,1444,1146,298,590977,Сумська область
19840,590978,2431,33,1557,1243,314,590978,Сумська область
19841,590979,2390,24,1463,1212,251,590979,Сумська область
19842,590980,2264,40,1447,1183,264,590980,Сумська область
19843,590981,1872,47,1183,1005,178,590981,Сумська область
19844,590982,2092,34,1351,1093,258,590982,Сумська область
19845,590983,2255,37,1448,1184,264,590983,Сумська область
19846,590984,1552,27,1037,847,190,590984,Сумська область
19847,590985,1678,25,952,834,118,590985,Сумська область
19848,590986,2237,52,1337,1090,247,590986,Сумська область
19849,590987,2035,40,1295,1042,253,590987,Сумська область
19850,590988,2158,26,1389,1044,345,590988,Сумська область
19851,590989,2338,30,1373,1159,214,590989,Сумська область
19852,590990,2225,22,1368,1140,228,590990,Сумська область
19853,590991,2221,33,1455,1192,263,590991,Сумська область
19854,590992,2101,35,1365,1158,207,590992,Сумська область
19855,590993,2377,31,1635,1290,345,590993,Сумська область
19856,590994,461,10,313,247,66,590994,Сумська область
19857,590995,2148,25,1515,1182,333,590995,Сумська область
19858,590996,192,5,175,111,64,590996,Сумська область
19859,590997,2283,40,1428,1168,260,590997,Сумська область
19860,590998,2062,23,1095,913,182,590998,Сумська область
19861,590999,1957,17,1294,1075,219,590999,Сумська область
19862,591000,1698,17,1019,871,148,591000,Сумська область
19863,591001,1530,14,922,764,158,591001,Сумська область
19864,591002,856,12,543,428,115,591002,Сумська область
19865,591003,29,0,29,26,3,591003,Сумська область
19866,591004,17,0,17,11,6,591004,Сумська область
19867,591005,102,1,100,89,11,591005,Сумська область
19868,591006,91,3,87,77,10,591006,Сумська область
19869,591007,8,0,7,5,2,591007,Сумська область
19870,591008,51,2,48,34,14,591008,Сумська область
19871,591010,18,0,18,13,5,591010,Сумська область
19872,591011,60,0,57,48,9,591011,Сумська область
19873,591012,32,0,31,24,7,591012,Сумська область
19874,591013,39,1,37,30,7,591013,Сумська область
19875,591014,388,24,361,335,26,591014,Сумська область
19876,591015,2283,39,1432,1199,233,591015,Сумська область
19877,591016,1736,29,1044,815,229,591016,Сумська область
19878,590001,1337,15,698,617,81,590001,Сумська область
19879,590002,1405,19,798,736,62,590002,Сумська область
19880,590003,2294,27,1367,1159,208,590003,Сумська область
19881,590004,2282,37,1311,1111,200,590004,Сумська область
19882,590005,2290,30,1351,1133,218,590005,Сумська область
19883,590006,2294,22,1164,1029,135,590006,Сумська область
19884,590007,1200,12,658,587,71,590007,Сумська область
19885,590008,878,10,515,470,45,590008,Сумська область
19886,590009,1022,7,506,444,62,590009,Сумська область
19887,590010,718,5,393,355,38,590010,Сумська область
19888,590011,392,5,246,203,43,590011,Сумська область
19889,590012,210,2,110,97,13,590012,Сумська область
19890,590013,1081,10,662,570,92,590013,Сумська область
19891,590014,1348,11,835,758,77,590014,Сумська область
19892,590015,919,7,573,514,59,590015,Сумська область
19893,590016,278,4,189,162,27,590016,Сумська область
19894,590017,243,3,176,137,39,590017,Сумська область
19895,590018,225,0,154,141,13,590018,Сумська область
19896,590019,863,12,604,522,82,590019,Сумська область
19897,590020,883,4,608,516,92,590020,Сумська область
19898,590021,321,3,239,200,39,590021,Сумська область
19899,590022,376,0,279,228,51,590022,Сумська область
19900,590023,102,0,83,69,14,590023,Сумська область
19901,590024,72,0,51,39,12,590024,Сумська область
19902,590025,1099,6,605,532,73,590025,Сумська область
19903,590026,543,12,315,275,40,590026,Сумська область
19904,590027,602,6,333,274,59,590027,Сумська область
19905,590028,315,7,178,137,41,590028,Сумська область
19906,590029,436,4,282,233,49,590029,Сумська область
19907,590030,116,0,81,63,18,590030,Сумська область
19908,590031,251,1,150,128,22,590031,Сумська область
19909,590032,264,1,162,152,10,590032,Сумська область
19910,590033,93,0,61,38,23,590033,Сумська область
19911,590034,430,5,222,194,28,590034,Сумська область
19912,590035,199,1,100,71,29,590035,Сумська область
19913,590036,159,3,107,70,37,590036,Сумська область
19914,590037,423,6,237,193,44,590037,Сумська область
19915,590038,652,4,432,358,74,590038,Сумська область
19916,590039,114,2,60,38,22,590039,Сумська область
19917,590040,323,4,212,175,37,590040,Сумська область
19918,590041,575,4,379,347,32,590041,Сумська область
19919,590042,330,2,221,199,22,590042,Сумська область
19920,590043,340,1,214,183,31,590043,Сумська область
19921,590044,422,0,248,201,47,590044,Сумська область
19922,590045,423,4,206,173,33,590045,Сумська область
19923,590046,589,5,443,378,65,590046,Сумська область
19924,590047,530,6,378,317,61,590047,Сумська область
19925,590048,599,7,315,301,14,590048,Сумська область
19926,590049,218,3,135,92,43,590049,Сумська область
19927,590050,263,1,157,120,37,590050,Сумська область
19928,590051,100,1,61,46,15,590051,Сумська область
19929,590052,161,1,106,79,27,590052,Сумська область
19930,590053,517,9,362,275,87,590053,Сумська область
19931,590054,143,1,102,90,12,590054,Сумська область
19932,590055,392,0,321,264,57,590055,Сумська область
19933,590056,73,0,62,41,21,590056,Сумська область
19934,590057,299,2,204,174,30,590057,Сумська область
19935,590058,178,1,109,79,30,590058,Сумська область
19936,590059,30,0,30,25,5,590059,Сумська область
19937,590219,1101,19,723,601,122,590219,Сумська область
19938,590220,1947,18,1258,1025,233,590220,Сумська область
19939,590221,409,1,240,196,44,590221,Сумська область
19940,590222,1315,22,784,643,141,590222,Сумська область
19941,590223,450,10,293,251,42,590223,Сумська область
19942,590224,1256,17,794,676,118,590224,Сумська область
19943,590225,118,4,77,47,30,590225,Сумська область
19944,590226,359,3,217,187,30,590226,Сумська область
19945,590227,795,2,447,398,49,590227,Сумська область
19946,590228,700,5,407,369,38,590228,Сумська область
19947,590229,276,2,174,148,26,590229,Сумська область
19948,590230,305,12,202,155,47,590230,Сумська область
19949,590231,1100,10,632,544,88,590231,Сумська область
19950,590232,238,2,139,116,23,590232,Сумська область
19951,590233,456,4,315,293,22,590233,Сумська область
19952,590234,405,5,211,182,29,590234,Сумська область
19953,590235,409,3,230,203,27,590235,Сумська область
19954,590236,302,5,148,126,22,590236,Сумська область
19955,590237,85,0,74,66,8,590237,Сумська область
19956,590238,797,7,500,447,53,590238,Сумська область
19957,590239,80,0,63,38,25,590239,Сумська область
19958,590240,1162,10,587,527,60,590240,Сумська область
19959,590241,427,1,206,190,16,590241,Сумська область
19960,590242,413,3,269,221,48,590242,Сумська область
19961,590243,419,1,242,212,30,590243,Сумська область
19962,590244,458,3,297,248,49,590244,Сумська область
19963,590245,517,8,340,310,30,590245,Сумська область
19964,590246,207,0,171,143,28,590246,Сумська область
19965,590247,1048,9,652,540,112,590247,Сумська область
19966,590248,314,3,215,174,41,590248,Сумська область
19967,590249,326,0,161,147,14,590249,Сумська область
19968,590250,155,1,102,76,26,590250,Сумська область
19969,590251,595,6,372,332,40,590251,Сумська область
19970,590252,307,3,216,208,8,590252,Сумська область
19971,590253,133,3,86,79,7,590253,Сумська область
19972,590254,382,3,185,166,19,590254,Сумська область
19973,590255,421,1,296,262,34,590255,Сумська область
19974,590256,120,1,67,60,7,590256,Сумська область
19975,590257,686,10,361,272,89,590257,Сумська область
19976,590258,117,0,55,40,15,590258,Сумська область
19977,590259,15,0,14,10,4,590259,Сумська область
19978,590582,403,4,221,184,37,590582,Сумська область
19979,590583,230,1,157,135,22,590583,Сумська область
19980,590584,1508,23,962,790,172,590584,Сумська область
19981,590585,377,6,220,176,44,590585,Сумська область
19982,590586,372,6,198,151,47,590586,Сумська область
19983,590587,351,2,181,148,33,590587,Сумська область
19984,590588,105,0,72,60,12,590588,Сумська область
19985,590589,640,2,425,342,83,590589,Сумська область
19986,590590,2340,20,1447,1159,288,590590,Сумська область
19987,590591,1696,21,1009,875,134,590591,Сумська область
19988,590592,1379,11,798,687,111,590592,Сумська область
19989,590593,347,4,203,174,29,590593,Сумська область
19990,590594,356,7,222,191,31,590594,Сумська область
19991,590595,338,3,210,178,32,590595,Сумська область
19992,590596,670,5,419,376,43,590596,Сумська область
19993,590597,231,3,156,123,33,590597,Сумська область
19994,590598,203,3,124,86,38,590598,Сумська область
19995,590599,390,3,228,183,45,590599,Сумська область
19996,590600,612,4,457,375,82,590600,Сумська область
19997,590601,150,0,103,80,23,590601,Сумська область
19998,590602,162,2,113,101,12,590602,Сумська область
19999,590603,2369,23,1475,1154,321,590603,Сумська область
20000,590604,412,5,287,260,27,590604,Сумська область
20001,590605,729,7,479,409,70,590605,Сумська область
20002,590606,244,2,143,92,51,590606,Сумська область
20003,590607,775,2,551,435,116,590607,Сумська область
20004,590608,574,5,294,237,57,590608,Сумська область
20005,590609,1089,7,622,522,100,590609,Сумська область
20006,590610,1100,13,632,530,102,590610,Сумська область
20007,590611,1923,18,1061,932,129,590611,Сумська область
20008,590612,922,4,544,446,98,590612,Сумська область
20009,590613,570,3,331,280,51,590613,Сумська область
20010,590614,587,3,307,277,30,590614,Сумська область
20011,590615,995,8,547,451,96,590615,Сумська область
20012,590616,355,2,232,163,69,590616,Сумська область
20013,590617,388,2,209,191,18,590617,Сумська область
20014,590618,1445,25,969,739,230,590618,Сумська область
20015,590619,467,2,286,237,49,590619,Сумська область
20016,590620,776,5,514,397,117,590620,Сумська область
20017,590621,313,2,177,156,21,590621,Сумська область
20018,590622,263,4,175,149,26,590622,Сумська область
20019,590623,1485,10,904,761,143,590623,Сумська область
20020,590624,1407,17,832,661,171,590624,Сумська область
20021,590625,1180,14,744,630,114,590625,Сумська область
20022,590626,1559,13,952,814,138,590626,Сумська область
20023,590627,2029,37,1231,976,255,590627,Сумська область
20024,590628,212,1,133,108,25,590628,Сумська область
20025,590629,401,6,250,218,32,590629,Сумська область
20026,590630,726,8,444,351,93,590630,Сумська область
20027,590631,1526,19,997,832,165,590631,Сумська область
20028,590632,1799,17,976,764,212,590632,Сумська область
20029,590633,579,2,331,302,29,590633,Сумська область
20030,590634,1861,22,1133,900,233,590634,Сумська область
20031,590635,582,3,303,249,54,590635,Сумська область
20032,590636,1058,14,582,491,91,590636,Сумська область
20033,590637,714,9,433,368,65,590637,Сумська область
20034,590638,93,3,89,76,13,590638,Сумська область
20035,590896,2324,39,1588,1197,391,590896,Сумська область
20036,590897,2086,45,1335,1031,304,590897,Сумська область
20037,590898,2182,27,1405,1100,305,590898,Сумська область
20038,590899,2252,34,1479,1170,309,590899,Сумська область
20039,590900,2201,33,1415,1133,282,590900,Сумська область
20040,590901,1959,38,1312,1007,305,590901,Сумська область
20041,590902,2252,39,1568,1279,289,590902,Сумська область
20042,590903,2088,40,1378,1130,248,590903,Сумська область
20043,590904,2001,48,1357,1049,308,590904,Сумська область
20044,590905,2495,31,1627,1289,338,590905,Сумська область
20045,590906,2153,39,1368,1127,241,590906,Сумська область
20046,590907,1920,26,1225,938,287,590907,Сумська область
20047,590908,1837,31,1152,950,202,590908,Сумська область
20048,590909,1442,20,944,791,153,590909,Сумська область
20049,590910,1957,50,1228,990,238,590910,Сумська область
20050,590911,1974,32,1263,1025,238,590911,Сумська область
20051,590912,1509,18,980,794,186,590912,Сумська область
20052,590913,1539,17,1029,824,205,590913,Сумська область
20053,590914,2191,29,1432,1194,238,590914,Сумська область
20054,590915,2204,33,1341,1111,230,590915,Сумська область
20055,590916,1822,32,1150,923,227,590916,Сумська область
20056,590917,1907,33,1124,948,176,590917,Сумська область
20057,590918,2178,38,1273,1090,183,590918,Сумська область
20058,590919,2216,32,1407,1129,278,590919,Сумська область
20059,590920,2158,31,1355,1095,260,590920,Сумська область
20060,590921,1870,32,1133,938,195,590921,Сумська область
20061,590922,1884,27,1213,933,280,590922,Сумська область
20062,590923,1164,29,805,638,167,590923,Сумська область
20063,590924,2263,24,1419,1134,285,590924,Сумська область
20064,590925,2057,21,1376,1081,295,590925,Сумська область
20065,590944,14,0,14,13,1,590944,Сумська область
20066,590945,37,0,35,29,6,590945,Сумська область
20067,590946,8,0,8,5,3,590946,Сумська область
20068,591017,1173,18,727,596,131,591017,Сумська область
20069,590135,280,1,151,141,10,590135,Сумська область
20070,590136,402,6,234,212,22,590136,Сумська область
20071,590137,1156,5,600,562,38,590137,Сумська область
20072,590138,130,2,64,59,5,590138,Сумська область
20073,590139,578,8,294,267,27,590139,Сумська область
20074,590141,507,2,313,275,38,590141,Сумська область
20075,590142,566,7,349,322,27,590142,Сумська область
20076,590143,211,0,119,96,23,590143,Сумська область
20077,590144,792,6,432,389,43,590144,Сумська область
20078,590145,1057,14,632,551,81,590145,Сумська область
20079,590146,406,0,225,201,24,590146,Сумська область
20080,590147,844,9,504,423,81,590147,Сумська область
20081,590148,381,1,224,201,23,590148,Сумська область
20082,590149,641,7,412,361,51,590149,Сумська область
20083,590150,856,4,492,463,29,590150,Сумська область
20084,590151,481,4,341,262,79,590151,Сумська область
20085,590152,694,5,440,351,89,590152,Сумська область
20086,590153,267,5,148,122,26,590153,Сумська область
20087,590154,1052,16,681,588,93,590154,Сумська область
20088,590155,1095,14,632,568,64,590155,Сумська область
20089,590156,192,2,97,83,14,590156,Сумська область
20090,590157,228,1,158,144,14,590157,Сумська область
20091,590158,412,2,240,200,40,590158,Сумська область
20092,590159,1127,4,633,593,40,590159,Сумська область
20093,590160,239,0,143,130,13,590160,Сумська область
20094,590161,184,0,103,88,15,590161,Сумська область
20095,590162,485,0,240,211,29,590162,Сумська область
20096,590163,301,3,152,142,10,590163,Сумська область
20097,590164,198,3,109,94,15,590164,Сумська область
20098,590165,306,2,206,184,22,590165,Сумська область
20099,590166,146,0,79,71,8,590166,Сумська область
20100,590167,469,6,325,303,22,590167,Сумська область
20101,590168,184,3,116,105,11,590168,Сумська область
20102,590169,399,4,230,210,20,590169,Сумська область
20103,590170,457,2,250,236,14,590170,Сумська область
20104,590171,350,2,186,161,25,590171,Сумська область
20105,590176,457,1,285,253,32,590176,Сумська область
20106,590177,517,7,278,228,50,590177,Сумська область
20107,590181,642,12,392,319,73,590181,Сумська область
20108,590182,783,10,421,358,63,590182,Сумська область
20109,590183,205,2,145,119,26,590183,Сумська область
20110,590185,529,2,327,225,102,590185,Сумська область
20111,590188,335,2,195,179,16,590188,Сумська область
20112,590190,818,10,493,389,104,590190,Сумська область
20113,590191,312,4,186,153,33,590191,Сумська область
20114,590192,168,0,92,80,12,590192,Сумська область
20115,590196,614,6,308,269,39,590196,Сумська область
20116,590197,188,1,110,94,16,590197,Сумська область
20117,590198,239,1,125,97,28,590198,Сумська область
20118,590210,571,8,307,237,70,590210,Сумська область
20119,590213,231,5,156,128,28,590213,Сумська область
20120,590260,1387,12,841,708,133,590260,Сумська область
20121,590261,1292,14,759,618,141,590261,Сумська область
20122,590262,1378,22,802,653,149,590262,Сумська область
20123,590263,1050,16,588,497,91,590263,Сумська область
20124,590264,711,5,399,344,55,590264,Сумська область
20125,590265,1607,40,975,803,172,590265,Сумська область
20126,590266,704,8,377,314,63,590266,Сумська область
20127,590267,1392,16,795,658,137,590267,Сумська область
20128,590268,1463,21,848,711,137,590268,Сумська область
20129,590269,1256,17,726,586,140,590269,Сумська область
20130,590270,683,8,403,311,92,590270,Сумська область
20131,590271,1516,13,883,769,114,590271,Сумська область
20132,590272,1221,17,706,584,122,590272,Сумська область
20133,590273,1378,15,789,656,133,590273,Сумська область
20134,590274,563,7,323,293,30,590274,Сумська область
20135,590276,635,8,322,271,51,590276,Сумська область
20136,590277,310,3,150,108,42,590277,Сумська область
20137,590278,342,6,247,191,56,590278,Сумська область
20138,590280,564,6,286,239,47,590280,Сумська область
20139,590282,693,5,377,307,70,590282,Сумська область
20140,590283,280,3,132,94,38,590283,Сумська область
20141,590284,490,7,235,198,37,590284,Сумська область
20142,590287,421,4,244,206,38,590287,Сумська область
20143,590288,311,2,198,145,53,590288,Сумська область
20144,590291,803,5,453,380,73,590291,Сумська область
20145,590295,844,3,603,499,104,590295,Сумська область
20146,590296,447,2,251,211,40,590296,Сумська область
20147,590297,217,3,119,97,22,590297,Сумська область
20148,590298,581,3,405,360,45,590298,Сумська область
20149,590299,35,0,29,20,9,590299,Сумська область
20150,590432,1762,12,1068,989,79,590432,Сумська область
20151,590433,1892,19,1135,1055,80,590433,Сумська область
20152,590434,1841,14,1064,978,86,590434,Сумська область
20153,590435,1939,15,1085,978,107,590435,Сумська область
20154,590436,2067,19,1159,1080,79,590436,Сумська область
20155,590437,2026,24,1130,1056,74,590437,Сумська область
20156,590438,381,1,234,219,15,590438,Сумська область
20157,590439,299,0,192,173,19,590439,Сумська область
20158,590440,389,5,218,206,12,590440,Сумська область
20159,590441,300,1,188,176,12,590441,Сумська область
20160,590442,309,2,152,132,20,590442,Сумська область
20161,590443,190,4,115,107,8,590443,Сумська область
20162,590444,293,2,171,154,17,590444,Сумська область
20163,590445,84,0,43,39,4,590445,Сумська область
20164,590446,488,6,256,235,21,590446,Сумська область
20165,590447,354,5,241,228,13,590447,Сумська область
20166,590448,134,2,81,72,9,590448,Сумська область
20167,590449,145,0,76,57,19,590449,Сумська область
20168,590450,341,2,263,254,9,590450,Сумська область
20169,590451,557,4,324,297,27,590451,Сумська область
20170,590452,248,0,159,148,11,590452,Сумська область
20171,590453,163,0,96,76,20,590453,Сумська область
20172,590454,870,13,441,425,16,590454,Сумська область
20173,590455,330,6,200,175,25,590455,Сумська область
20174,590456,203,4,104,90,14,590456,Сумська область
20175,590457,228,2,145,138,7,590457,Сумська область
20176,590458,493,4,294,268,26,590458,Сумська область
20177,590459,260,2,148,123,25,590459,Сумська область
20178,590460,240,2,150,130,20,590460,Сумська область
20179,590461,206,1,132,118,14,590461,Сумська область
20180,590462,107,0,57,48,9,590462,Сумська область
20181,590463,128,0,64,55,9,590463,Сумська область
20182,590464,136,0,77,62,15,590464,Сумська область
20183,590465,240,1,122,102,20,590465,Сумська область
20184,590466,122,1,60,52,8,590466,Сумська область
20185,590467,294,0,190,175,15,590467,Сумська область
20186,590468,147,2,81,73,8,590468,Сумська область
20187,590469,287,1,185,160,25,590469,Сумська область
20188,590470,40,1,33,25,8,590470,Сумська область
20189,590544,1352,12,659,617,42,590544,Сумська область
20190,590545,1126,18,602,563,39,590545,Сумська область
20191,590546,773,7,397,380,17,590546,Сумська область
20192,590547,797,2,436,405,31,590547,Сумська область
20193,590548,658,10,359,335,24,590548,Сумська область
20194,590549,776,3,416,399,17,590549,Сумська область
20195,590550,163,0,92,85,7,590550,Сумська область
20196,590551,96,2,54,45,9,590551,Сумська область
20197,590552,188,0,105,98,7,590552,Сумська область
20198,590553,140,2,85,80,5,590553,Сумська область
20199,590554,194,0,139,126,13,590554,Сумська область
20200,590555,212,2,128,118,10,590555,Сумська область
20201,590556,425,4,280,260,20,590556,Сумська область
20202,590557,262,6,150,137,13,590557,Сумська область
20203,590558,119,0,65,58,7,590558,Сумська область
20204,590559,51,0,38,37,1,590559,Сумська область
20205,590561,466,2,265,247,18,590561,Сумська область
20206,590562,144,1,103,86,17,590562,Сумська область
20207,590563,274,2,161,137,24,590563,Сумська область
20208,590564,155,0,104,95,9,590564,Сумська область
20209,590565,184,0,148,129,19,590565,Сумська область
20210,590566,39,2,28,23,5,590566,Сумська область
20211,590567,173,0,109,95,14,590567,Сумська область
20212,590568,257,2,172,150,22,590568,Сумська область
20213,590569,189,0,109,92,17,590569,Сумська область
20214,590570,215,3,112,97,15,590570,Сумська область
20215,590571,192,1,76,72,4,590571,Сумська область
20216,590572,298,4,165,152,13,590572,Сумська область
20217,590573,761,5,412,377,35,590573,Сумська область
20218,590574,663,5,381,352,29,590574,Сумська область
20219,590575,113,0,72,65,7,590575,Сумська область
20220,590576,93,1,73,63,10,590576,Сумська область
20221,590577,147,0,90,85,5,590577,Сумська область
20222,590578,200,4,117,101,16,590578,Сумська область
20223,590579,67,0,48,43,5,590579,Сумська область
20224,590581,28,0,24,19,5,590581,Сумська область
20225,590679,654,10,376,339,37,590679,Сумська область
20226,590680,375,6,221,200,21,590680,Сумська область
20227,590681,279,3,145,121,24,590681,Сумська область
20228,590682,134,0,88,62,26,590682,Сумська область
20229,590683,416,2,231,207,24,590683,Сумська область
20230,590684,97,1,54,45,9,590684,Сумська область
20231,590685,235,0,141,112,29,590685,Сумська область
20232,590686,608,5,330,293,37,590686,Сумська область
20233,590687,161,1,70,58,12,590687,Сумська область
20234,590688,569,2,246,216,30,590688,Сумська область
20235,590694,390,8,241,216,25,590694,Сумська область
20236,590695,632,6,385,356,29,590695,Сумська область
20237,590696,610,4,386,332,54,590696,Сумська область
20238,590697,991,12,511,455,56,590697,Сумська область
20239,590698,895,4,447,407,40,590698,Сумська область
20240,590699,464,3,247,218,29,590699,Сумська область
20241,590704,1345,10,733,666,67,590704,Сумська область
20242,590705,1105,11,645,545,100,590705,Сумська область
20243,590706,1309,19,706,643,63,590706,Сумська область
20244,590707,1166,13,556,503,53,590707,Сумська область
20245,590708,456,9,275,245,30,590708,Сумська область
20246,590709,227,1,126,110,16,590709,Сумська область
20247,590710,341,0,190,179,11,590710,Сумська область
20248,590711,632,7,375,341,34,590711,Сумська область
20249,590712,289,1,145,129,16,590712,Сумська область
20250,590713,803,11,441,386,55,590713,Сумська область
20251,590714,404,5,233,198,35,590714,Сумська область
20252,590715,287,4,177,136,41,590715,Сумська область
20253,590716,583,2,349,328,21,590716,Сумська область
20254,590717,934,7,597,569,28,590717,Сумська область
20255,590718,220,3,143,132,11,590718,Сумська область
20256,590719,687,2,359,341,18,590719,Сумська область
20257,590720,1122,6,614,581,33,590720,Сумська область
20258,590721,1110,10,667,582,85,590721,Сумська область
20259,590722,1368,21,877,775,102,590722,Сумська область
20260,590723,1273,16,687,599,88,590723,Сумська область
20261,590724,217,4,111,95,16,590724,Сумська область
20262,590725,201,1,112,104,8,590725,Сумська область
20263,590726,272,3,204,138,66,590726,Сумська область
20264,590727,156,2,96,84,12,590727,Сумська область
20265,590728,188,1,115,105,10,590728,Сумська область
20266,590729,182,1,104,90,14,590729,Сумська область
20267,590730,451,1,247,224,23,590730,Сумська область
20268,590731,407,2,244,236,8,590731,Сумська область
20269,590732,556,4,287,254,33,590732,Сумська область
20270,590733,21,0,20,13,7,590733,Сумська область
20271,590734,1815,23,1116,1007,109,590734,Сумська область
20272,590735,1850,21,1221,1079,142,590735,Сумська область
20273,590736,1350,12,812,734,78,590736,Сумська область
20274,590737,1976,32,1291,1124,167,590737,Сумська область
20275,590738,1428,18,883,770,113,590738,Сумська область
20276,590739,1122,19,667,583,84,590739,Сумська область
20277,590740,1248,26,806,721,85,590740,Сумська область
20278,590741,1213,17,736,626,110,590741,Сумська область
20279,590742,1222,13,769,666,103,590742,Сумська область
20280,590743,1955,19,1291,1050,241,590743,Сумська область
20281,590744,186,5,145,136,9,590744,Сумська область
20282,590745,1339,15,820,740,80,590745,Сумська область
20283,590746,1859,20,1090,978,112,590746,Сумська область
20284,590747,1450,6,915,841,74,590747,Сумська область
20285,590748,1354,27,815,702,113,590748,Сумська область
20286,590749,1660,15,1035,931,104,590749,Сумська область
20287,590750,25,0,24,19,5,590750,Сумська область
20288,590751,101,9,91,80,11,590751,Сумська область
20289,590179,1059,15,617,521,96,590179,Сумська область
20290,590180,974,9,565,498,67,590180,Сумська область
20291,590200,241,1,144,116,28,590200,Сумська область
20292,590207,163,5,115,88,27,590207,Сумська область
20293,590208,381,6,223,171,52,590208,Сумська область
20294,590275,974,13,460,388,72,590275,Сумська область
20295,590279,206,0,76,55,21,590279,Сумська область
20296,590281,400,5,199,157,42,590281,Сумська область
20297,590285,174,1,104,71,33,590285,Сумська область
20298,590286,606,6,355,264,91,590286,Сумська область
20299,590289,111,0,73,58,15,590289,Сумська область
20300,590290,149,1,80,57,23,590290,Сумська область
20301,590292,487,5,325,249,76,590292,Сумська область
20302,590293,442,7,230,176,54,590293,Сумська область
20303,590294,647,6,344,297,47,590294,Сумська область
20304,590675,1766,15,914,802,112,590675,Сумська область
20305,590676,1291,9,723,642,81,590676,Сумська область
20306,590677,1945,17,1090,930,160,590677,Сумська область
20307,590678,582,1,341,298,43,590678,Сумська область
20308,590689,280,0,217,187,30,590689,Сумська область
20309,590690,528,3,274,240,34,590690,Сумська область
20310,590691,614,3,362,314,48,590691,Сумська область
20311,590692,131,0,74,64,10,590692,Сумська область
20312,590693,545,2,331,275,56,590693,Сумська область
20313,590700,219,1,133,114,19,590700,Сумська область
20314,590701,278,4,182,157,25,590701,Сумська область
20315,590702,829,2,501,439,62,590702,Сумська область
20316,590752,1502,17,853,771,82,590752,Сумська область
20317,590753,1909,27,1053,953,100,590753,Сумська область
20318,590754,1848,20,1046,911,135,590754,Сумська область
20319,590755,1518,29,949,832,117,590755,Сумська область
20320,590756,1473,21,906,776,130,590756,Сумська область
20321,590758,2153,45,1404,1063,341,590758,Сумська область
20322,590759,2425,41,1522,1291,231,590759,Сумська область
20323,590760,1896,24,1189,1033,156,590760,Сумська область
20324,590761,1862,25,1108,934,174,590761,Сумська область
20325,590762,1994,25,1210,1062,148,590762,Сумська область
20326,590763,1996,28,1249,1044,205,590763,Сумська область
20327,590764,1858,23,1101,938,163,590764,Сумська область
20328,590765,1329,17,813,711,102,590765,Сумська область
20329,590766,2058,29,1246,1078,168,590766,Сумська область
20330,590767,2137,30,1324,1141,183,590767,Сумська область
20331,590768,1763,33,1053,913,140,590768,Сумська область
20332,590769,1880,22,1113,939,174,590769,Сумська область
20333,590770,1929,34,1194,1022,172,590770,Сумська область
20334,590771,1853,23,1173,985,188,590771,Сумська область
20335,590772,1991,28,1166,1024,142,590772,Сумська область
20336,590773,1989,22,1187,1001,186,590773,Сумська область
20337,590774,2060,42,1164,1017,147,590774,Сумська область
20338,590775,2058,40,1233,1069,164,590775,Сумська область
20339,590778,1924,22,1168,1033,135,590778,Сумська область
20340,590779,1555,23,937,819,118,590779,Сумська область
20341,590780,1944,29,1107,988,119,590780,Сумська область
20342,590781,2044,30,1128,988,140,590781,Сумська область
20343,590782,2019,34,1129,962,167,590782,Сумська область
20344,590783,2011,27,1140,985,155,590783,Сумська область
20345,590784,1430,24,773,683,90,590784,Сумська область
20346,590785,1539,11,754,650,104,590785,Сумська область
20347,590786,1757,5,892,806,86,590786,Сумська область
20348,590787,1954,27,1200,1031,169,590787,Сумська область
20349,590788,24,0,24,20,4,590788,Сумська область
20350,590789,135,5,110,96,14,590789,Сумська область
20351,590790,142,7,135,132,3,590790,Сумська область
20352,590852,719,8,407,360,47,590852,Сумська область
20353,590853,2061,37,1233,1111,122,590853,Сумська область
20354,590854,2127,26,1268,1125,143,590854,Сумська область
20355,590855,2004,19,1216,1081,135,590855,Сумська область
20356,590856,2226,34,1252,1094,158,590856,Сумська область
20357,590857,2122,26,1300,1143,157,590857,Сумська область
20358,590858,2055,25,1212,1074,138,590858,Сумська область
20359,590859,1758,17,1116,949,167,590859,Сумська область
20360,590860,978,15,627,534,93,590860,Сумська область
20361,590861,1586,28,948,828,120,590861,Сумська область
20362,590862,2194,28,1273,1100,173,590862,Сумська область
20363,590863,1157,20,742,643,99,590863,Сумська область
20364,590864,1880,26,1102,970,132,590864,Сумська область
20365,590865,2154,31,1269,1128,141,590865,Сумська область
20366,590866,1435,12,815,732,83,590866,Сумська область
20367,590867,1641,13,997,884,113,590867,Сумська область
20368,590868,1734,13,1099,977,122,590868,Сумська область
20369,590869,2089,18,1140,1001,139,590869,Сумська область
20370,590870,1569,19,957,825,132,590870,Сумська область
20371,590871,1366,16,819,722,97,590871,Сумська область
20372,590872,1655,15,1058,920,138,590872,Сумська область
20373,590873,2053,27,1238,1102,136,590873,Сумська область
20374,590874,2025,34,1246,1096,150,590874,Сумська область
20375,590875,2134,28,1327,1149,178,590875,Сумська область
20376,590876,2177,35,1342,1193,149,590876,Сумська область
20377,590877,1653,20,957,821,136,590877,Сумська область
20378,590878,2161,34,1301,1175,126,590878,Сумська область
20379,590879,1767,22,1060,972,88,590879,Сумська область
20380,590880,1483,8,914,828,86,590880,Сумська область
20381,590881,1313,13,747,670,77,590881,Сумська область
20382,590882,2165,29,1358,1211,147,590882,Сумська область
20383,590883,62,0,60,58,2,590883,Сумська область
20384,590060,2317,10,1269,1047,222,590060,Сумська область
20385,590061,2253,22,1353,1110,243,590061,Сумська область
20386,590062,2167,15,1179,997,182,590062,Сумська область
20387,590063,1802,24,987,758,229,590063,Сумська область
20388,590064,376,8,257,200,57,590064,Сумська область
20389,590065,62,0,48,34,14,590065,Сумська область
20390,590066,144,3,101,79,22,590066,Сумська область
20391,590067,124,0,84,66,18,590067,Сумська область
20392,590068,355,2,260,204,56,590068,Сумська область
20393,590069,608,6,376,313,63,590069,Сумська область
20394,590070,428,4,238,196,42,590070,Сумська область
20395,590072,426,0,288,250,38,590072,Сумська область
20396,590073,109,0,73,54,19,590073,Сумська область
20397,590074,457,7,264,199,65,590074,Сумська область
20398,590075,529,2,337,297,40,590075,Сумська область
20399,590076,336,3,283,258,25,590076,Сумська область
20400,590077,187,1,147,119,28,590077,Сумська область
20401,590078,461,1,290,238,52,590078,Сумська область
20402,590079,295,2,202,143,59,590079,Сумська область
20403,590080,265,2,178,154,24,590080,Сумська область
20404,590081,620,4,364,307,57,590081,Сумська область
20405,590082,937,8,544,466,78,590082,Сумська область
20406,590083,822,7,502,426,76,590083,Сумська область
20407,590084,355,6,243,162,81,590084,Сумська область
20408,590085,493,4,334,271,63,590085,Сумська область
20409,590086,458,4,267,221,46,590086,Сумська область
20410,590087,1156,9,682,569,113,590087,Сумська область
20411,590088,411,3,260,222,38,590088,Сумська область
20412,590089,81,0,64,46,18,590089,Сумська область
20413,590090,96,1,65,46,19,590090,Сумська область
20414,590091,1103,3,585,512,73,590091,Сумська область
20415,590092,155,0,99,80,19,590092,Сумська область
20416,590093,462,5,258,184,74,590093,Сумська область
20417,590094,979,3,723,609,114,590094,Сумська область
20418,590095,25,1,16,14,2,590095,Сумська область
20419,590172,1203,13,673,596,77,590172,Сумська область
20420,590173,870,9,513,443,70,590173,Сумська область
20421,590174,587,5,381,308,73,590174,Сумська область
20422,590175,119,0,78,63,15,590175,Сумська область
20423,590178,750,6,355,298,57,590178,Сумська область
20424,590184,561,9,311,269,42,590184,Сумська область
20425,590187,446,0,307,253,54,590187,Сумська область
20426,590189,283,0,173,128,45,590189,Сумська область
20427,590193,413,1,318,249,69,590193,Сумська область
20428,590194,216,2,146,125,21,590194,Сумська область
20429,590195,193,1,141,111,30,590195,Сумська область
20430,590199,365,0,215,191,24,590199,Сумська область
20431,590201,167,1,86,59,27,590201,Сумська область
20432,590202,374,3,274,221,53,590202,Сумська область
20433,590203,949,16,497,446,51,590203,Сумська область
20434,590204,829,20,468,394,74,590204,Сумська область
20435,590205,1046,9,508,461,47,590205,Сумська область
20436,590206,331,3,204,176,28,590206,Сумська область
20437,590209,554,4,332,255,77,590209,Сумська область
20438,590211,794,8,432,379,53,590211,Сумська область
20439,590212,383,2,236,189,47,590212,Сумська область
20440,590214,1042,15,592,496,96,590214,Сумська область
20441,590215,406,2,236,199,37,590215,Сумська область
20442,590216,347,3,207,155,52,590216,Сумська область
20443,590217,152,2,100,67,33,590217,Сумська область
20444,590218,511,4,352,259,93,590218,Сумська область
20445,590329,583,3,397,305,92,590329,Сумська область
20446,590330,549,6,445,243,202,590330,Сумська область
20447,590331,562,2,369,306,63,590331,Сумська область
20448,590332,634,6,368,310,58,590332,Сумська область
20449,590333,568,7,381,334,47,590333,Сумська область
20450,590334,283,4,222,153,69,590334,Сумська область
20451,590335,507,6,355,286,69,590335,Сумська область
20452,590336,131,0,109,88,21,590336,Сумська область
20453,590337,1110,22,718,631,87,590337,Сумська область
20454,590338,1364,14,842,715,127,590338,Сумська область
20455,590339,1536,21,946,805,141,590339,Сумська область
20456,590340,222,2,169,142,27,590340,Сумська область
20457,590341,520,1,391,299,92,590341,Сумська область
20458,590342,743,15,432,330,102,590342,Сумська область
20459,590343,483,6,361,292,69,590343,Сумська область
20460,590344,161,0,122,104,18,590344,Сумська область
20461,590345,412,6,254,209,45,590345,Сумська область
20462,590346,503,6,350,320,30,590346,Сумська область
20463,590347,672,10,434,371,63,590347,Сумська область
20464,590348,641,3,470,394,76,590348,Сумська область
20465,590349,570,9,415,342,73,590349,Сумська область
20466,590350,914,11,604,484,120,590350,Сумська область
20467,590351,341,6,238,194,44,590351,Сумська область
20468,590352,466,8,323,270,53,590352,Сумська область
20469,590353,27,1,26,19,7,590353,Сумська область
20470,590354,1079,9,715,575,140,590354,Сумська область
20471,590355,1233,9,805,660,145,590355,Сумська область
20472,590356,867,11,558,461,97,590356,Сумська область
20473,590357,699,16,481,395,86,590357,Сумська область
20474,590358,607,8,412,338,74,590358,Сумська область
20475,590359,401,1,282,228,54,590359,Сумська область
20476,590360,647,8,447,367,80,590360,Сумська область
20477,590361,462,3,302,229,73,590361,Сумська область
20478,590362,703,2,436,338,98,590362,Сумська область
20479,590363,722,6,476,395,81,590363,Сумська область
20480,590364,435,3,288,225,63,590364,Сумська область
20481,590365,1008,9,664,552,112,590365,Сумська область
20482,590366,820,12,574,487,87,590366,Сумська область
20483,590367,233,6,155,123,32,590367,Сумська область
20484,590368,385,13,264,224,40,590368,Сумська область
20485,590369,693,10,480,413,67,590369,Сумська область
20486,590370,174,2,118,100,18,590370,Сумська область
20487,590371,210,0,162,151,11,590371,Сумська область
20488,590372,390,7,300,218,82,590372,Сумська область
20489,590373,367,0,255,198,57,590373,Сумська область
20490,590374,262,2,191,144,47,590374,Сумська область
20491,590375,369,4,262,222,40,590375,Сумська область
20492,590376,184,3,138,108,30,590376,Сумська область
20493,590377,174,2,129,101,28,590377,Сумська область
20494,590378,1138,13,728,582,146,590378,Сумська область
20495,590379,867,8,526,435,91,590379,Сумська область
20496,590380,90,0,62,44,18,590380,Сумська область
20497,590381,105,2,67,52,15,590381,Сумська область
20498,590382,264,4,173,122,51,590382,Сумська область
20499,590383,428,6,298,233,65,590383,Сумська область
20500,590384,304,3,213,176,37,590384,Сумська область
20501,590385,268,4,210,167,43,590385,Сумська область
20502,590386,169,1,118,62,56,590386,Сумська область
20503,590387,278,1,210,163,47,590387,Сумська область
20504,590388,117,0,79,45,34,590388,Сумська область
20505,590389,336,6,237,172,65,590389,Сумська область
20506,590390,229,1,154,79,75,590390,Сумська область
20507,590391,66,1,44,36,8,590391,Сумська область
20508,590392,65,2,51,25,26,590392,Сумська область
20509,590393,697,3,486,406,80,590393,Сумська область
20510,590395,260,2,179,146,33,590395,Сумська область
20511,590396,106,0,74,53,21,590396,Сумська область
20512,590397,35,2,28,25,3,590397,Сумська область
20513,590471,488,1,350,305,45,590471,Сумська область
20514,590472,255,5,161,129,32,590472,Сумська область
20515,590473,117,1,79,54,25,590473,Сумська область
20516,590474,272,5,197,152,45,590474,Сумська область
20517,590475,724,12,458,345,113,590475,Сумська область
20518,590476,681,8,403,330,73,590476,Сумська область
20519,590477,413,6,287,244,43,590477,Сумська область
20520,590478,238,4,143,113,30,590478,Сумська область
20521,590479,400,2,230,182,48,590479,Сумська область
20522,590480,388,10,260,223,37,590480,Сумська область
20523,590481,197,0,107,81,26,590481,Сумська область
20524,590483,787,13,503,415,88,590483,Сумська область
20525,590484,108,0,63,46,17,590484,Сумська область
20526,590485,1409,17,882,744,138,590485,Сумська область
20527,590486,453,3,304,191,113,590486,Сумська область
20528,590487,912,11,569,436,133,590487,Сумська область
20529,590488,103,0,74,61,13,590488,Сумська область
20530,590489,180,2,113,91,22,590489,Сумська область
20531,590490,345,3,242,208,34,590490,Сумська область
20532,590491,240,0,158,114,44,590491,Сумська область
20533,590492,823,12,534,421,113,590492,Сумська область
20534,590493,133,0,110,90,20,590493,Сумська область
20535,590494,351,7,196,163,33,590494,Сумська область
20536,590495,200,2,131,103,28,590495,Сумська область
20537,590496,95,0,65,47,18,590496,Сумська область
20538,590497,228,2,147,127,20,590497,Сумська область
20539,590498,114,0,75,60,15,590498,Сумська область
20540,590499,104,0,79,65,14,590499,Сумська область
20541,590500,207,5,141,122,19,590500,Сумська область
20542,590501,52,0,31,23,8,590501,Сумська область
20543,590502,204,4,125,109,16,590502,Сумська область
20544,590503,135,1,86,59,27,590503,Сумська область
20545,590504,986,14,693,574,119,590504,Сумська область
20546,590505,317,2,207,152,55,590505,Сумська область
20547,590506,535,9,297,241,56,590506,Сумська область
20548,590507,196,2,118,83,35,590507,Сумська область
20549,590508,74,0,58,46,12,590508,Сумська область
20550,590509,249,3,155,131,24,590509,Сумська область
20551,590510,362,3,224,186,38,590510,Сумська область
20552,590511,505,0,302,262,40,590511,Сумська область
20553,590512,523,7,333,280,53,590512,Сумська область
20554,590513,322,4,215,181,34,590513,Сумська область
20555,590514,197,1,129,84,45,590514,Сумська область
20556,590515,214,3,130,110,20,590515,Сумська область
20557,590517,981,8,589,469,120,590517,Сумська область
20558,590518,1038,8,721,563,158,590518,Сумська область
20559,590519,357,4,198,164,34,590519,Сумська область
20560,590520,151,3,106,80,26,590520,Сумська область
20561,590521,908,11,563,491,72,590521,Сумська область
20562,590522,270,3,176,156,20,590522,Сумська область
20563,590523,139,0,90,61,29,590523,Сумська область
20564,590524,427,4,271,240,31,590524,Сумська область
20565,590525,864,10,532,462,70,590525,Сумська область
20566,590526,260,4,157,131,26,590526,Сумська область
20567,590527,949,16,614,516,98,590527,Сумська область
20568,590528,199,1,145,113,32,590528,Сумська область
20569,590529,354,5,226,187,39,590529,Сумська область
20570,590530,219,0,145,119,26,590530,Сумська область
20571,590531,910,13,487,389,98,590531,Сумська область
20572,590532,277,4,174,137,37,590532,Сумська область
20573,590534,584,10,369,282,87,590534,Сумська область
20574,590535,571,6,358,278,80,590535,Сумська область
20575,590536,246,3,158,126,32,590536,Сумська область
20576,590537,139,3,88,62,26,590537,Сумська область
20577,590538,583,4,383,322,61,590538,Сумська область
20578,590539,360,3,236,203,33,590539,Сумська область
20579,590540,276,5,183,157,26,590540,Сумська область
20580,590541,194,4,116,96,20,590541,Сумська область
20581,590542,334,5,242,200,42,590542,Сумська область
20582,590543,557,24,532,508,24,590543,Сумська область
20583,590827,1553,18,991,827,164,590827,Сумська область
20584,590828,1578,19,1039,861,178,590828,Сумська область
20585,590829,1665,31,1038,864,174,590829,Сумська область
20586,590830,1627,33,1048,845,203,590830,Сумська область
20587,590831,1684,33,1053,870,183,590831,Сумська область
20588,590832,1587,20,1050,859,191,590832,Сумська область
20589,590833,1561,22,970,753,217,590833,Сумська область
20590,590834,1422,15,903,738,165,590834,Сумська область
20591,590835,1415,14,926,768,158,590835,Сумська область
20592,590836,1388,17,852,724,128,590836,Сумська область
20593,590837,1335,18,847,747,100,590837,Сумська область
20594,590838,1563,32,972,810,162,590838,Сумська область
20595,590839,1524,23,966,790,176,590839,Сумська область
20596,590840,1457,21,922,769,153,590840,Сумська область
20597,590841,1529,13,870,750,120,590841,Сумська область
20598,590842,1334,20,787,656,131,590842,Сумська область
20599,590843,1313,16,833,659,174,590843,Сумська область
20600,590844,1460,26,854,710,144,590844,Сумська область
20601,590845,1713,19,1048,894,154,590845,Сумська область
20602,590846,1705,22,1133,948,185,590846,Сумська область
20603,590847,1769,22,1105,953,152,590847,Сумська область
20604,590848,1796,14,1115,979,136,590848,Сумська область
20605,590849,1806,23,1089,932,157,590849,Сумська область
20606,590850,28,1,26,23,3,590850,Сумська область
20607,590851,68,2,64,59,5,590851,Сумська область
20608,590096,860,17,544,469,75,590096,Сумська область
20609,590097,621,8,359,292,67,590097,Сумська область
20610,590098,831,5,500,436,64,590098,Сумська область
20611,590099,949,9,575,504,71,590099,Сумська область
20612,590100,463,2,288,247,41,590100,Сумська область
20613,590101,778,1,465,403,62,590101,Сумська область
20614,590102,595,2,349,299,50,590102,Сумська область
20615,590103,460,3,341,319,22,590103,Сумська область
20616,590104,671,2,448,397,51,590104,Сумська область
20617,590105,319,2,186,150,36,590105,Сумська область
20618,590106,178,0,97,79,18,590106,Сумська область
20619,590107,540,4,352,320,32,590107,Сумська область
20620,590108,123,2,64,50,14,590108,Сумська область
20621,590109,125,0,83,74,9,590109,Сумська область
20622,590110,167,1,109,93,16,590110,Сумська область
20623,590111,239,1,159,128,31,590111,Сумська область
20624,590112,61,1,44,36,8,590112,Сумська область
20625,590113,213,0,130,116,14,590113,Сумська область
20626,590115,584,7,334,313,21,590115,Сумська область
20627,590116,212,2,156,133,23,590116,Сумська область
20628,590117,794,7,491,446,45,590117,Сумська область
20629,590118,229,2,131,112,19,590118,Сумська область
20630,590119,47,0,34,26,8,590119,Сумська область
20631,590120,422,5,271,245,26,590120,Сумська область
20632,590121,553,6,349,275,74,590121,Сумська область
20633,590122,268,1,190,149,41,590122,Сумська область
20634,590123,64,0,42,36,6,590123,Сумська область
20635,590124,345,0,209,188,21,590124,Сумська область
20636,590125,509,7,330,253,77,590125,Сумська область
20637,590126,480,5,291,248,43,590126,Сумська область
20638,590127,430,5,267,237,30,590127,Сумська область
20639,590128,199,1,155,134,21,590128,Сумська область
20640,590129,472,3,293,270,23,590129,Сумська область
20641,590130,726,8,442,356,86,590130,Сумська область
20642,590131,594,5,375,309,66,590131,Сумська область
20643,590132,380,3,239,188,51,590132,Сумська область
20644,590133,162,1,102,73,29,590133,Сумська область
20645,590134,20,0,18,12,6,590134,Сумська область
20646,590300,654,3,374,284,90,590300,Сумська область
20647,590301,377,3,243,207,36,590301,Сумська область
20648,590302,780,6,418,361,57,590302,Сумська область
20649,590303,835,3,487,411,76,590303,Сумська область
20650,590304,987,6,567,481,86,590304,Сумська область
20651,590305,570,6,347,295,52,590305,Сумська область
20652,590306,1279,10,730,625,105,590306,Сумська область
20653,590308,154,0,99,84,15,590308,Сумська область
20654,590309,268,1,162,134,28,590309,Сумська область
20655,590310,805,24,521,441,80,590310,Сумська область
20656,590311,577,6,381,312,69,590311,Сумська область
20657,590312,415,2,264,231,33,590312,Сумська область
20658,590314,431,3,262,197,65,590314,Сумська область
20659,590315,404,2,251,222,29,590315,Сумська область
20660,590316,401,3,249,203,46,590316,Сумська область
20661,590317,58,0,38,29,9,590317,Сумська область
20662,590318,772,10,522,426,96,590318,Сумська область
20663,590319,888,5,466,411,55,590319,Сумська область
20664,590320,678,5,455,392,63,590320,Сумська область
20665,590321,340,3,236,214,22,590321,Сумська область
20666,590322,566,8,365,308,57,590322,Сумська область
20667,590323,235,4,171,145,26,590323,Сумська область
20668,590324,455,3,336,312,24,590324,Сумська область
20669,590325,454,0,271,243,28,590325,Сумська область
20670,590326,627,6,367,317,50,590326,Сумська область
20671,590327,365,2,240,212,28,590327,Сумська область
20672,590328,821,8,527,447,80,590328,Сумська область
20673,590398,1703,18,970,865,105,590398,Сумська область
20674,590399,345,2,215,193,22,590399,Сумська область
20675,590400,279,5,152,111,41,590400,Сумська область
20676,590401,185,3,120,77,43,590401,Сумська область
20677,590402,626,10,364,295,69,590402,Сумська область
20678,590403,978,4,597,540,57,590403,Сумська область
20679,590404,464,1,306,266,40,590404,Сумська область
20680,590405,169,0,102,79,23,590405,Сумська область
20681,590406,241,1,136,121,15,590406,Сумська область
20682,590407,390,10,260,234,26,590407,Сумська область
20683,590408,1427,17,883,778,105,590408,Сумська область
20684,590409,565,6,364,323,41,590409,Сумська область
20685,590410,1244,10,799,693,106,590410,Сумська область
20686,590411,278,1,198,166,32,590411,Сумська область
20687,590412,982,10,733,584,149,590412,Сумська область
20688,590413,607,8,359,310,49,590413,Сумська область
20689,590414,490,0,290,240,50,590414,Сумська область
20690,590415,283,2,202,144,58,590415,Сумська область
20691,590416,154,1,94,86,8,590416,Сумська область
20692,590417,264,2,172,134,38,590417,Сумська область
20693,590418,128,1,78,58,20,590418,Сумська область
20694,590419,997,18,611,537,74,590419,Сумська область
20695,590420,355,4,232,186,46,590420,Сумська область
20696,590421,629,6,373,332,41,590421,Сумська область
20697,590422,169,1,100,94,6,590422,Сумська область
20698,590423,733,7,448,376,72,590423,Сумська область
20699,590424,618,4,438,398,40,590424,Сумська область
20700,590425,871,6,539,446,93,590425,Сумська область
20701,590426,337,2,172,133,39,590426,Сумська область
20702,590427,472,5,312,255,57,590427,Сумська область
20703,590428,1453,24,904,803,101,590428,Сумська область
20704,590429,1508,22,980,837,143,590429,Сумська область
20705,590430,243,4,120,99,21,590430,Сумська область
20706,590431,248,6,186,151,35,590431,Сумська область
20707,590639,2310,29,1462,1203,259,590639,Сумська область
20708,590640,2294,35,1476,1156,320,590640,Сумська область
20709,590641,2319,19,1490,1236,254,590641,Сумська область
20710,590642,2206,27,1380,1133,247,590642,Сумська область
20711,590643,2314,24,1400,1200,200,590643,Сумська область
20712,590644,2210,18,1287,1096,191,590644,Сумська область
20713,590645,1764,19,1018,866,152,590645,Сумська область
20714,590646,792,10,461,428,33,590646,Сумська область
20715,590647,1037,5,781,666,115,590647,Сумська область
20716,590648,289,2,205,154,51,590648,Сумська область
20717,590649,169,0,119,96,23,590649,Сумська область
20718,590650,174,2,110,87,23,590650,Сумська область
20719,590651,1154,21,612,521,91,590651,Сумська область
20720,590652,1036,7,553,460,93,590652,Сумська область
20721,590653,855,7,527,458,69,590653,Сумська область
20722,590654,318,3,196,152,44,590654,Сумська область
20723,590655,389,2,253,220,33,590655,Сумська область
20724,590656,690,11,453,384,69,590656,Сумська область
20725,590657,230,3,150,138,12,590657,Сумська область
20726,590658,530,6,340,263,77,590658,Сумська область
20727,590659,89,0,58,50,8,590659,Сумська область
20728,590660,128,0,89,73,16,590660,Сумська область
20729,590661,673,5,421,331,90,590661,Сумська область
20730,590662,105,1,71,50,21,590662,Сумська область
20731,590663,284,8,155,130,25,590663,Сумська область
20732,590664,313,2,214,201,13,590664,Сумська область
20733,590665,137,1,79,73,6,590665,Сумська область
20734,590666,212,0,155,130,25,590666,Сумська область
20735,590667,144,0,102,90,12,590667,Сумська область
20736,590668,164,0,110,96,14,590668,Сумська область
20737,590669,346,2,223,208,15,590669,Сумська область
20738,590670,231,3,161,143,18,590670,Сумська область
20739,590671,154,0,92,77,15,590671,Сумська область
20740,590672,272,2,161,149,12,590672,Сумська область
20741,590673,561,7,348,301,47,590673,Сумська область
20742,590674,45,2,41,38,3,590674,Сумська область
20743,590791,1752,35,1053,923,130,590791,Сумська область
20744,590792,1612,30,1023,925,98,590792,Сумська область
20745,590793,1732,29,1039,885,154,590793,Сумська область
20746,590794,1023,16,601,506,95,590794,Сумська область
20747,590795,1519,25,952,797,155,590795,Сумська область
20748,590796,1569,22,960,824,136,590796,Сумська область
20749,590797,1760,28,998,889,109,590797,Сумська область
20750,590798,1689,21,1005,879,126,590798,Сумська область
20751,590799,1014,16,572,513,59,590799,Сумська область
20752,590800,1471,26,825,728,97,590800,Сумська область
20753,590801,1590,24,901,790,111,590801,Сумська область
20754,590802,1589,16,939,818,121,590802,Сумська область
20755,590803,1779,17,1089,942,147,590803,Сумська область
20756,590804,239,8,122,103,19,590804,Сумська область
20757,590805,187,2,93,82,11,590805,Сумська область
20758,590806,36,1,30,28,2,590806,Сумська область
20759,590807,2288,22,1427,1224,203,590807,Сумська область
20760,590808,2256,33,1459,1264,195,590808,Сумська область
20761,590809,2127,27,1385,1208,177,590809,Сумська область
20762,590810,2220,19,1378,1214,164,590810,Сумська область
20763,590811,1864,19,1129,972,157,590811,Сумська область
20764,590813,2064,30,1446,1232,214,590813,Сумська область
20765,590814,2210,26,1439,1223,216,590814,Сумська область
20766,590815,1505,11,989,864,125,590815,Сумська область
20767,590816,1630,18,1055,891,164,590816,Сумська область
20768,590817,2278,34,1441,1264,177,590817,Сумська область
20769,590818,1944,15,1278,1105,173,590818,Сумська область
20770,590819,1287,17,783,672,111,590819,Сумська область
20771,590820,2150,25,1375,1183,192,590820,Сумська область
20772,590821,2257,28,1422,1236,186,590821,Сумська область
20773,590822,2054,37,1306,1101,205,590822,Сумська область
20774,590823,1906,34,1223,1072,151,590823,Сумська область
20775,590824,1729,16,1112,968,144,590824,Сумська область
20776,590825,1569,25,976,858,118,590825,Сумська область
20777,590826,47,2,41,32,9,590826,Сумська область
20778,611096,2316,54,1272,645,627,611096,Тернопільська область
20779,611097,2299,46,1252,638,614,611097,Тернопільська область
20780,611098,2419,65,1438,681,757,611098,Тернопільська область
20781,611099,2401,62,1453,706,747,611099,Тернопільська область
20782,611100,2331,52,1255,672,583,611100,Тернопільська область
20783,611101,2468,55,1489,754,735,611101,Тернопільська область
20784,611102,2427,59,1532,729,803,611102,Тернопільська область
20785,611103,2400,53,1425,725,700,611103,Тернопільська область
20786,611104,2184,64,1303,627,676,611104,Тернопільська область
20787,611105,2116,60,1283,606,677,611105,Тернопільська область
20788,611106,2439,65,1433,742,691,611106,Тернопільська область
20789,611107,2483,57,1412,666,746,611107,Тернопільська область
20790,611108,2430,57,1391,666,725,611108,Тернопільська область
20791,611109,1567,38,963,501,462,611109,Тернопільська область
20792,611110,1672,67,1036,545,491,611110,Тернопільська область
20793,611111,1791,33,1107,575,532,611111,Тернопільська область
20794,611112,1877,42,1158,580,578,611112,Тернопільська область
20795,611113,2154,51,1304,606,698,611113,Тернопільська область
20796,611114,2483,33,1511,663,848,611114,Тернопільська область
20797,611115,1908,38,1132,547,585,611115,Тернопільська область
20798,611116,1667,46,979,499,480,611116,Тернопільська область
20799,611117,1211,38,778,372,406,611117,Тернопільська область
20800,611118,2394,62,1438,673,765,611118,Тернопільська область
20801,611119,1520,31,930,425,505,611119,Тернопільська область
20802,611120,1671,40,1066,484,582,611120,Тернопільська область
20803,611121,1600,33,995,492,503,611121,Тернопільська область
20804,611122,2072,63,1311,609,702,611122,Тернопільська область
20805,611123,2459,64,1505,764,741,611123,Тернопільська область
20806,611124,2411,48,1433,700,733,611124,Тернопільська область
20807,611125,1736,47,981,505,476,611125,Тернопільська область
20808,611126,2268,52,1389,676,713,611126,Тернопільська область
20809,611127,2284,54,1376,641,735,611127,Тернопільська область
20810,611128,2200,46,1328,571,757,611128,Тернопільська область
20811,611129,2311,75,1427,624,803,611129,Тернопільська область
20812,611130,2294,61,1468,688,780,611130,Тернопільська область
20813,611131,2397,60,1472,681,791,611131,Тернопільська область
20814,611132,2166,39,1335,641,694,611132,Тернопільська область
20815,611133,2324,53,1330,698,632,611133,Тернопільська область
20816,611134,1960,70,1162,566,596,611134,Тернопільська область
20817,611135,2239,42,1339,654,685,611135,Тернопільська область
20818,611136,2173,53,1343,665,678,611136,Тернопільська область
20819,611137,2169,54,1346,685,661,611137,Тернопільська область
20820,611138,1904,52,1094,519,575,611138,Тернопільська область
20821,611139,2336,64,1493,675,818,611139,Тернопільська область
20822,611140,2261,56,1356,678,678,611140,Тернопільська область
20823,611141,2419,57,1457,710,747,611141,Тернопільська область
20824,611142,2069,56,1294,608,686,611142,Тернопільська область
20825,611143,1982,47,1210,598,612,611143,Тернопільська область
20826,611144,1610,42,1018,482,536,611144,Тернопільська область
20827,611145,2174,51,1343,675,668,611145,Тернопільська область
20828,611146,2244,59,1441,685,756,611146,Тернопільська область
20829,611147,2346,56,1388,686,702,611147,Тернопільська область
20830,611148,2103,49,1270,610,660,611148,Тернопільська область
20831,611149,2092,46,1181,545,636,611149,Тернопільська область
20832,611150,2379,40,1414,664,750,611150,Тернопільська область
20833,611151,2099,43,1317,677,640,611151,Тернопільська область
20834,611152,2397,51,1408,748,660,611152,Тернопільська область
20835,611153,2165,55,1349,623,726,611153,Тернопільська область
20836,611154,2503,58,1556,763,793,611154,Тернопільська область
20837,611155,2264,52,1435,678,757,611155,Тернопільська область
20838,611156,2447,64,1497,677,820,611156,Тернопільська область
20839,611157,2335,49,1444,663,781,611157,Тернопільська область
20840,611158,2192,28,1031,566,465,611158,Тернопільська область
20841,611159,2353,49,1370,714,656,611159,Тернопільська область
20842,611160,2271,36,1124,634,490,611160,Тернопільська область
20843,611161,2340,49,1289,638,651,611161,Тернопільська область
20844,611162,2260,58,1331,596,735,611162,Тернопільська область
20845,611163,1794,37,938,448,490,611163,Тернопільська область
20846,611164,2291,51,1412,688,724,611164,Тернопільська область
20847,611165,2212,55,1333,686,647,611165,Тернопільська область
20848,611166,2181,56,1389,676,713,611166,Тернопільська область
20849,611167,2356,63,1489,724,765,611167,Тернопільська область
20850,611168,2185,56,1333,658,675,611168,Тернопільська область
20851,611169,2242,55,1395,661,734,611169,Тернопільська область
20852,611170,2343,51,1448,693,755,611170,Тернопільська область
20853,611171,2296,34,1406,692,714,611171,Тернопільська область
20854,611172,2038,48,1240,624,616,611172,Тернопільська область
20855,611173,2031,43,1217,614,603,611173,Тернопільська область
20856,611174,7,0,7,4,3,611174,Тернопільська область
20857,611175,261,27,222,122,100,611175,Тернопільська область
20858,611176,21,1,19,12,7,611176,Тернопільська область
20859,611177,45,2,38,17,21,611177,Тернопільська область
20860,611179,168,4,146,78,68,611179,Тернопільська область
20861,611180,105,4,101,57,44,611180,Тернопільська область
20862,611181,76,4,71,28,43,611181,Тернопільська область
20863,610328,503,11,331,151,180,610328,Тернопільська область
20864,610329,327,6,216,113,103,610329,Тернопільська область
20865,610330,112,3,83,43,40,610330,Тернопільська область
20866,610331,733,8,390,252,138,610331,Тернопільська область
20867,610332,435,2,280,115,165,610332,Тернопільська область
20868,610333,642,4,373,273,100,610333,Тернопільська область
20869,610334,340,2,235,168,67,610334,Тернопільська область
20870,610335,383,4,268,150,118,610335,Тернопільська область
20871,610336,671,10,452,199,253,610336,Тернопільська область
20872,610337,145,3,88,56,32,610337,Тернопільська область
20873,610338,772,14,518,211,307,610338,Тернопільська область
20874,610339,287,8,175,116,59,610339,Тернопільська область
20875,610340,1695,21,760,415,345,610340,Тернопільська область
20876,610341,979,10,468,281,187,610341,Тернопільська область
20877,610342,810,13,534,274,260,610342,Тернопільська область
20878,610343,166,1,127,59,68,610343,Тернопільська область
20879,610344,173,6,138,56,82,610344,Тернопільська область
20880,610345,597,3,351,227,124,610345,Тернопільська область
20881,610346,1200,19,843,389,454,610346,Тернопільська область
20882,610347,328,8,201,116,85,610347,Тернопільська область
20883,610348,932,13,395,286,109,610348,Тернопільська область
20884,610349,829,11,553,309,244,610349,Тернопільська область
20885,610350,154,1,105,49,56,610350,Тернопільська область
20886,610351,292,2,193,84,109,610351,Тернопільська область
20887,610352,462,15,292,152,140,610352,Тернопільська область
20888,610353,532,4,344,158,186,610353,Тернопільська область
20889,610354,150,3,99,52,47,610354,Тернопільська область
20890,610355,365,3,270,151,119,610355,Тернопільська область
20891,610356,735,13,448,215,233,610356,Тернопільська область
20892,610357,2032,48,1164,567,597,610357,Тернопільська область
20893,610358,1202,33,696,352,344,610358,Тернопільська область
20894,610359,1955,54,1059,540,519,610359,Тернопільська область
20895,610360,2246,44,1244,653,591,610360,Тернопільська область
20896,610361,1604,38,897,479,418,610361,Тернопільська область
20897,610362,463,2,401,188,213,610362,Тернопільська область
20898,610363,155,2,123,85,38,610363,Тернопільська область
20899,610364,178,3,122,78,44,610364,Тернопільська область
20900,610365,211,4,147,84,63,610365,Тернопільська область
20901,610366,562,3,416,206,210,610366,Тернопільська область
20902,610367,532,7,425,159,266,610367,Тернопільська область
20903,610368,451,6,269,181,88,610368,Тернопільська область
20904,610369,497,5,305,159,146,610369,Тернопільська область
20905,610370,305,5,190,124,66,610370,Тернопільська область
20906,610371,209,2,127,84,43,610371,Тернопільська область
20907,610372,248,2,164,93,71,610372,Тернопільська область
20908,610373,154,1,99,46,53,610373,Тернопільська область
20909,610374,297,6,212,113,99,610374,Тернопільська область
20910,610375,239,5,175,56,119,610375,Тернопільська область
20911,610376,423,13,301,120,181,610376,Тернопільська область
20912,610377,421,6,251,165,86,610377,Тернопільська область
20913,610378,520,11,287,165,122,610378,Тернопільська область
20914,610379,649,9,394,211,183,610379,Тернопільська область
20915,610380,129,1,83,57,26,610380,Тернопільська область
20916,610381,205,3,120,58,62,610381,Тернопільська область
20917,610382,1021,19,649,266,383,610382,Тернопільська область
20918,610383,313,8,235,122,113,610383,Тернопільська область
20919,610384,459,1,325,215,110,610384,Тернопільська область
20920,610385,161,0,116,29,87,610385,Тернопільська область
20921,610386,392,5,245,88,157,610386,Тернопільська область
20922,610387,148,4,108,47,61,610387,Тернопільська область
20923,610388,646,12,435,207,228,610388,Тернопільська область
20924,610389,496,6,367,168,199,610389,Тернопільська область
20925,610390,207,5,141,44,97,610390,Тернопільська область
20926,610391,926,18,440,226,214,610391,Тернопільська область
20927,610392,538,1,423,205,218,610392,Тернопільська область
20928,610393,351,1,235,121,114,610393,Тернопільська область
20929,610394,213,2,152,96,56,610394,Тернопільська область
20930,610395,556,16,358,151,207,610395,Тернопільська область
20931,610396,705,15,504,145,359,610396,Тернопільська область
20932,610397,327,12,235,99,136,610397,Тернопільська область
20933,610398,1072,22,738,363,375,610398,Тернопільська область
20934,610399,370,4,243,119,124,610399,Тернопільська область
20935,610400,82,0,63,40,23,610400,Тернопільська область
20936,610401,483,2,338,185,153,610401,Тернопільська область
20937,610402,274,7,190,73,117,610402,Тернопільська область
20938,610403,224,7,217,145,72,610403,Тернопільська область
20939,610544,1971,35,1129,636,493,610544,Тернопільська область
20940,610545,193,2,110,61,49,610545,Тернопільська область
20941,610546,259,3,179,109,70,610546,Тернопільська область
20942,610547,104,3,62,26,36,610547,Тернопільська область
20943,610548,775,19,432,307,125,610548,Тернопільська область
20944,610549,144,2,101,55,46,610549,Тернопільська область
20945,610550,604,12,317,217,100,610550,Тернопільська область
20946,610551,1094,13,648,410,238,610551,Тернопільська область
20947,610552,587,13,367,237,130,610552,Тернопільська область
20948,610554,969,11,625,348,277,610554,Тернопільська область
20949,610555,809,17,497,286,211,610555,Тернопільська область
20950,610556,284,0,162,109,53,610556,Тернопільська область
20951,610557,390,7,256,174,82,610557,Тернопільська область
20952,610558,121,4,74,51,23,610558,Тернопільська область
20953,610559,607,6,328,212,116,610559,Тернопільська область
20954,610560,997,12,570,322,248,610560,Тернопільська область
20955,610561,534,11,353,265,88,610561,Тернопільська область
20956,610562,92,0,58,43,15,610562,Тернопільська область
20957,610563,373,11,236,117,119,610563,Тернопільська область
20958,610564,284,3,187,126,61,610564,Тернопільська область
20959,610565,305,7,228,103,125,610565,Тернопільська область
20960,610566,297,7,182,114,68,610566,Тернопільська область
20961,610567,762,12,502,345,157,610567,Тернопільська область
20962,610568,286,4,195,74,121,610568,Тернопільська область
20963,610569,248,4,167,81,86,610569,Тернопільська область
20964,610570,73,0,54,37,17,610570,Тернопільська область
20965,610571,261,0,156,99,57,610571,Тернопільська область
20966,610572,108,0,85,67,18,610572,Тернопільська область
20967,610573,423,6,293,170,123,610573,Тернопільська область
20968,610574,886,24,445,295,150,610574,Тернопільська область
20969,610575,1966,44,1034,647,387,610575,Тернопільська область
20970,610576,1669,35,898,545,353,610576,Тернопільська область
20971,610577,1505,35,769,481,288,610577,Тернопільська область
20972,610578,1288,46,648,415,233,610578,Тернопільська область
20973,610579,899,23,494,316,178,610579,Тернопільська область
20974,610580,910,15,496,304,192,610580,Тернопільська область
20975,610581,1429,26,751,429,322,610581,Тернопільська область
20976,610582,1152,16,625,411,214,610582,Тернопільська область
20977,610583,1829,32,954,622,332,610583,Тернопільська область
20978,610584,1667,33,896,556,340,610584,Тернопільська область
20979,610585,572,2,368,269,99,610585,Тернопільська область
20980,610586,814,7,542,287,255,610586,Тернопільська область
20981,610587,779,12,537,373,164,610587,Тернопільська область
20982,610591,1076,17,665,403,262,610591,Тернопільська область
20983,610592,127,4,70,50,20,610592,Тернопільська область
20984,610596,531,10,320,225,95,610596,Тернопільська область
20985,610597,410,10,205,150,55,610597,Тернопільська область
20986,610598,293,4,189,130,59,610598,Тернопільська область
20987,610599,262,2,163,104,59,610599,Тернопільська область
20988,610600,1997,48,1061,792,269,610600,Тернопільська область
20989,610601,2007,24,912,665,247,610601,Тернопільська область
20990,610602,1160,29,541,383,158,610602,Тернопільська область
20991,610603,1226,33,567,393,174,610603,Тернопільська область
20992,610604,357,3,156,116,40,610604,Тернопільська область
20993,610607,1215,20,675,420,255,610607,Тернопільська область
20994,610609,1161,12,686,542,144,610609,Тернопільська область
20995,610610,947,12,427,318,109,610610,Тернопільська область
20996,610613,277,5,146,79,67,610613,Тернопільська область
20997,610614,437,11,239,161,78,610614,Тернопільська область
20998,610615,316,7,203,135,68,610615,Тернопільська область
20999,610616,11,0,9,7,2,610616,Тернопільська область
21000,610617,307,1,194,109,85,610617,Тернопільська область
21001,610618,169,4,107,56,51,610618,Тернопільська область
21002,610619,655,12,404,232,172,610619,Тернопільська область
21003,610620,146,9,96,56,40,610620,Тернопільська область
21004,610621,652,11,468,221,247,610621,Тернопільська область
21005,610622,838,6,476,289,187,610622,Тернопільська область
21006,610623,231,7,161,108,53,610623,Тернопільська область
21007,610624,771,11,492,222,270,610624,Тернопільська область
21008,610625,616,9,414,280,134,610625,Тернопільська область
21009,610626,442,9,303,188,115,610626,Тернопільська область
21010,610627,477,10,319,193,126,610627,Тернопільська область
21011,610628,549,11,333,196,137,610628,Тернопільська область
21012,610629,449,3,264,101,163,610629,Тернопільська область
21013,610630,81,3,41,24,17,610630,Тернопільська область
21014,610631,568,6,342,210,132,610631,Тернопільська область
21015,610632,215,3,141,93,48,610632,Тернопільська область
21016,610633,381,4,223,115,108,610633,Тернопільська область
21017,610634,632,7,337,211,126,610634,Тернопільська область
21018,610635,310,7,166,94,72,610635,Тернопільська область
21019,610636,293,3,206,95,111,610636,Тернопільська область
21020,610637,412,12,291,156,135,610637,Тернопільська область
21021,610638,182,1,125,47,78,610638,Тернопільська область
21022,610639,249,2,177,104,73,610639,Тернопільська область
21023,610640,413,15,219,129,90,610640,Тернопільська область
21024,610641,1694,38,973,587,386,610641,Тернопільська область
21025,610642,1445,26,781,487,294,610642,Тернопільська область
21026,610643,881,7,454,308,146,610643,Тернопільська область
21027,610644,628,7,320,198,122,610644,Тернопільська область
21028,610645,1550,27,834,552,282,610645,Тернопільська область
21029,610646,125,3,78,53,25,610646,Тернопільська область
21030,610647,153,1,107,88,19,610647,Тернопільська область
21031,610648,286,5,170,106,64,610648,Тернопільська область
21032,610649,476,8,303,156,147,610649,Тернопільська область
21033,610650,100,3,66,35,31,610650,Тернопільська область
21034,610651,249,6,139,80,59,610651,Тернопільська область
21035,610652,405,8,284,198,86,610652,Тернопільська область
21036,610653,157,3,116,67,49,610653,Тернопільська область
21037,610654,394,9,230,128,102,610654,Тернопільська область
21038,610655,180,8,112,74,38,610655,Тернопільська область
21039,610656,477,10,313,171,142,610656,Тернопільська область
21040,610657,226,7,135,82,53,610657,Тернопільська область
21041,610658,106,2,71,52,19,610658,Тернопільська область
21042,610659,578,25,400,210,190,610659,Тернопільська область
21043,610660,274,6,187,112,75,610660,Тернопільська область
21044,610661,378,6,234,100,134,610661,Тернопільська область
21045,610662,644,9,405,222,183,610662,Тернопільська область
21046,610663,318,9,179,100,79,610663,Тернопільська область
21047,610664,319,4,196,109,87,610664,Тернопільська область
21048,610717,767,5,530,297,233,610717,Тернопільська область
21049,610718,176,0,113,56,57,610718,Тернопільська область
21050,610719,351,6,246,138,108,610719,Тернопільська область
21051,610720,83,0,70,50,20,610720,Тернопільська область
21052,610721,57,0,49,37,12,610721,Тернопільська область
21053,610722,486,4,395,194,201,610722,Тернопільська область
21054,610723,429,0,257,136,121,610723,Тернопільська область
21055,610724,744,13,568,309,259,610724,Тернопільська область
21056,610725,339,9,214,133,81,610725,Тернопільська область
21057,610726,459,5,269,168,101,610726,Тернопільська область
21058,610727,338,3,239,145,94,610727,Тернопільська область
21059,610728,725,12,493,311,182,610728,Тернопільська область
21060,610729,1036,14,711,421,290,610729,Тернопільська область
21061,610730,276,1,214,139,75,610730,Тернопільська область
21062,610731,829,15,473,277,196,610731,Тернопільська область
21063,610732,303,3,213,107,106,610732,Тернопільська область
21064,610733,105,0,67,27,40,610733,Тернопільська область
21065,610734,774,16,484,269,215,610734,Тернопільська область
21066,610735,283,7,198,124,74,610735,Тернопільська область
21067,610736,540,15,364,118,246,610736,Тернопільська область
21068,610737,232,5,173,108,65,610737,Тернопільська область
21069,610738,546,7,338,218,120,610738,Тернопільська область
21070,610739,282,4,189,79,110,610739,Тернопільська область
21071,610740,310,5,209,124,85,610740,Тернопільська область
21072,610741,464,20,265,125,140,610741,Тернопільська область
21073,610742,284,4,187,100,87,610742,Тернопільська область
21074,610743,323,5,190,93,97,610743,Тернопільська область
21075,610744,1077,22,746,411,335,610744,Тернопільська область
21076,610745,292,9,182,93,89,610745,Тернопільська область
21077,610746,390,5,276,190,86,610746,Тернопільська область
21078,610747,273,10,193,132,61,610747,Тернопільська область
21079,610748,231,1,187,124,63,610748,Тернопільська область
21080,610749,524,12,357,139,218,610749,Тернопільська область
21081,610750,1185,30,900,487,413,610750,Тернопільська область
21082,610751,352,4,230,108,122,610751,Тернопільська область
21083,610752,59,1,43,16,27,610752,Тернопільська область
21084,610753,1142,25,623,364,259,610753,Тернопільська область
21085,610754,914,15,500,312,188,610754,Тернопільська область
21086,610755,1864,28,1115,638,477,610755,Тернопільська область
21087,610756,741,14,413,229,184,610756,Тернопільська область
21088,610757,1570,31,855,450,405,610757,Тернопільська область
21089,610758,353,3,259,138,121,610758,Тернопільська область
21090,610759,103,2,72,32,40,610759,Тернопільська область
21091,610760,206,1,119,70,49,610760,Тернопільська область
21092,610761,1116,22,545,309,236,610761,Тернопільська область
21093,610762,887,29,488,283,205,610762,Тернопільська область
21094,610763,899,19,558,355,203,610763,Тернопільська область
21095,610764,71,2,54,36,18,610764,Тернопільська область
21096,610765,421,14,326,155,171,610765,Тернопільська область
21097,610766,184,3,137,70,67,610766,Тернопільська область
21098,610767,587,9,415,241,174,610767,Тернопільська область
21099,610768,957,17,582,318,264,610768,Тернопільська область
21100,610769,541,6,382,162,220,610769,Тернопільська область
21101,610770,282,7,207,115,92,610770,Тернопільська область
21102,610771,100,1,65,20,45,610771,Тернопільська область
21103,610772,232,2,148,103,45,610772,Тернопільська область
21104,610773,230,4,162,84,78,610773,Тернопільська область
21105,610774,232,3,135,94,41,610774,Тернопільська область
21106,610775,91,0,74,37,37,610775,Тернопільська область
21107,610776,795,12,525,323,202,610776,Тернопільська область
21108,610777,469,13,326,155,171,610777,Тернопільська область
21109,610778,121,5,73,47,26,610778,Тернопільська область
21110,610779,466,1,337,226,111,610779,Тернопільська область
21111,610780,346,4,226,113,113,610780,Тернопільська область
21112,611034,226,2,159,83,76,611034,Тернопільська область
21113,611035,303,2,185,98,87,611035,Тернопільська область
21114,611036,94,4,46,23,23,611036,Тернопільська область
21115,611037,507,2,355,179,176,611037,Тернопільська область
21116,611038,542,1,336,203,133,611038,Тернопільська область
21117,611039,759,7,500,299,201,611039,Тернопільська область
21118,611040,610,9,396,171,225,611040,Тернопільська область
21119,611041,389,6,257,151,106,611041,Тернопільська область
21120,611042,274,2,190,95,95,611042,Тернопільська область
21121,611043,838,15,505,313,192,611043,Тернопільська область
21122,611044,412,5,249,133,116,611044,Тернопільська область
21123,611045,301,10,193,122,71,611045,Тернопільська область
21124,611046,820,10,541,403,138,611046,Тернопільська область
21125,611047,217,3,135,97,38,611047,Тернопільська область
21126,611048,349,2,245,167,78,611048,Тернопільська область
21127,611049,51,2,38,32,6,611049,Тернопільська область
21128,611050,400,5,267,171,96,611050,Тернопільська область
21129,611051,295,3,166,96,70,611051,Тернопільська область
21130,611052,78,1,51,35,16,611052,Тернопільська область
21131,611053,500,5,302,170,132,611053,Тернопільська область
21132,611054,231,4,158,74,84,611054,Тернопільська область
21133,611055,167,3,112,56,56,611055,Тернопільська область
21134,611056,360,7,246,145,101,611056,Тернопільська область
21135,611057,316,1,226,126,100,611057,Тернопільська область
21136,611058,362,1,214,104,110,611058,Тернопільська область
21137,611060,553,7,355,225,130,611060,Тернопільська область
21138,611061,173,1,95,56,39,611061,Тернопільська область
21139,611062,450,9,290,152,138,611062,Тернопільська область
21140,611063,205,2,144,88,56,611063,Тернопільська область
21141,611064,471,6,307,173,134,611064,Тернопільська область
21142,611065,306,7,227,122,105,611065,Тернопільська область
21143,611066,155,1,118,66,52,611066,Тернопільська область
21144,611067,410,7,243,114,129,611067,Тернопільська область
21145,611068,303,1,222,141,81,611068,Тернопільська область
21146,611069,239,1,164,70,94,611069,Тернопільська область
21147,611070,520,7,372,212,160,611070,Тернопільська область
21148,611071,242,4,172,100,72,611071,Тернопільська область
21149,611072,514,4,358,223,135,611072,Тернопільська область
21150,611073,336,7,233,92,141,611073,Тернопільська область
21151,611074,315,2,194,106,88,611074,Тернопільська область
21152,611075,328,2,233,149,84,611075,Тернопільська область
21153,611076,278,5,186,109,77,611076,Тернопільська область
21154,611077,518,5,300,174,126,611077,Тернопільська область
21155,611078,444,4,264,187,77,611078,Тернопільська область
21156,611079,299,7,199,126,73,611079,Тернопільська область
21157,611080,410,2,263,167,96,611080,Тернопільська область
21158,611081,147,0,104,48,56,611081,Тернопільська область
21159,611082,441,3,334,178,156,611082,Тернопільська область
21160,611083,424,4,291,146,145,611083,Тернопільська область
21161,611084,756,9,454,306,148,611084,Тернопільська область
21162,611085,429,7,310,164,146,611085,Тернопільська область
21163,611086,438,9,282,188,94,611086,Тернопільська область
21164,611087,547,6,355,249,106,611087,Тернопільська область
21165,611088,1805,28,1089,664,425,611088,Тернопільська область
21166,611089,1959,31,1236,826,410,611089,Тернопільська область
21167,611090,26,0,25,8,17,611090,Тернопільська область
21168,611091,31,2,24,10,14,611091,Тернопільська область
21169,611184,231,4,151,79,72,611184,Тернопільська область
21170,611186,74,0,20,14,6,611186,Тернопільська область
21171,610001,1593,36,908,466,442,610001,Тернопільська область
21172,610002,682,19,391,176,215,610002,Тернопільська область
21173,610003,1696,34,1039,481,558,610003,Тернопільська область
21174,610004,718,19,404,188,216,610004,Тернопільська область
21175,610005,774,27,454,243,211,610005,Тернопільська область
21176,610006,1433,37,851,378,473,610006,Тернопільська область
21177,610007,1974,38,1142,576,566,610007,Тернопільська область
21178,610008,1693,27,921,445,476,610008,Тернопільська область
21179,610009,1444,41,870,341,529,610009,Тернопільська область
21180,610010,722,12,429,216,213,610010,Тернопільська область
21181,610011,629,15,410,195,215,610011,Тернопільська область
21182,610012,364,9,286,166,120,610012,Тернопільська область
21183,610013,395,10,264,120,144,610013,Тернопільська область
21184,610014,425,5,254,106,148,610014,Тернопільська область
21185,610015,242,5,178,58,120,610015,Тернопільська область
21186,610016,156,4,104,27,77,610016,Тернопільська область
21187,610017,526,11,417,122,295,610017,Тернопільська область
21188,610018,518,8,394,99,295,610018,Тернопільська область
21189,610019,356,4,266,142,124,610019,Тернопільська область
21190,610020,660,16,457,216,241,610020,Тернопільська область
21191,610021,330,1,255,85,170,610021,Тернопільська область
21192,610022,196,7,148,75,73,610022,Тернопільська область
21193,610023,392,7,293,95,198,610023,Тернопільська область
21194,610024,634,12,449,232,217,610024,Тернопільська область
21195,610025,188,9,110,76,34,610025,Тернопільська область
21196,610026,563,11,362,204,158,610026,Тернопільська область
21197,610027,106,0,66,43,23,610027,Тернопільська область
21198,610028,930,15,552,216,336,610028,Тернопільська область
21199,610029,516,8,349,180,169,610029,Тернопільська область
21200,610030,499,11,400,137,263,610030,Тернопільська область
21201,610031,247,5,159,100,59,610031,Тернопільська область
21202,610032,553,5,433,206,227,610032,Тернопільська область
21203,610033,559,9,311,124,187,610033,Тернопільська область
21204,610034,301,5,220,89,131,610034,Тернопільська область
21205,610035,213,1,120,72,48,610035,Тернопільська область
21206,610036,310,9,206,89,117,610036,Тернопільська область
21207,610037,85,1,46,33,13,610037,Тернопільська область
21208,610038,489,5,360,187,173,610038,Тернопільська область
21209,610039,417,10,291,136,155,610039,Тернопільська область
21210,610040,305,6,234,105,129,610040,Тернопільська область
21211,610041,203,2,170,80,90,610041,Тернопільська область
21212,610042,422,5,313,129,184,610042,Тернопільська область
21213,610043,228,3,137,44,93,610043,Тернопільська область
21214,610044,588,1,407,236,171,610044,Тернопільська область
21215,610045,397,4,265,186,79,610045,Тернопільська область
21216,610046,692,14,429,201,228,610046,Тернопільська область
21217,610048,592,15,377,192,185,610048,Тернопільська область
21218,610049,281,3,171,57,114,610049,Тернопільська область
21219,610050,451,12,341,139,202,610050,Тернопільська область
21220,610051,221,2,164,51,113,610051,Тернопільська область
21221,610052,940,20,527,225,302,610052,Тернопільська область
21222,610053,147,4,115,44,71,610053,Тернопільська область
21223,610404,1548,33,897,435,462,610404,Тернопільська область
21224,610405,1315,21,735,340,395,610405,Тернопільська область
21225,610406,1503,36,824,450,374,610406,Тернопільська область
21226,610407,858,17,532,266,266,610407,Тернопільська область
21227,610408,248,2,128,84,44,610408,Тернопільська область
21228,610409,1281,23,766,412,354,610409,Тернопільська область
21229,610410,738,15,408,193,215,610410,Тернопільська область
21230,610411,273,5,192,97,95,610411,Тернопільська область
21231,610412,59,0,35,10,25,610412,Тернопільська область
21232,610413,205,3,180,52,128,610413,Тернопільська область
21233,610414,501,6,343,78,265,610414,Тернопільська область
21234,610415,96,0,75,17,58,610415,Тернопільська область
21235,610416,137,1,109,45,64,610416,Тернопільська область
21236,610417,143,4,111,42,69,610417,Тернопільська область
21237,610418,349,2,260,103,157,610418,Тернопільська область
21238,610419,188,4,150,54,96,610419,Тернопільська область
21239,610420,323,3,251,85,166,610420,Тернопільська область
21240,610421,72,2,57,15,42,610421,Тернопільська область
21241,610422,183,3,106,35,71,610422,Тернопільська область
21242,610423,78,0,47,17,30,610423,Тернопільська область
21243,610424,140,3,117,54,63,610424,Тернопільська область
21244,610425,145,2,119,52,67,610425,Тернопільська область
21245,610426,132,0,74,38,36,610426,Тернопільська область
21246,610427,754,19,515,259,256,610427,Тернопільська область
21247,610428,598,13,398,229,169,610428,Тернопільська область
21248,610429,201,2,162,83,79,610429,Тернопільська область
21249,610430,215,8,142,77,65,610430,Тернопільська область
21250,610431,396,10,220,119,101,610431,Тернопільська область
21251,610432,80,2,40,25,15,610432,Тернопільська область
21252,610433,97,2,67,22,45,610433,Тернопільська область
21253,610434,77,0,60,18,42,610434,Тернопільська область
21254,610435,140,0,106,39,67,610435,Тернопільська область
21255,610436,79,0,54,12,42,610436,Тернопільська область
21256,610437,803,11,548,250,298,610437,Тернопільська область
21257,610438,671,42,501,205,296,610438,Тернопільська область
21258,610439,187,4,123,72,51,610439,Тернопільська область
21259,610440,303,15,203,94,109,610440,Тернопільська область
21260,610441,91,1,58,23,35,610441,Тернопільська область
21261,610442,349,9,257,165,92,610442,Тернопільська область
21262,610443,348,13,279,131,148,610443,Тернопільська область
21263,610444,234,5,179,30,149,610444,Тернопільська область
21264,610445,257,3,177,74,103,610445,Тернопільська область
21265,610446,511,8,441,173,268,610446,Тернопільська область
21266,610447,218,6,150,66,84,610447,Тернопільська область
21267,610448,265,0,187,53,134,610448,Тернопільська область
21268,610449,567,8,412,179,233,610449,Тернопільська область
21269,610450,325,3,233,109,124,610450,Тернопільська область
21270,610451,567,8,393,190,203,610451,Тернопільська область
21271,610452,98,2,68,36,32,610452,Тернопільська область
21272,610453,259,8,192,94,98,610453,Тернопільська область
21273,610454,529,10,316,191,125,610454,Тернопільська область
21274,610455,179,0,123,57,66,610455,Тернопільська область
21275,610456,491,9,346,163,183,610456,Тернопільська область
21276,610457,270,6,221,119,102,610457,Тернопільська область
21277,610458,122,0,89,55,34,610458,Тернопільська область
21278,610459,269,7,153,83,70,610459,Тернопільська область
21279,610460,1507,38,998,497,501,610460,Тернопільська область
21280,610461,1176,16,791,346,445,610461,Тернопільська область
21281,610462,528,3,410,182,228,610462,Тернопільська область
21282,610463,393,9,266,118,148,610463,Тернопільська область
21283,610464,303,4,203,84,119,610464,Тернопільська область
21284,610465,262,3,173,82,91,610465,Тернопільська область
21285,610466,231,1,156,85,71,610466,Тернопільська область
21286,610467,313,4,215,108,107,610467,Тернопільська область
21287,610468,341,2,211,93,118,610468,Тернопільська область
21288,610469,249,3,162,89,73,610469,Тернопільська область
21289,610470,218,4,142,92,50,610470,Тернопільська область
21290,610471,203,0,125,50,75,610471,Тернопільська область
21291,610472,215,1,167,57,110,610472,Тернопільська область
21292,610473,177,6,118,35,83,610473,Тернопільська область
21293,610474,666,6,445,140,305,610474,Тернопільська область
21294,610475,283,11,199,67,132,610475,Тернопільська область
21295,610476,335,7,226,110,116,610476,Тернопільська область
21296,610477,334,4,250,117,133,610477,Тернопільська область
21297,610478,229,5,136,65,71,610478,Тернопільська область
21298,610479,159,2,107,41,66,610479,Тернопільська область
21299,610480,148,3,103,54,49,610480,Тернопільська область
21300,610481,540,7,425,206,219,610481,Тернопільська область
21301,610482,325,3,258,96,162,610482,Тернопільська область
21302,610483,199,8,127,55,72,610483,Тернопільська область
21303,610484,130,0,99,32,67,610484,Тернопільська область
21304,610485,387,8,253,140,113,610485,Тернопільська область
21305,610486,160,2,101,32,69,610486,Тернопільська область
21306,610487,151,2,93,49,44,610487,Тернопільська область
21307,610488,270,3,198,107,91,610488,Тернопільська область
21308,610489,134,3,92,40,52,610489,Тернопільська область
21309,610490,343,6,259,118,141,610490,Тернопільська область
21310,610491,116,5,86,39,47,610491,Тернопільська область
21311,610492,43,0,39,19,20,610492,Тернопільська область
21312,610494,17,0,17,0,17,610494,Тернопільська область
21313,610495,1761,46,1068,460,608,610495,Тернопільська область
21314,610496,1645,27,975,456,519,610496,Тернопільська область
21315,610497,1632,31,889,405,484,610497,Тернопільська область
21316,610498,1678,29,1012,512,500,610498,Тернопільська область
21317,610499,1333,18,945,504,441,610499,Тернопільська область
21318,610500,430,6,317,182,135,610500,Тернопільська область
21319,610501,314,7,207,84,123,610501,Тернопільська область
21320,610502,235,4,172,84,88,610502,Тернопільська область
21321,610503,325,6,250,126,124,610503,Тернопільська область
21322,610504,504,2,410,191,219,610504,Тернопільська область
21323,610505,227,2,179,87,92,610505,Тернопільська область
21324,610506,356,3,217,82,135,610506,Тернопільська область
21325,610507,39,0,32,12,20,610507,Тернопільська область
21326,610508,1046,9,633,366,267,610508,Тернопільська область
21327,610509,293,2,202,81,121,610509,Тернопільська область
21328,610510,148,4,102,47,55,610510,Тернопільська область
21329,610511,431,8,293,112,181,610511,Тернопільська область
21330,610512,542,4,411,152,259,610512,Тернопільська область
21331,610513,372,12,273,119,154,610513,Тернопільська область
21332,610514,387,11,282,143,139,610514,Тернопільська область
21333,610515,186,1,140,51,89,610515,Тернопільська область
21334,610516,785,6,451,228,223,610516,Тернопільська область
21335,610517,727,8,487,260,227,610517,Тернопільська область
21336,610518,542,8,407,199,208,610518,Тернопільська область
21337,610519,597,6,334,195,139,610519,Тернопільська область
21338,610520,271,5,177,88,89,610520,Тернопільська область
21339,610521,315,7,247,138,109,610521,Тернопільська область
21340,610522,996,28,543,295,248,610522,Тернопільська область
21341,610523,1054,13,783,364,419,610523,Тернопільська область
21342,610524,689,5,531,236,295,610524,Тернопільська область
21343,610525,788,19,534,238,296,610525,Тернопільська область
21344,610526,130,2,88,51,37,610526,Тернопільська область
21345,610527,815,9,491,209,282,610527,Тернопільська область
21346,610528,495,16,346,208,138,610528,Тернопільська область
21347,610529,259,6,173,56,117,610529,Тернопільська область
21348,610530,331,2,250,106,144,610530,Тернопільська область
21349,610531,140,0,103,61,42,610531,Тернопільська область
21350,610532,388,6,290,119,171,610532,Тернопільська область
21351,610533,297,4,239,78,161,610533,Тернопільська область
21352,610534,380,2,265,116,149,610534,Тернопільська область
21353,610535,477,9,301,136,165,610535,Тернопільська область
21354,610536,668,7,418,195,223,610536,Тернопільська область
21355,610537,394,13,381,192,189,610537,Тернопільська область
21356,610538,742,15,546,233,313,610538,Тернопільська область
21357,610539,419,4,269,167,102,610539,Тернопільська область
21358,610540,733,15,451,187,264,610540,Тернопільська область
21359,610541,30,0,23,6,17,610541,Тернопільська область
21360,610542,515,3,370,119,251,610542,Тернопільська область
21361,610543,405,10,271,108,163,610543,Тернопільська область
21362,610553,527,7,254,109,145,610553,Тернопільська область
21363,610588,513,1,315,218,97,610588,Тернопільська область
21364,610589,405,6,245,173,72,610589,Тернопільська область
21365,610590,259,3,153,79,74,610590,Тернопільська область
21366,610593,298,6,206,117,89,610593,Тернопільська область
21367,610594,157,1,104,56,48,610594,Тернопільська область
21368,610595,218,5,120,68,52,610595,Тернопільська область
21369,610605,1150,37,698,393,305,610605,Тернопільська область
21370,610606,714,6,404,203,201,610606,Тернопільська область
21371,610608,661,12,465,186,279,610608,Тернопільська область
21372,610611,383,7,299,160,139,610611,Тернопільська область
21373,610612,219,8,169,86,83,610612,Тернопільська область
21374,610781,357,6,178,93,85,610781,Тернопільська область
21375,610782,258,14,177,65,112,610782,Тернопільська область
21376,610783,208,0,151,95,56,610783,Тернопільська область
21377,610784,59,1,39,16,23,610784,Тернопільська область
21378,610785,592,15,368,122,246,610785,Тернопільська область
21379,610786,368,6,255,114,141,610786,Тернопільська область
21380,610787,495,10,293,118,175,610787,Тернопільська область
21381,610788,584,9,377,121,256,610788,Тернопільська область
21382,610789,417,6,263,77,186,610789,Тернопільська область
21383,610790,265,6,171,43,128,610790,Тернопільська область
21384,610791,62,2,52,2,50,610791,Тернопільська область
21385,610792,108,0,83,24,59,610792,Тернопільська область
21386,610793,493,5,265,125,140,610793,Тернопільська область
21387,610794,98,1,55,17,38,610794,Тернопільська область
21388,610795,108,1,66,21,45,610795,Тернопільська область
21389,610796,194,4,107,24,83,610796,Тернопільська область
21390,610797,543,7,338,143,195,610797,Тернопільська область
21391,610798,134,3,100,42,58,610798,Тернопільська область
21392,610799,420,7,306,111,195,610799,Тернопільська область
21393,610800,110,1,53,10,43,610800,Тернопільська область
21394,610801,955,11,684,234,450,610801,Тернопільська область
21395,610802,711,13,382,161,221,610802,Тернопільська область
21396,610803,397,9,253,70,183,610803,Тернопільська область
21397,610804,1136,23,654,293,361,610804,Тернопільська область
21398,610805,1033,25,558,257,301,610805,Тернопільська область
21399,610806,387,9,295,105,190,610806,Тернопільська область
21400,610807,856,15,529,220,309,610807,Тернопільська область
21401,610808,1227,26,792,334,458,610808,Тернопільська область
21402,610809,560,9,295,169,126,610809,Тернопільська область
21403,610810,296,8,165,107,58,610810,Тернопільська область
21404,610811,625,10,422,155,267,610811,Тернопільська область
21405,610812,214,4,123,52,71,610812,Тернопільська область
21406,610813,34,1,32,10,22,610813,Тернопільська область
21407,610893,479,6,327,142,185,610893,Тернопільська область
21408,610894,308,10,206,80,126,610894,Тернопільська область
21409,610895,2153,34,1319,659,660,610895,Тернопільська область
21410,610896,1639,45,985,483,502,610896,Тернопільська область
21411,610897,907,21,581,294,287,610897,Тернопільська область
21412,610898,944,20,592,256,336,610898,Тернопільська область
21413,610899,164,2,128,33,95,610899,Тернопільська область
21414,610900,2109,53,1320,566,754,610900,Тернопільська область
21415,610901,2129,46,1234,618,616,610901,Тернопільська область
21416,610902,2220,42,1295,638,657,610902,Тернопільська область
21417,610903,208,8,125,69,56,610903,Тернопільська область
21418,610904,1471,24,882,436,446,610904,Тернопільська область
21419,610905,1102,23,652,372,280,610905,Тернопільська область
21420,610906,1533,44,982,434,548,610906,Тернопільська область
21421,610907,1971,70,1245,596,649,610907,Тернопільська область
21422,610908,1753,39,1085,548,537,610908,Тернопільська область
21423,610909,972,11,678,341,337,610909,Тернопільська область
21424,610910,1372,30,915,449,466,610910,Тернопільська область
21425,610911,607,18,378,246,132,610911,Тернопільська область
21426,610912,262,1,208,120,88,610912,Тернопільська область
21427,610913,552,14,339,179,160,610913,Тернопільська область
21428,610914,212,7,205,78,127,610914,Тернопільська область
21429,610915,751,13,538,318,220,610915,Тернопільська область
21430,610916,476,16,334,167,167,610916,Тернопільська область
21431,610917,677,10,441,172,269,610917,Тернопільська область
21432,610918,538,6,345,150,195,610918,Тернопільська область
21433,610919,388,12,294,147,147,610919,Тернопільська область
21434,610920,192,4,152,76,76,610920,Тернопільська область
21435,610921,771,13,515,201,314,610921,Тернопільська область
21436,610922,338,3,228,131,97,610922,Тернопільська область
21437,610923,543,14,320,147,173,610923,Тернопільська область
21438,610924,513,14,373,163,210,610924,Тернопільська область
21439,610925,291,6,211,65,146,610925,Тернопільська область
21440,610926,1021,17,689,429,260,610926,Тернопільська область
21441,610927,107,0,80,55,25,610927,Тернопільська область
21442,610928,348,8,210,70,140,610928,Тернопільська область
21443,610929,416,5,279,157,122,610929,Тернопільська область
21444,610930,609,8,463,214,249,610930,Тернопільська область
21445,610931,1622,22,1092,512,580,610931,Тернопільська область
21446,610932,1335,17,826,440,386,610932,Тернопільська область
21447,610933,1431,22,891,397,494,610933,Тернопільська область
21448,610934,2392,66,1490,735,755,610934,Тернопільська область
21449,610935,746,15,482,243,239,610935,Тернопільська область
21450,610936,158,5,123,50,73,610936,Тернопільська область
21451,610937,1570,33,1047,447,600,610937,Тернопільська область
21452,610938,1045,31,674,306,368,610938,Тернопільська область
21453,610939,453,17,313,145,168,610939,Тернопільська область
21454,610940,786,17,568,237,331,610940,Тернопільська область
21455,610941,474,10,315,185,130,610941,Тернопільська область
21456,610942,483,8,299,148,151,610942,Тернопільська область
21457,610943,430,5,273,160,113,610943,Тернопільська область
21458,610944,219,0,153,75,78,610944,Тернопільська область
21459,610945,559,9,333,142,191,610945,Тернопільська область
21460,610946,1052,25,669,377,292,610946,Тернопільська область
21461,610947,491,11,351,103,248,610947,Тернопільська область
21462,610948,479,16,338,137,201,610948,Тернопільська область
21463,610949,589,16,381,204,177,610949,Тернопільська область
21464,610950,280,7,183,94,89,610950,Тернопільська область
21465,610951,573,18,400,208,192,610951,Тернопільська область
21466,610952,484,7,362,174,188,610952,Тернопільська область
21467,610953,831,24,523,284,239,610953,Тернопільська область
21468,610954,1157,31,716,330,386,610954,Тернопільська область
21469,610955,19,1,18,6,12,610955,Тернопільська область
21470,610956,49,0,45,18,27,610956,Тернопільська область
21471,610957,19,1,18,7,11,610957,Тернопільська область
21472,610958,40,0,31,14,17,610958,Тернопільська область
21473,611092,900,22,566,290,276,611092,Тернопільська область
21474,611093,2217,45,1293,587,706,611093,Тернопільська область
21475,611094,1182,28,662,349,313,611094,Тернопільська область
21476,611095,1954,40,1041,499,542,611095,Тернопільська область
21477,611182,35,1,31,12,19,611182,Тернопільська область
21478,610132,703,6,512,247,265,610132,Тернопільська область
21479,610133,839,9,626,341,285,610133,Тернопільська область
21480,610134,117,4,87,47,40,610134,Тернопільська область
21481,610135,460,10,280,104,176,610135,Тернопільська область
21482,610136,538,9,374,124,250,610136,Тернопільська область
21483,610137,344,1,232,108,124,610137,Тернопільська область
21484,610138,1025,26,600,290,310,610138,Тернопільська область
21485,610139,1173,16,623,339,284,610139,Тернопільська область
21486,610140,1096,17,576,309,267,610140,Тернопільська область
21487,610141,728,20,417,217,200,610141,Тернопільська область
21488,610142,1922,38,1144,584,560,610142,Тернопільська область
21489,610143,1003,17,559,282,277,610143,Тернопільська область
21490,610144,910,21,550,274,276,610144,Тернопільська область
21491,610145,767,14,503,232,271,610145,Тернопільська область
21492,610146,634,14,362,175,187,610146,Тернопільська область
21493,610147,209,2,132,60,72,610147,Тернопільська область
21494,610148,408,4,290,103,187,610148,Тернопільська область
21495,610149,108,1,78,31,47,610149,Тернопільська область
21496,610150,587,5,465,205,260,610150,Тернопільська область
21497,610151,1238,25,749,442,307,610151,Тернопільська область
21498,610152,476,9,389,102,287,610152,Тернопільська область
21499,610153,441,8,323,165,158,610153,Тернопільська область
21500,610154,340,1,276,129,147,610154,Тернопільська область
21501,610155,527,14,338,235,103,610155,Тернопільська область
21502,610156,1744,27,996,581,415,610156,Тернопільська область
21503,610157,207,3,167,79,88,610157,Тернопільська область
21504,610158,1054,12,721,401,320,610158,Тернопільська область
21505,610159,208,0,151,51,100,610159,Тернопільська область
21506,610160,687,6,407,130,277,610160,Тернопільська область
21507,610161,197,5,110,19,91,610161,Тернопільська область
21508,610162,702,11,443,242,201,610162,Тернопільська область
21509,610163,731,8,448,268,180,610163,Тернопільська область
21510,610164,333,3,219,154,65,610164,Тернопільська область
21511,610165,132,3,69,45,24,610165,Тернопільська область
21512,610166,178,4,136,89,47,610166,Тернопільська область
21513,610167,953,9,629,340,289,610167,Тернопільська область
21514,610168,458,7,289,89,200,610168,Тернопільська область
21515,610169,98,2,58,35,23,610169,Тернопільська область
21516,610170,767,9,446,220,226,610170,Тернопільська область
21517,610171,238,4,166,74,92,610171,Тернопільська область
21518,610172,685,7,484,170,314,610172,Тернопільська область
21519,610173,545,7,363,169,194,610173,Тернопільська область
21520,610174,1143,18,820,346,474,610174,Тернопільська область
21521,610175,254,5,168,99,69,610175,Тернопільська область
21522,610176,339,2,272,147,125,610176,Тернопільська область
21523,610177,358,4,239,128,111,610177,Тернопільська область
21524,610178,629,6,457,249,208,610178,Тернопільська область
21525,610179,218,2,170,79,91,610179,Тернопільська область
21526,610180,981,10,751,346,405,610180,Тернопільська область
21527,610181,1183,18,719,372,347,610181,Тернопільська область
21528,610182,617,10,474,246,228,610182,Тернопільська область
21529,610183,322,5,244,141,103,610183,Тернопільська область
21530,610184,788,13,504,263,241,610184,Тернопільська область
21531,610185,811,13,564,336,228,610185,Тернопільська область
21532,610186,225,4,153,76,77,610186,Тернопільська область
21533,610187,793,5,569,332,237,610187,Тернопільська область
21534,610188,1370,16,780,368,412,610188,Тернопільська область
21535,610189,1320,14,964,590,374,610189,Тернопільська область
21536,610190,916,13,567,325,242,610190,Тернопільська область
21537,610191,709,6,551,329,222,610191,Тернопільська область
21538,610192,425,3,334,193,141,610192,Тернопільська область
21539,610193,1598,35,908,249,659,610193,Тернопільська область
21540,610194,212,6,163,80,83,610194,Тернопільська область
21541,610195,817,8,485,241,244,610195,Тернопільська область
21542,610196,1010,11,521,277,244,610196,Тернопільська область
21543,610197,1106,15,708,349,359,610197,Тернопільська область
21544,610198,441,6,282,157,125,610198,Тернопільська область
21545,610199,390,3,219,126,93,610199,Тернопільська область
21546,610200,249,6,148,84,64,610200,Тернопільська область
21547,610201,368,7,238,96,142,610201,Тернопільська область
21548,610202,10,0,10,4,6,610202,Тернопільська область
21549,610203,101,5,61,36,25,610203,Тернопільська область
21550,610204,279,5,209,105,104,610204,Тернопільська область
21551,610205,958,13,682,394,288,610205,Тернопільська область
21552,610206,324,6,238,159,79,610206,Тернопільська область
21553,610207,134,1,86,65,21,610207,Тернопільська область
21554,610208,192,0,110,56,54,610208,Тернопільська область
21555,610209,794,12,534,268,266,610209,Тернопільська область
21556,610210,469,11,285,162,123,610210,Тернопільська область
21557,610211,724,14,404,240,164,610211,Тернопільська область
21558,610212,641,7,494,271,223,610212,Тернопільська область
21559,610213,1391,29,815,443,372,610213,Тернопільська область
21560,610214,1123,19,737,420,317,610214,Тернопільська область
21561,610215,1699,37,969,615,354,610215,Тернопільська область
21562,610216,1842,26,1059,667,392,610216,Тернопільська область
21563,610217,463,10,325,148,177,610217,Тернопільська область
21564,610218,48,2,26,17,9,610218,Тернопільська область
21565,610219,310,10,228,92,136,610219,Тернопільська область
21566,610220,436,3,320,161,159,610220,Тернопільська область
21567,610221,376,10,262,154,108,610221,Тернопільська область
21568,610222,884,7,587,337,250,610222,Тернопільська область
21569,610223,92,0,54,31,23,610223,Тернопільська область
21570,610224,72,0,44,19,25,610224,Тернопільська область
21571,610225,1729,38,972,499,473,610225,Тернопільська область
21572,610226,1664,27,954,458,496,610226,Тернопільська область
21573,610227,1494,34,765,387,378,610227,Тернопільська область
21574,610228,684,8,463,242,221,610228,Тернопільська область
21575,610229,1271,42,977,572,405,610229,Тернопільська область
21576,610230,417,3,275,136,139,610230,Тернопільська область
21577,610231,628,8,427,269,158,610231,Тернопільська область
21578,610232,158,6,96,40,56,610232,Тернопільська область
21579,610233,1492,30,1098,605,493,610233,Тернопільська область
21580,610234,169,0,118,50,68,610234,Тернопільська область
21581,610235,268,2,184,86,98,610235,Тернопільська область
21582,610236,229,0,173,91,82,610236,Тернопільська область
21583,610237,440,7,260,170,90,610237,Тернопільська область
21584,610238,151,3,120,55,65,610238,Тернопільська область
21585,610239,916,11,555,400,155,610239,Тернопільська область
21586,610240,162,0,107,52,55,610240,Тернопільська область
21587,610241,237,10,165,110,55,610241,Тернопільська область
21588,610242,1124,24,666,370,296,610242,Тернопільська область
21589,610243,319,11,250,101,149,610243,Тернопільська область
21590,610244,829,12,537,334,203,610244,Тернопільська область
21591,610245,211,2,148,49,99,610245,Тернопільська область
21592,610246,988,12,598,354,244,610246,Тернопільська область
21593,610247,482,11,348,138,210,610247,Тернопільська область
21594,610248,266,1,229,112,117,610248,Тернопільська область
21595,610249,695,22,540,223,317,610249,Тернопільська область
21596,610250,776,11,483,238,245,610250,Тернопільська область
21597,610251,568,13,441,252,189,610251,Тернопільська область
21598,610252,45,0,23,14,9,610252,Тернопільська область
21599,610253,705,6,494,265,229,610253,Тернопільська область
21600,610254,461,5,320,181,139,610254,Тернопільська область
21601,610255,631,15,434,249,185,610255,Тернопільська область
21602,610256,159,1,116,67,49,610256,Тернопільська область
21603,610257,498,4,402,122,280,610257,Тернопільська область
21604,610258,337,2,245,110,135,610258,Тернопільська область
21605,610259,992,11,671,439,232,610259,Тернопільська область
21606,610260,806,13,552,310,242,610260,Тернопільська область
21607,610261,1263,42,728,380,348,610261,Тернопільська область
21608,610262,1088,15,572,394,178,610262,Тернопільська область
21609,610263,1440,37,750,466,284,610263,Тернопільська область
21610,610264,1404,26,689,423,266,610264,Тернопільська область
21611,610265,527,8,340,174,166,610265,Тернопільська область
21612,610266,797,10,518,312,206,610266,Тернопільська область
21613,610267,189,4,153,122,31,610267,Тернопільська область
21614,610268,134,0,97,55,42,610268,Тернопільська область
21615,610269,1400,27,971,555,416,610269,Тернопільська область
21616,610270,125,7,114,103,11,610270,Тернопільська область
21617,610665,1282,31,700,463,237,610665,Тернопільська область
21618,610666,940,21,567,356,211,610666,Тернопільська область
21619,610667,954,12,583,414,169,610667,Тернопільська область
21620,610668,1070,16,532,335,197,610668,Тернопільська область
21621,610669,196,1,127,84,43,610669,Тернопільська область
21622,610670,187,0,145,45,100,610670,Тернопільська область
21623,610671,741,7,597,291,306,610671,Тернопільська область
21624,610672,304,7,164,107,57,610672,Тернопільська область
21625,610673,234,4,126,64,62,610673,Тернопільська область
21626,610674,520,8,330,232,98,610674,Тернопільська область
21627,610675,453,4,297,178,119,610675,Тернопільська область
21628,610676,156,9,101,40,61,610676,Тернопільська область
21629,610677,260,4,155,100,55,610677,Тернопільська область
21630,610678,206,1,152,90,62,610678,Тернопільська область
21631,610679,271,1,192,74,118,610679,Тернопільська область
21632,610680,91,0,59,25,34,610680,Тернопільська область
21633,610681,221,2,174,57,117,610681,Тернопільська область
21634,610682,153,1,123,40,83,610682,Тернопільська область
21635,610683,75,0,52,30,22,610683,Тернопільська область
21636,610684,837,25,533,413,120,610684,Тернопільська область
21637,610685,250,12,153,112,41,610685,Тернопільська область
21638,610686,157,2,110,61,49,610686,Тернопільська область
21639,610687,778,9,396,194,202,610687,Тернопільська область
21640,610688,1307,25,676,384,292,610688,Тернопільська область
21641,610689,660,11,412,182,230,610689,Тернопільська область
21642,610690,411,12,261,151,110,610690,Тернопільська область
21643,610691,202,1,90,58,32,610691,Тернопільська область
21644,610692,194,2,129,64,65,610692,Тернопільська область
21645,610693,235,6,138,89,49,610693,Тернопільська область
21646,610694,484,15,333,160,173,610694,Тернопільська область
21647,610695,494,14,348,186,162,610695,Тернопільська область
21648,610696,144,2,91,62,29,610696,Тернопільська область
21649,610697,697,8,419,245,174,610697,Тернопільська область
21650,610698,691,13,420,221,199,610698,Тернопільська область
21651,610699,148,1,118,63,55,610699,Тернопільська область
21652,610700,457,5,333,220,113,610700,Тернопільська область
21653,610701,413,5,255,161,94,610701,Тернопільська область
21654,610702,169,0,109,59,50,610702,Тернопільська область
21655,610703,432,10,301,193,108,610703,Тернопільська область
21656,610704,227,2,181,77,104,610704,Тернопільська область
21657,610705,208,2,143,67,76,610705,Тернопільська область
21658,610706,849,10,544,183,361,610706,Тернопільська область
21659,610707,140,3,71,33,38,610707,Тернопільська область
21660,610708,401,7,254,166,88,610708,Тернопільська область
21661,610709,319,7,219,122,97,610709,Тернопільська область
21662,610710,185,1,149,69,80,610710,Тернопільська область
21663,610711,136,1,112,55,57,610711,Тернопільська область
21664,610712,243,4,118,58,60,610712,Тернопільська область
21665,610713,302,9,199,122,77,610713,Тернопільська область
21666,610714,440,14,281,172,109,610714,Тернопільська область
21667,610715,569,9,351,165,186,610715,Тернопільська область
21668,610716,17,0,16,3,13,610716,Тернопільська область
21669,610814,425,3,349,107,242,610814,Тернопільська область
21670,610815,224,2,170,53,117,610815,Тернопільська область
21671,610816,1103,13,737,424,313,610816,Тернопільська область
21672,610817,147,2,117,38,79,610817,Тернопільська область
21673,610818,527,7,364,179,185,610818,Тернопільська область
21674,610819,773,14,489,241,248,610819,Тернопільська область
21675,610820,304,6,199,132,67,610820,Тернопільська область
21676,610821,512,5,333,133,200,610821,Тернопільська область
21677,610822,433,11,324,122,202,610822,Тернопільська область
21678,610823,312,8,245,150,95,610823,Тернопільська область
21679,610824,245,4,149,67,82,610824,Тернопільська область
21680,610825,521,5,417,187,230,610825,Тернопільська область
21681,610826,1486,27,929,382,547,610826,Тернопільська область
21682,610827,352,6,232,87,145,610827,Тернопільська область
21683,610828,118,1,84,49,35,610828,Тернопільська область
21684,610829,401,4,289,168,121,610829,Тернопільська область
21685,610830,504,17,392,211,181,610830,Тернопільська область
21686,610831,344,2,285,122,163,610831,Тернопільська область
21687,610832,601,9,372,159,213,610832,Тернопільська область
21688,610833,262,5,216,91,125,610833,Тернопільська область
21689,610834,572,8,340,182,158,610834,Тернопільська область
21690,610835,211,2,158,59,99,610835,Тернопільська область
21691,610836,83,0,74,31,43,610836,Тернопільська область
21692,610837,1199,13,707,374,333,610837,Тернопільська область
21693,610838,1057,20,808,358,450,610838,Тернопільська область
21694,610839,78,0,55,21,34,610839,Тернопільська область
21695,610840,962,19,624,306,318,610840,Тернопільська область
21696,610841,1037,25,695,488,207,610841,Тернопільська область
21697,610842,294,8,215,150,65,610842,Тернопільська область
21698,610843,264,4,194,72,122,610843,Тернопільська область
21699,610844,991,18,675,371,304,610844,Тернопільська область
21700,610845,874,23,543,334,209,610845,Тернопільська область
21701,610846,1239,16,977,502,475,610846,Тернопільська область
21702,610847,927,17,755,409,346,610847,Тернопільська область
21703,610848,154,8,115,42,73,610848,Тернопільська область
21704,610849,403,5,301,122,179,610849,Тернопільська область
21705,610850,340,1,235,121,114,610850,Тернопільська область
21706,610851,771,7,451,249,202,610851,Тернопільська область
21707,610852,343,9,251,125,126,610852,Тернопільська область
21708,610853,282,8,184,76,108,610853,Тернопільська область
21709,610854,358,5,240,150,90,610854,Тернопільська область
21710,610855,474,5,308,121,187,610855,Тернопільська область
21711,610856,672,14,425,254,171,610856,Тернопільська область
21712,610857,404,7,243,113,130,610857,Тернопільська область
21713,610858,361,9,235,110,125,610858,Тернопільська область
21714,610859,212,0,136,68,68,610859,Тернопільська область
21715,610860,827,16,594,304,290,610860,Тернопільська область
21716,610861,363,5,267,109,158,610861,Тернопільська область
21717,610862,403,5,270,126,144,610862,Тернопільська область
21718,610863,403,5,278,136,142,610863,Тернопільська область
21719,610864,268,7,204,87,117,610864,Тернопільська область
21720,610865,165,0,141,73,68,610865,Тернопільська область
21721,610866,50,0,46,17,29,610866,Тернопільська область
21722,610867,577,25,443,189,254,610867,Тернопільська область
21723,610868,586,6,399,135,264,610868,Тернопільська область
21724,610869,381,2,260,106,154,610869,Тернопільська область
21725,610870,161,2,115,47,68,610870,Тернопільська область
21726,610871,324,5,244,131,113,610871,Тернопільська область
21727,610872,269,6,199,130,69,610872,Тернопільська область
21728,610873,1075,15,641,311,330,610873,Тернопільська область
21729,610874,1034,14,663,334,329,610874,Тернопільська область
21730,610875,327,5,192,103,89,610875,Тернопільська область
21731,610876,181,5,93,41,52,610876,Тернопільська область
21732,610877,682,8,432,191,241,610877,Тернопільська область
21733,610878,165,4,97,29,68,610878,Тернопільська область
21734,610879,1394,15,854,424,430,610879,Тернопільська область
21735,610880,1610,36,878,422,456,610880,Тернопільська область
21736,610881,954,19,556,286,270,610881,Тернопільська область
21737,610882,567,4,355,200,155,610882,Тернопільська область
21738,610883,493,13,323,162,161,610883,Тернопільська область
21739,610884,163,1,106,52,54,610884,Тернопільська область
21740,610885,405,11,262,165,97,610885,Тернопільська область
21741,610886,1398,35,795,394,401,610886,Тернопільська область
21742,610887,945,15,503,243,260,610887,Тернопільська область
21743,610888,1331,27,743,374,369,610888,Тернопільська область
21744,610889,2262,58,1216,694,522,610889,Тернопільська область
21745,610890,938,16,464,217,247,610890,Тернопільська область
21746,610891,2133,28,1134,620,514,610891,Тернопільська область
21747,610892,1058,27,628,314,314,610892,Тернопільська область
21748,611183,1183,22,688,420,268,611183,Тернопільська область
21749,1,222,25,196,162,34,1,Тернопільська область
21750,610055,549,12,329,171,158,610055,Тернопільська область
21751,610056,124,2,83,68,15,610056,Тернопільська область
21752,610057,396,5,311,96,215,610057,Тернопільська область
21753,610058,1404,14,1008,592,416,610058,Тернопільська область
21754,610059,439,1,348,125,223,610059,Тернопільська область
21755,610060,1353,35,690,414,276,610060,Тернопільська область
21756,610061,2001,40,1058,689,369,610061,Тернопільська область
21757,610062,1485,27,800,482,318,610062,Тернопільська область
21758,610063,2007,30,1038,625,413,610063,Тернопільська область
21759,610064,1038,31,564,367,197,610064,Тернопільська область
21760,610065,742,6,443,245,198,610065,Тернопільська область
21761,610066,138,0,78,40,38,610066,Тернопільська область
21762,610067,494,16,252,148,104,610067,Тернопільська область
21763,610068,330,3,219,113,106,610068,Тернопільська область
21764,610069,439,4,264,196,68,610069,Тернопільська область
21765,610070,1170,4,703,380,323,610070,Тернопільська область
21766,610071,978,30,569,368,201,610071,Тернопільська область
21767,610072,1238,19,757,430,327,610072,Тернопільська область
21768,610073,965,20,754,399,355,610073,Тернопільська область
21769,610074,1375,24,985,560,425,610074,Тернопільська область
21770,610075,391,8,259,166,93,610075,Тернопільська область
21771,610076,245,6,182,95,87,610076,Тернопільська область
21772,610077,143,0,91,50,41,610077,Тернопільська область
21773,610078,764,6,460,288,172,610078,Тернопільська область
21774,610079,522,10,323,197,126,610079,Тернопільська область
21775,610080,47,1,36,10,26,610080,Тернопільська область
21776,610081,242,8,152,97,55,610081,Тернопільська область
21777,610082,51,1,40,20,20,610082,Тернопільська область
21778,610083,621,6,330,166,164,610083,Тернопільська область
21779,610084,115,1,66,47,19,610084,Тернопільська область
21780,610085,262,3,188,72,116,610085,Тернопільська область
21781,610086,287,1,196,147,49,610086,Тернопільська область
21782,610087,1229,30,795,508,287,610087,Тернопільська область
21783,610088,1367,25,935,443,492,610088,Тернопільська область
21784,610089,291,5,224,105,119,610089,Тернопільська область
21785,610090,735,5,440,271,169,610090,Тернопільська область
21786,610091,1264,24,681,480,201,610091,Тернопільська область
21787,610092,1023,5,649,297,352,610092,Тернопільська область
21788,610093,1095,19,686,415,271,610093,Тернопільська область
21789,610094,192,1,127,84,43,610094,Тернопільська область
21790,610095,845,10,584,288,296,610095,Тернопільська область
21791,610096,1865,28,917,506,411,610096,Тернопільська область
21792,610097,855,20,408,205,203,610097,Тернопільська область
21793,610098,390,6,223,115,108,610098,Тернопільська область
21794,610099,142,3,81,37,44,610099,Тернопільська область
21795,610100,162,0,123,71,52,610100,Тернопільська область
21796,610101,83,8,53,40,13,610101,Тернопільська область
21797,610102,846,13,528,332,196,610102,Тернопільська область
21798,610103,539,21,298,148,150,610103,Тернопільська область
21799,610104,1238,17,675,370,305,610104,Тернопільська область
21800,610105,365,2,214,116,98,610105,Тернопільська область
21801,610106,698,8,435,209,226,610106,Тернопільська область
21802,610107,877,16,504,266,238,610107,Тернопільська область
21803,610108,89,2,62,42,20,610108,Тернопільська область
21804,610109,280,2,201,92,109,610109,Тернопільська область
21805,610110,648,12,448,266,182,610110,Тернопільська область
21806,610111,517,12,343,221,122,610111,Тернопільська область
21807,610112,57,1,42,19,23,610112,Тернопільська область
21808,610113,583,7,398,167,231,610113,Тернопільська область
21809,610114,872,7,457,284,173,610114,Тернопільська область
21810,610115,1198,16,707,456,251,610115,Тернопільська область
21811,610116,1127,14,549,396,153,610116,Тернопільська область
21812,610117,356,15,270,173,97,610117,Тернопільська область
21813,610118,628,3,364,234,130,610118,Тернопільська область
21814,610119,731,11,454,271,183,610119,Тернопільська область
21815,610120,170,1,145,55,90,610120,Тернопільська область
21816,610121,157,3,125,96,29,610121,Тернопільська область
21817,610122,505,6,285,194,91,610122,Тернопільська область
21818,610123,221,6,158,84,74,610123,Тернопільська область
21819,610124,743,22,395,233,162,610124,Тернопільська область
21820,610125,480,6,279,167,112,610125,Тернопільська область
21821,610126,199,5,119,67,52,610126,Тернопільська область
21822,610127,1043,12,603,340,263,610127,Тернопільська область
21823,610128,512,8,315,169,146,610128,Тернопільська область
21824,610129,170,3,118,69,49,610129,Тернопільська область
21825,610130,1353,26,890,445,445,610130,Тернопільська область
21826,610131,212,9,135,90,45,610131,Тернопільська область
21827,610271,1127,20,728,359,369,610271,Тернопільська область
21828,610272,418,4,258,139,119,610272,Тернопільська область
21829,610273,104,1,64,36,28,610273,Тернопільська область
21830,610274,530,6,406,168,238,610274,Тернопільська область
21831,610275,546,4,385,230,155,610275,Тернопільська область
21832,610276,272,5,165,123,42,610276,Тернопільська область
21833,610277,438,9,277,125,152,610277,Тернопільська область
21834,610278,227,5,152,96,56,610278,Тернопільська область
21835,610279,474,10,313,215,98,610279,Тернопільська область
21836,610280,498,5,282,198,84,610280,Тернопільська область
21837,610281,770,11,497,325,172,610281,Тернопільська область
21838,610282,1344,18,807,482,325,610282,Тернопільська область
21839,610283,631,6,391,182,209,610283,Тернопільська область
21840,610284,272,8,188,85,103,610284,Тернопільська область
21841,610285,303,0,180,86,94,610285,Тернопільська область
21842,610286,344,3,224,113,111,610286,Тернопільська область
21843,610287,189,3,146,68,78,610287,Тернопільська область
21844,610288,2159,29,1184,765,419,610288,Тернопільська область
21845,610289,1570,26,761,490,271,610289,Тернопільська область
21846,610290,1566,29,881,542,339,610290,Тернопільська область
21847,610291,2092,28,1142,780,362,610291,Тернопільська область
21848,610292,425,4,244,131,113,610292,Тернопільська область
21849,610293,333,2,223,163,60,610293,Тернопільська область
21850,610294,423,2,288,172,116,610294,Тернопільська область
21851,610295,752,13,493,265,228,610295,Тернопільська область
21852,610296,617,10,380,168,212,610296,Тернопільська область
21853,610297,757,5,653,192,461,610297,Тернопільська область
21854,610298,434,3,325,190,135,610298,Тернопільська область
21855,610299,886,25,658,357,301,610299,Тернопільська область
21856,610300,404,2,297,171,126,610300,Тернопільська область
21857,610301,298,8,195,127,68,610301,Тернопільська область
21858,610302,320,7,168,77,91,610302,Тернопільська область
21859,610303,1447,17,936,555,381,610303,Тернопільська область
21860,610304,523,12,308,127,181,610304,Тернопільська область
21861,610305,282,5,178,96,82,610305,Тернопільська область
21862,610306,350,8,258,105,153,610306,Тернопільська область
21863,610307,653,14,417,183,234,610307,Тернопільська область
21864,610308,1190,15,689,403,286,610308,Тернопільська область
21865,610309,121,0,95,35,60,610309,Тернопільська область
21866,610310,1090,24,769,513,256,610310,Тернопільська область
21867,610311,662,17,472,212,260,610311,Тернопільська область
21868,610312,784,7,487,342,145,610312,Тернопільська область
21869,610313,398,6,295,127,168,610313,Тернопільська область
21870,610314,507,4,363,256,107,610314,Тернопільська область
21871,610315,436,7,345,183,162,610315,Тернопільська область
21872,610316,1146,17,622,343,279,610316,Тернопільська область
21873,610317,1318,20,691,381,310,610317,Тернопільська область
21874,610318,77,3,60,36,24,610318,Тернопільська область
21875,610319,628,5,414,247,167,610319,Тернопільська область
21876,610320,154,6,117,73,44,610320,Тернопільська область
21877,610321,420,6,268,187,81,610321,Тернопільська область
21878,610322,162,0,129,84,45,610322,Тернопільська область
21879,610323,549,7,410,227,183,610323,Тернопільська область
21880,610324,240,3,137,72,65,610324,Тернопільська область
21881,610325,288,3,171,79,92,610325,Тернопільська область
21882,610326,627,10,461,275,186,610326,Тернопільська область
21883,610327,399,4,272,103,169,610327,Тернопільська область
21884,610959,258,6,166,106,60,610959,Тернопільська область
21885,610960,579,9,402,218,184,610960,Тернопільська область
21886,610961,590,14,452,148,304,610961,Тернопільська область
21887,610962,1478,30,761,374,387,610962,Тернопільська область
21888,610963,1398,16,804,447,357,610963,Тернопільська область
21889,610964,1255,24,786,475,311,610964,Тернопільська область
21890,610965,205,1,141,66,75,610965,Тернопільська область
21891,610966,92,3,63,36,27,610966,Тернопільська область
21892,610967,196,2,102,63,39,610967,Тернопільська область
21893,610968,789,11,597,257,340,610968,Тернопільська область
21894,610969,812,7,482,267,215,610969,Тернопільська область
21895,610970,689,7,463,267,196,610970,Тернопільська область
21896,610971,942,21,544,276,268,610971,Тернопільська область
21897,610972,317,4,238,164,74,610972,Тернопільська область
21898,610973,369,9,271,148,123,610973,Тернопільська область
21899,610974,448,9,292,120,172,610974,Тернопільська область
21900,610975,1238,12,643,346,297,610975,Тернопільська область
21901,610976,1233,26,722,355,367,610976,Тернопільська область
21902,610977,729,10,432,197,235,610977,Тернопільська область
21903,610978,694,8,457,214,243,610978,Тернопільська область
21904,610979,68,0,43,8,35,610979,Тернопільська область
21905,610980,285,3,169,108,61,610980,Тернопільська область
21906,610981,290,4,194,91,103,610981,Тернопільська область
21907,610982,1306,15,900,476,424,610982,Тернопільська область
21908,610983,960,16,811,447,364,610983,Тернопільська область
21909,610984,352,9,185,93,92,610984,Тернопільська область
21910,610985,324,6,209,101,108,610985,Тернопільська область
21911,610986,114,2,70,28,42,610986,Тернопільська область
21912,610987,364,0,244,120,124,610987,Тернопільська область
21913,610988,486,5,283,95,188,610988,Тернопільська область
21914,610989,471,4,326,180,146,610989,Тернопільська область
21915,610990,1527,32,955,550,405,610990,Тернопільська область
21916,610991,426,5,326,172,154,610991,Тернопільська область
21917,610992,348,7,201,127,74,610992,Тернопільська область
21918,610993,515,6,317,203,114,610993,Тернопільська область
21919,610994,609,2,422,204,218,610994,Тернопільська область
21920,610995,587,9,329,176,153,610995,Тернопільська область
21921,610996,803,7,454,228,226,610996,Тернопільська область
21922,610997,452,9,362,176,186,610997,Тернопільська область
21923,610998,436,8,322,189,133,610998,Тернопільська область
21924,610999,1308,13,938,303,635,610999,Тернопільська область
21925,611000,774,18,485,315,170,611000,Тернопільська область
21926,611001,155,0,116,63,53,611001,Тернопільська область
21927,611002,179,3,129,52,77,611002,Тернопільська область
21928,611003,517,7,336,143,193,611003,Тернопільська область
21929,611004,153,3,93,55,38,611004,Тернопільська область
21930,611005,816,11,661,253,408,611005,Тернопільська область
21931,611006,384,2,240,111,129,611006,Тернопільська область
21932,611007,235,0,175,76,99,611007,Тернопільська область
21933,611008,586,19,346,245,101,611008,Тернопільська область
21934,611009,734,11,445,261,184,611009,Тернопільська область
21935,611010,898,14,576,307,269,611010,Тернопільська область
21936,611011,82,3,52,27,25,611011,Тернопільська область
21937,611012,332,6,231,101,130,611012,Тернопільська область
21938,611013,1588,29,926,475,451,611013,Тернопільська область
21939,611014,1288,29,697,339,358,611014,Тернопільська область
21940,611015,1998,28,1027,521,506,611015,Тернопільська область
21941,611016,1439,21,773,385,388,611016,Тернопільська область
21942,611017,1043,24,575,325,250,611017,Тернопільська область
21943,611018,1048,14,535,256,279,611018,Тернопільська область
21944,611019,1071,13,669,376,293,611019,Тернопільська область
21945,611020,1030,16,592,285,307,611020,Тернопільська область
21946,611021,2088,32,1062,621,441,611021,Тернопільська область
21947,611022,1608,36,916,483,433,611022,Тернопільська область
21948,611023,766,13,441,211,230,611023,Тернопільська область
21949,611024,1663,29,860,431,429,611024,Тернопільська область
21950,611025,716,11,406,248,158,611025,Тернопільська область
21951,611026,1493,29,858,429,429,611026,Тернопільська область
21952,611027,1576,24,871,437,434,611027,Тернопільська область
21953,611028,117,0,74,37,37,611028,Тернопільська область
21954,611029,539,13,338,149,189,611029,Тернопільська область
21955,611030,598,13,396,194,202,611030,Тернопільська область
21956,611031,363,9,231,139,92,611031,Тернопільська область
21957,611032,925,8,540,369,171,611032,Тернопільська область
21958,611033,109,2,98,47,51,611033,Тернопільська область
21959,611185,1064,14,534,283,251,611185,Тернопільська область
21960,611187,119,0,78,52,26,611187,Тернопільська область
21961,631089,2029,30,1353,1172,181,631089,Харківська область
21962,631090,1927,28,1335,1170,165,631090,Харківська область
21963,631091,1935,24,1297,1105,192,631091,Харківська область
21964,631092,1832,25,1216,1033,183,631092,Харківська область
21965,631093,2016,24,1414,1180,234,631093,Харківська область
21966,631094,1852,31,1206,1015,191,631094,Харківська область
21967,631095,1989,33,1135,957,178,631095,Харківська область
21968,631096,1890,36,1228,960,268,631096,Харківська область
21969,631097,2033,16,1212,1087,125,631097,Харківська область
21970,631098,1975,25,1349,1181,168,631098,Харківська область
21971,631099,2212,46,1449,1267,182,631099,Харківська область
21972,631100,2093,21,1156,959,197,631100,Харківська область
21973,631101,2124,22,1415,1221,194,631101,Харківська область
21974,631102,2047,46,1360,1137,223,631102,Харківська область
21975,631103,1916,24,1317,1118,199,631103,Харківська область
21976,631104,1953,33,1267,1085,182,631104,Харківська область
21977,631105,1801,20,1242,1041,201,631105,Харківська область
21978,631106,1858,29,1239,1025,214,631106,Харківська область
21979,631107,2182,30,1507,1283,224,631107,Харківська область
21980,631108,2150,17,959,870,89,631108,Харківська область
21981,631109,1993,32,1334,1120,214,631109,Харківська область
21982,631110,2053,33,1395,1172,223,631110,Харківська область
21983,631111,2225,14,927,827,100,631111,Харківська область
21984,631112,2154,40,1421,1172,249,631112,Харківська область
21985,631113,2094,39,1370,1175,195,631113,Харківська область
21986,631114,1835,32,1205,975,230,631114,Харківська область
21987,631115,2245,33,1596,1310,286,631115,Харківська область
21988,631116,1761,29,1165,975,190,631116,Харківська область
21989,631117,2017,21,1339,1130,209,631117,Харківська область
21990,631118,2048,31,1365,1168,197,631118,Харківська область
21991,631119,1677,45,1082,915,167,631119,Харківська область
21992,631120,1837,27,1217,1020,197,631120,Харківська область
21993,631121,1941,40,1280,1085,195,631121,Харківська область
21994,631122,1611,29,1099,925,174,631122,Харківська область
21995,631123,2175,32,1486,1245,241,631123,Харківська область
21996,631124,2233,30,1291,1083,208,631124,Харківська область
21997,631125,1792,31,1224,994,230,631125,Харківська область
21998,631126,1685,25,1095,898,197,631126,Харківська область
21999,631127,1754,30,1169,968,201,631127,Харківська область
22000,631128,1813,32,1164,950,214,631128,Харківська область
22001,631129,1756,40,1134,907,227,631129,Харківська область
22002,631130,1573,26,1050,854,196,631130,Харківська область
22003,631131,1712,28,1117,880,237,631131,Харківська область
22004,631132,1540,30,987,805,182,631132,Харківська область
22005,631133,1315,14,846,668,178,631133,Харківська область
22006,631134,1738,32,1102,899,203,631134,Харківська область
22007,631135,1619,30,1076,824,252,631135,Харківська область
22008,631136,1470,38,947,716,231,631136,Харківська область
22009,631137,2037,51,1287,1027,260,631137,Харківська область
22010,631138,1995,26,1202,983,219,631138,Харківська область
22011,631139,1987,39,1227,1015,212,631139,Харківська область
22012,631140,2120,26,1247,1025,222,631140,Харківська область
22013,631141,2335,41,1521,1164,357,631141,Харківська область
22014,631142,1930,36,1234,985,249,631142,Харківська область
22015,631143,2119,43,1319,1131,188,631143,Харківська область
22016,631144,2049,28,1246,1074,172,631144,Харківська область
22017,631145,2150,29,1091,910,181,631145,Харківська область
22018,631146,1448,19,739,655,84,631146,Харківська область
22019,631147,1945,4,798,735,63,631147,Харківська область
22020,631148,2146,47,1411,1121,290,631148,Харківська область
22021,631149,2009,57,1326,1041,285,631149,Харківська область
22022,631150,2081,40,1427,1089,338,631150,Харківська область
22023,631151,2276,48,1440,1136,304,631151,Харківська область
22024,631152,2098,39,1495,1254,241,631152,Харківська область
22025,631153,2106,34,1481,1299,182,631153,Харківська область
22026,631154,2119,24,1327,1164,163,631154,Харківська область
22027,631155,2226,37,1463,1151,312,631155,Харківська область
22028,631156,2169,40,1412,1116,296,631156,Харківська область
22029,631157,1315,25,851,652,199,631157,Харківська область
22030,631158,1208,29,813,624,189,631158,Харківська область
22031,631159,1919,39,1273,957,316,631159,Харківська область
22032,631160,2201,34,1461,1172,289,631160,Харківська область
22033,631161,2054,42,1299,1050,249,631161,Харківська область
22034,631162,2043,41,1318,973,345,631162,Харківська область
22035,631163,2277,48,1485,1134,351,631163,Харківська область
22036,631164,2079,34,1716,1237,479,631164,Харківська область
22037,631165,1682,33,1043,776,267,631165,Харківська область
22038,631166,1797,42,1095,836,259,631166,Харківська область
22039,631167,231,1,221,197,24,631167,Харківська область
22040,631168,181,1,176,127,49,631168,Харківська область
22041,631169,28,0,28,23,5,631169,Харківська область
22042,631170,73,5,67,57,10,631170,Харківська область
22043,631171,138,3,132,126,6,631171,Харківська область
22044,631172,250,8,241,212,29,631172,Харківська область
22045,631173,149,5,127,114,13,631173,Харківська область
22046,631174,104,3,100,96,4,631174,Харківська область
22047,631175,88,1,82,72,10,631175,Харківська область
22048,631176,855,12,843,744,99,631176,Харківська область
22049,631696,1676,15,949,800,149,631696,Харківська область
22050,631697,1209,25,845,611,234,631697,Харківська область
22051,631698,1864,24,1287,868,419,631698,Харківська область
22052,631231,1795,41,1133,886,247,631231,Харківська область
22053,631232,1852,28,1210,941,269,631232,Харківська область
22054,631233,2370,47,1497,1199,298,631233,Харківська область
22055,631234,1821,27,1201,872,329,631234,Харківська область
22056,631235,1776,48,1144,884,260,631235,Харківська область
22057,631236,1988,44,1375,1075,300,631236,Харківська область
22058,631237,1940,18,1054,898,156,631237,Харківська область
22059,631238,1432,25,1026,877,149,631238,Харківська область
22060,631239,1371,15,745,658,87,631239,Харківська область
22061,631240,2074,42,1333,1041,292,631240,Харківська область
22062,631241,1780,32,1152,862,290,631241,Харківська область
22063,631242,1933,42,1254,959,295,631242,Харківська область
22064,631243,1952,31,1215,961,254,631243,Харківська область
22065,631244,1833,31,1114,990,124,631244,Харківська область
22066,631245,1918,23,1276,1120,156,631245,Харківська область
22067,631246,1847,26,1223,1040,183,631246,Харківська область
22068,631247,2216,39,1437,1271,166,631247,Харківська область
22069,631248,1261,15,814,720,94,631248,Харківська область
22070,631249,2251,33,1578,1400,178,631249,Харківська область
22071,631250,2922,42,2009,1658,351,631250,Харківська область
22072,631251,1948,21,1182,1050,132,631251,Харківська область
22073,631252,1394,33,834,659,175,631252,Харківська область
22074,631253,1074,11,641,560,81,631253,Харківська область
22075,631254,2357,32,1507,1267,240,631254,Харківська область
22076,631255,2035,33,1261,1034,227,631255,Харківська область
22077,631256,2263,26,1266,1138,128,631256,Харківська область
22078,631257,2455,35,1513,1370,143,631257,Харківська область
22079,631258,1725,27,1125,924,201,631258,Харківська область
22080,631259,1613,21,972,852,120,631259,Харківська область
22081,631260,928,17,579,516,63,631260,Харківська область
22082,631261,1795,16,1045,895,150,631261,Харківська область
22083,631262,1622,12,805,764,41,631262,Харківська область
22084,631263,2079,33,1354,1153,201,631263,Харківська область
22085,631264,1776,25,1209,991,218,631264,Харківська область
22086,631265,1942,29,1350,1149,201,631265,Харківська область
22087,631266,1652,37,1107,937,170,631266,Харківська область
22088,631267,1835,25,1231,1015,216,631267,Харківська область
22089,631268,1792,23,1211,1015,196,631268,Харківська область
22090,631269,1861,34,1246,1043,203,631269,Харківська область
22091,631270,1843,35,1226,1031,195,631270,Харківська область
22092,631271,1949,44,1301,1101,200,631271,Харківська область
22093,631272,1963,13,1161,1025,136,631272,Харківська область
22094,631273,2007,26,1295,1141,154,631273,Харківська область
22095,631274,1870,25,1194,1041,153,631274,Харківська область
22096,631275,2012,26,1350,1122,228,631275,Харківська область
22097,631276,2060,33,1398,1134,264,631276,Харківська область
22098,631277,2097,29,1480,1227,253,631277,Харківська область
22099,631278,2133,48,1412,1210,202,631278,Харківська область
22100,631279,2139,38,1498,1255,243,631279,Харківська область
22101,631280,2165,43,1428,1202,226,631280,Харківська область
22102,631281,1476,25,980,788,192,631281,Харківська область
22103,631282,1664,32,1157,919,238,631282,Харківська область
22104,631283,1771,31,1101,892,209,631283,Харківська область
22105,631284,1834,32,1267,948,319,631284,Харківська область
22106,631285,1348,27,894,739,155,631285,Харківська область
22107,631286,1934,45,1296,1141,155,631286,Харківська область
22108,631287,1883,28,1327,1189,138,631287,Харківська область
22109,631288,1836,29,1277,1103,174,631288,Харківська область
22110,631289,1889,32,1262,1084,178,631289,Харківська область
22111,631290,1732,15,1147,1030,117,631290,Харківська область
22112,631291,2020,23,1355,1156,199,631291,Харківська область
22113,631292,2136,30,1477,1265,212,631292,Харківська область
22114,631293,1299,12,911,777,134,631293,Харківська область
22115,631294,1634,32,1124,997,127,631294,Харківська область
22116,631295,2070,30,1388,1225,163,631295,Харківська область
22117,631296,2117,29,1440,1238,202,631296,Харківська область
22118,631297,2079,28,1355,1164,191,631297,Харківська область
22119,631298,1904,25,1342,1176,166,631298,Харківська область
22120,631299,1835,19,1181,1029,152,631299,Харківська область
22121,631300,1696,25,1141,989,152,631300,Харківська область
22122,631301,1973,21,1294,1116,178,631301,Харківська область
22123,631302,15,1,14,12,2,631302,Харківська область
22124,631304,71,2,67,55,12,631304,Харківська область
22125,631305,91,4,87,80,7,631305,Харківська область
22126,631306,58,2,54,50,4,631306,Харківська область
22127,631307,67,3,63,52,11,631307,Харківська область
22128,631308,29,1,28,21,7,631308,Харківська область
22129,631309,192,6,185,156,29,631309,Харківська область
22130,631310,39,2,35,25,10,631310,Харківська область
22131,631311,31,0,31,24,7,631311,Харківська область
22132,631312,33,1,30,23,7,631312,Харківська область
22133,631313,69,1,65,56,9,631313,Харківська область
22134,631314,187,9,170,155,15,631314,Харківська область
22135,631315,22,0,21,17,4,631315,Харківська область
22136,631415,1423,24,872,720,152,631415,Харківська область
22137,631416,1796,31,1230,1001,229,631416,Харківська область
22138,631417,2332,40,1504,1295,209,631417,Харківська область
22139,631418,1753,31,1113,927,186,631418,Харківська область
22140,631419,1295,17,814,674,140,631419,Харківська область
22141,631420,1203,11,757,643,114,631420,Харківська область
22142,631421,1253,16,736,642,94,631421,Харківська область
22143,631481,1842,33,1217,1008,209,631481,Харківська область
22144,631482,1521,29,973,843,130,631482,Харківська область
22145,631483,1732,32,1144,968,176,631483,Харківська область
22146,631484,2121,25,1420,1187,233,631484,Харківська область
22147,631525,36,0,36,33,3,631525,Харківська область
22148,631526,25,3,22,20,2,631526,Харківська область
22149,631527,20,0,19,17,2,631527,Харківська область
22150,631690,1123,30,683,567,116,631690,Харківська область
22151,631691,2505,35,1618,1310,308,631691,Харківська область
22152,631701,997,10,625,539,86,631701,Харківська область
22153,631422,819,10,551,456,95,631422,Харківська область
22154,631423,2081,21,1355,1185,170,631423,Харківська область
22155,631424,2177,24,1442,1267,175,631424,Харківська область
22156,631425,1265,15,842,744,98,631425,Харківська область
22157,631426,2210,31,1256,1105,151,631426,Харківська область
22158,631427,2291,26,1464,1283,181,631427,Харківська область
22159,631428,2090,28,1259,1129,130,631428,Харківська область
22160,631429,1927,26,1219,1117,102,631429,Харківська область
22161,631430,2294,35,1319,1185,134,631430,Харківська область
22162,631431,1873,13,1234,1069,165,631431,Харківська область
22163,631432,2164,28,1410,1229,181,631432,Харківська область
22164,631433,2208,33,1401,1246,155,631433,Харківська область
22165,631434,1969,35,1346,1179,167,631434,Харківська область
22166,631435,1245,17,666,611,55,631435,Харківська область
22167,631436,2163,40,1400,1199,201,631436,Харківська область
22168,631437,1871,19,1134,1024,110,631437,Харківська область
22169,631438,1702,19,934,815,119,631438,Харківська область
22170,631439,2143,21,1426,1255,171,631439,Харківська область
22171,631440,2282,23,1502,1314,188,631440,Харківська область
22172,631441,2009,25,1300,1166,134,631441,Харківська область
22173,631442,2190,26,1420,1259,161,631442,Харківська область
22174,631443,2199,29,1458,1279,179,631443,Харківська область
22175,631444,1324,10,904,807,97,631444,Харківська область
22176,631445,1497,28,1005,910,95,631445,Харківська область
22177,631446,1864,20,1220,1062,158,631446,Харківська область
22178,631451,1233,18,819,709,110,631451,Харківська область
22179,631452,1927,14,1256,1126,130,631452,Харківська область
22180,631453,1741,32,1135,995,140,631453,Харківська область
22181,631454,1962,24,1255,1096,159,631454,Харківська область
22182,631455,2029,25,1300,1131,169,631455,Харківська область
22183,631456,2020,27,1333,1155,178,631456,Харківська область
22184,631457,2312,36,1491,1299,192,631457,Харківська область
22185,631458,2217,22,1487,1315,172,631458,Харківська область
22186,631459,2017,29,1264,1150,114,631459,Харківська область
22187,631460,2108,18,1307,1152,155,631460,Харківська область
22188,631461,2240,36,1419,1226,193,631461,Харківська область
22189,631467,2053,35,1414,1223,191,631467,Харківська область
22190,631468,1654,37,1126,965,161,631468,Харківська область
22191,631469,1978,25,1346,1168,178,631469,Харківська область
22192,631470,1746,18,1138,995,143,631470,Харківська область
22193,631471,1637,28,1136,982,154,631471,Харківська область
22194,631472,1849,33,1278,1107,171,631472,Харківська область
22195,631473,1892,29,1300,1084,216,631473,Харківська область
22196,631474,1933,28,1297,1106,191,631474,Харківська область
22197,631475,1993,44,1324,1146,178,631475,Харківська область
22198,631476,1912,22,1274,1100,174,631476,Харківська область
22199,631477,1484,21,1014,880,134,631477,Харківська область
22200,631478,1962,35,1264,1101,163,631478,Харківська область
22201,631479,1924,26,1271,1087,184,631479,Харківська область
22202,631480,2325,30,1540,1287,253,631480,Харківська область
22203,631485,1853,23,1215,1062,153,631485,Харківська область
22204,631486,1814,25,1202,1038,164,631486,Харківська область
22205,631487,1886,24,1282,1096,186,631487,Харківська область
22206,631488,1905,26,1226,1039,187,631488,Харківська область
22207,631489,2092,29,1396,1233,163,631489,Харківська область
22208,631490,1911,33,1298,1102,196,631490,Харківська область
22209,631491,1796,26,1161,1020,141,631491,Харківська область
22210,631492,1817,26,1198,1029,169,631492,Харківська область
22211,631506,2183,28,1432,1244,188,631506,Харківська область
22212,631507,1965,31,1338,1156,182,631507,Харківська область
22213,631508,1762,24,1176,1021,155,631508,Харківська область
22214,631509,2054,40,1339,1186,153,631509,Харківська область
22215,631510,1985,29,1299,1155,144,631510,Харківська область
22216,631511,1754,38,1131,1006,125,631511,Харківська область
22217,631512,1909,19,1230,1081,149,631512,Харківська область
22218,631513,2021,26,1378,1212,166,631513,Харківська область
22219,631514,2069,25,1377,1192,185,631514,Харківська область
22220,631515,2399,44,1591,1325,266,631515,Харківська область
22221,631516,2268,40,1499,1295,204,631516,Харківська область
22222,631517,2053,36,1349,1161,188,631517,Харківська область
22223,631518,1955,16,1324,1164,160,631518,Харківська область
22224,631519,1848,29,1274,1109,165,631519,Харківська область
22225,631520,2148,37,1433,1246,187,631520,Харківська область
22226,631521,1957,31,1342,1150,192,631521,Харківська область
22227,631522,2278,34,1488,1269,219,631522,Харківська область
22228,631523,2223,24,1536,1288,248,631523,Харківська область
22229,631524,2203,37,1425,1214,211,631524,Харківська область
22230,631528,293,10,277,245,32,631528,Харківська область
22231,631529,143,3,138,116,22,631529,Харківська область
22232,631530,52,0,51,47,4,631530,Харківська область
22233,631531,511,58,446,359,87,631531,Харківська область
22234,631532,54,0,53,50,3,631532,Харківська область
22235,631354,2149,40,1393,1244,149,631354,Харківська область
22236,631355,2109,38,1397,1240,157,631355,Харківська область
22237,631356,1635,29,1106,972,134,631356,Харківська область
22238,631357,2090,37,1309,1159,150,631357,Харківська область
22239,631358,2049,34,1323,1179,144,631358,Харківська область
22240,631359,1771,28,1182,1017,165,631359,Харківська область
22241,631360,1598,16,1079,916,163,631360,Харківська область
22242,631361,1729,21,1167,1024,143,631361,Харківська область
22243,631362,1967,27,1231,1071,160,631362,Харківська область
22244,631363,1517,21,966,867,99,631363,Харківська область
22245,631364,1739,26,1227,1048,179,631364,Харківська область
22246,631365,1456,28,928,803,125,631365,Харківська область
22247,631366,2018,23,1382,1193,189,631366,Харківська область
22248,631367,2023,34,1352,1194,158,631367,Харківська область
22249,631368,1846,34,1240,1084,156,631368,Харківська область
22250,631369,1686,19,1126,961,165,631369,Харківська область
22251,631370,1855,35,1261,1068,193,631370,Харківська область
22252,631371,1802,31,1228,1063,165,631371,Харківська область
22253,631372,1887,30,1199,1047,152,631372,Харківська область
22254,631533,2176,23,1318,1171,147,631533,Харківська область
22255,631534,2105,27,1434,1303,131,631534,Харківська область
22256,631535,2261,36,1525,1321,204,631535,Харківська область
22257,631536,2195,28,1278,1139,139,631536,Харківська область
22258,631591,2199,37,1457,1285,172,631591,Харківська область
22259,631592,1706,21,979,873,106,631592,Харківська область
22260,631593,1482,18,967,838,129,631593,Харківська область
22261,631594,1964,23,1218,1079,139,631594,Харківська область
22262,631595,1909,18,1116,985,131,631595,Харківська область
22263,631596,2110,33,1358,1161,197,631596,Харківська область
22264,631597,2062,26,1411,1228,183,631597,Харківська область
22265,631598,2171,39,1389,1211,178,631598,Харківська область
22266,631599,2151,38,1422,1251,171,631599,Харківська область
22267,631600,1986,32,1308,1115,193,631600,Харківська область
22268,631601,2133,37,1340,1159,181,631601,Харківська область
22269,631602,1849,22,1189,1038,151,631602,Харківська область
22270,631603,2157,36,1365,1181,184,631603,Харківська область
22271,631604,1883,29,1244,1058,186,631604,Харківська область
22272,631605,2181,37,1378,1165,213,631605,Харківська область
22273,631606,1954,35,1262,1090,172,631606,Харківська область
22274,631607,1969,32,1236,1036,200,631607,Харківська область
22275,631608,2284,46,1421,1230,191,631608,Харківська область
22276,631609,1359,30,905,767,138,631609,Харківська область
22277,631610,1763,29,1161,1000,161,631610,Харківська область
22278,631611,1950,20,1250,1092,158,631611,Харківська область
22279,631612,1990,22,1273,1102,171,631612,Харківська область
22280,631613,1791,37,1085,933,152,631613,Харківська область
22281,631614,1774,27,1186,996,190,631614,Харківська область
22282,631615,2171,49,1500,1232,268,631615,Харківська область
22283,631616,2245,49,1570,1343,227,631616,Харківська область
22284,631617,1821,18,1216,1065,151,631617,Харківська область
22285,631618,681,10,440,406,34,631618,Харківська область
22286,631619,932,13,607,541,66,631619,Харківська область
22287,631620,1415,6,934,804,130,631620,Харківська область
22288,631621,1363,19,887,785,102,631621,Харківська область
22289,631622,2141,25,1289,1161,128,631622,Харківська область
22290,631623,2225,33,1345,1193,152,631623,Харківська область
22291,631624,2207,39,1345,1218,127,631624,Харківська область
22292,631625,1892,36,1190,1079,111,631625,Харківська область
22293,631626,1816,27,1157,1014,143,631626,Харківська область
22294,631627,1487,16,977,886,91,631627,Харківська область
22295,631628,2215,28,1371,1258,113,631628,Харківська область
22296,631629,2025,31,1342,1177,165,631629,Харківська область
22297,631630,2039,23,1299,1120,179,631630,Харківська область
22298,631631,1620,20,1023,932,91,631631,Харківська область
22299,631632,1966,24,1235,1087,148,631632,Харківська область
22300,631633,2093,39,1302,1157,145,631633,Харківська область
22301,631634,1721,19,1172,1019,153,631634,Харківська область
22302,631635,1969,39,1256,1090,166,631635,Харківська область
22303,631636,2001,42,1309,1171,138,631636,Харківська область
22304,631637,1868,20,1175,1023,152,631637,Харківська область
22305,631638,2127,32,1337,1170,167,631638,Харківська область
22306,631639,2257,35,1452,1272,180,631639,Харківська область
22307,631640,1968,19,1289,1139,150,631640,Харківська область
22308,631641,1892,33,1214,1038,176,631641,Харківська область
22309,631642,1881,29,1155,1032,123,631642,Харківська область
22310,631643,2164,29,1441,1258,183,631643,Харківська область
22311,631644,114,0,114,100,14,631644,Харківська область
22312,631645,108,2,95,85,10,631645,Харківська область
22313,631646,219,6,209,179,30,631646,Харківська область
22314,631647,121,3,117,102,15,631647,Харківська область
22315,631648,37,0,37,36,1,631648,Харківська область
22316,631694,989,6,601,523,78,631694,Харківська область
22317,631695,1700,22,1084,946,138,631695,Харківська область
22318,631699,327,8,230,186,44,631699,Харківська область
22319,631447,2191,35,1348,1195,153,631447,Харківська область
22320,631448,2287,34,1423,1226,197,631448,Харківська область
22321,631449,2031,30,1292,1156,136,631449,Харківська область
22322,631450,1964,31,1230,1084,146,631450,Харківська область
22323,631462,2185,32,1404,1246,158,631462,Харківська область
22324,631463,2245,35,1385,1220,165,631463,Харківська область
22325,631464,2481,28,1358,1214,144,631464,Харківська область
22326,631465,2291,38,1541,1315,226,631465,Харківська область
22327,631466,2338,34,1531,1348,183,631466,Харківська область
22328,631493,1844,17,1197,1050,147,631493,Харківська область
22329,631494,1809,36,1157,1030,127,631494,Харківська область
22330,631495,1807,24,1180,1049,131,631495,Харківська область
22331,631496,1986,21,1277,1159,118,631496,Харківська область
22332,631497,2174,35,1501,1304,197,631497,Харківська область
22333,631498,2068,26,1397,1224,173,631498,Харківська область
22334,631499,2116,27,1365,1202,163,631499,Харківська область
22335,631500,2008,30,1309,1154,155,631500,Харківська область
22336,631501,1880,35,1241,1100,141,631501,Харківська область
22337,631502,2108,34,1423,1269,154,631502,Харківська область
22338,631503,1691,21,1178,1026,152,631503,Харківська область
22339,631504,1665,32,1120,1002,118,631504,Харківська область
22340,631505,1915,30,1199,1034,165,631505,Харківська область
22341,631537,2309,25,1599,1384,215,631537,Харківська область
22342,631538,2062,26,1350,1202,148,631538,Харківська область
22343,631539,2444,32,1560,1391,169,631539,Харківська область
22344,631540,2239,38,1521,1346,175,631540,Харківська область
22345,631541,2212,42,1433,1302,131,631541,Харківська область
22346,631542,2066,31,1337,1187,150,631542,Харківська область
22347,631543,2460,42,1454,1270,184,631543,Харківська область
22348,631544,2264,28,1369,1204,165,631544,Харківська область
22349,631545,2083,44,1309,1185,124,631545,Харківська область
22350,631546,2062,27,1364,1224,140,631546,Харківська область
22351,631547,2253,48,1429,1294,135,631547,Харківська область
22352,631548,2061,30,1346,1212,134,631548,Харківська область
22353,631549,2018,37,1305,1148,157,631549,Харківська область
22354,631550,2113,27,1376,1252,124,631550,Харківська область
22355,631551,2217,28,1317,1204,113,631551,Харківська область
22356,631552,2208,32,1477,1275,202,631552,Харківська область
22357,631553,2102,27,1426,1278,148,631553,Харківська область
22358,631554,2260,33,1451,1271,180,631554,Харківська область
22359,631555,2245,27,1473,1335,138,631555,Харківська область
22360,631556,2202,26,1479,1355,124,631556,Харківська область
22361,631557,2269,32,1435,1306,129,631557,Харківська область
22362,631558,1817,19,1195,1076,119,631558,Харківська область
22363,631559,2344,24,1530,1344,186,631559,Харківська область
22364,631560,2078,34,1433,1265,168,631560,Харківська область
22365,631561,2253,27,1470,1303,167,631561,Харківська область
22366,631562,2076,28,1166,1082,84,631562,Харківська область
22367,631563,2138,32,1384,1230,154,631563,Харківська область
22368,631564,2386,26,1522,1393,129,631564,Харківська область
22369,631565,2276,39,1513,1354,159,631565,Харківська область
22370,631566,2257,16,1442,1321,121,631566,Харківська область
22371,631567,2192,40,1526,1384,142,631567,Харківська область
22372,631568,2104,30,1439,1300,139,631568,Харківська область
22373,631569,2016,36,1370,1225,145,631569,Харківська область
22374,631570,2242,20,1560,1404,156,631570,Харківська область
22375,631571,1959,31,1296,1170,126,631571,Харківська область
22376,631572,2208,20,1436,1268,168,631572,Харківська область
22377,631573,2221,26,1471,1345,126,631573,Харківська область
22378,631574,2238,26,1460,1318,142,631574,Харківська область
22379,631575,2032,16,1409,1286,123,631575,Харківська область
22380,631576,2187,30,1483,1331,152,631576,Харківська область
22381,631577,2446,21,1713,1514,199,631577,Харківська область
22382,631578,2055,28,1338,1186,152,631578,Харківська область
22383,631579,2189,31,1327,1176,151,631579,Харківська область
22384,631580,2175,38,1485,1306,179,631580,Харківська область
22385,631581,1952,27,1311,1180,131,631581,Харківська область
22386,631582,2102,34,1376,1236,140,631582,Харківська область
22387,631583,1958,29,1353,1196,157,631583,Харківська область
22388,631584,117,3,112,107,5,631584,Харківська область
22389,631585,48,1,44,39,5,631585,Харківська область
22390,631586,11,0,11,9,2,631586,Харківська область
22391,631587,94,0,19,19,0,631587,Харківська область
22392,631589,65,0,55,54,1,631589,Харківська область
22393,631590,723,12,706,669,37,631590,Харківська область
22394,631692,1672,27,1062,924,138,631692,Харківська область
22395,631693,776,9,471,438,33,631693,Харківська область
22396,631702,213,0,149,133,16,631702,Харківська область
22397,631703,126,1,95,79,16,631703,Харківська область
22398,631316,1784,42,1200,956,244,631316,Харківська область
22399,631317,1860,34,1251,1046,205,631317,Харківська область
22400,631318,2001,29,1335,1072,263,631318,Харківська область
22401,631319,1469,16,815,695,120,631319,Харківська область
22402,631320,2221,52,1407,1173,234,631320,Харківська область
22403,631321,1957,29,1307,1100,207,631321,Харківська область
22404,631322,2144,23,1407,1168,239,631322,Харківська область
22405,631323,2008,34,1367,1151,216,631323,Харківська область
22406,631324,2133,25,1337,1173,164,631324,Харківська область
22407,631325,2132,22,1260,1142,118,631325,Харківська область
22408,631326,2294,27,1559,1319,240,631326,Харківська область
22409,631327,2072,25,1416,1291,125,631327,Харківська область
22410,631328,1599,21,1103,959,144,631328,Харківська область
22411,631329,1397,16,935,844,91,631329,Харківська область
22412,631330,2271,29,1409,1205,204,631330,Харківська область
22413,631331,2061,34,1379,1210,169,631331,Харківська область
22414,631332,1819,30,1218,1066,152,631332,Харківська область
22415,631333,2193,44,1412,1202,210,631333,Харківська область
22416,631334,2146,22,1358,1211,147,631334,Харківська область
22417,631335,1924,14,1102,969,133,631335,Харківська область
22418,631336,2091,20,1291,1125,166,631336,Харківська область
22419,631337,2009,26,1257,1134,123,631337,Харківська область
22420,631338,1869,17,1207,1097,110,631338,Харківська область
22421,631339,2102,26,1374,1251,123,631339,Харківська область
22422,631340,2088,18,1340,1212,128,631340,Харківська область
22423,631341,1809,23,1127,1017,110,631341,Харківська область
22424,631342,2134,27,1473,1326,147,631342,Харківська область
22425,631343,2080,42,1402,1262,140,631343,Харківська область
22426,631345,2155,21,1386,1225,161,631345,Харківська область
22427,631346,2605,46,1592,1420,172,631346,Харківська область
22428,631348,1738,32,1121,1012,109,631348,Харківська область
22429,631349,1652,12,1083,959,124,631349,Харківська область
22430,631350,2057,32,1340,1165,175,631350,Харківська область
22431,631351,2391,27,1439,1301,138,631351,Харківська область
22432,631352,1894,38,1231,1075,156,631352,Харківська область
22433,631353,2113,37,1438,1265,173,631353,Харківська область
22434,631373,187,2,178,161,17,631373,Харківська область
22435,631374,162,3,139,124,15,631374,Харківська область
22436,631375,261,6,255,242,13,631375,Харківська область
22437,631649,1347,26,780,638,142,631649,Харківська область
22438,631650,1218,15,714,587,127,631650,Харківська область
22439,631651,2105,25,1272,1107,165,631651,Харківська область
22440,631652,2338,54,1612,1252,360,631652,Харківська область
22441,631653,2139,49,1337,1087,250,631653,Харківська область
22442,631654,2234,36,1399,1180,219,631654,Харківська область
22443,631655,1403,33,904,727,177,631655,Харківська область
22444,631656,1115,16,676,543,133,631656,Харківська область
22445,631657,2210,26,1370,1162,208,631657,Харківська область
22446,631658,2210,26,1336,1177,159,631658,Харківська область
22447,631659,1720,19,984,823,161,631659,Харківська область
22448,631660,1370,19,771,685,86,631660,Харківська область
22449,631661,2306,35,1578,1278,300,631661,Харківська область
22450,631662,1907,42,1263,1025,238,631662,Харківська область
22451,631663,1762,39,1143,933,210,631663,Харківська область
22452,631664,2035,30,1332,1107,225,631664,Харківська область
22453,631665,611,3,364,331,33,631665,Харківська область
22454,631666,1190,17,705,609,96,631666,Харківська область
22455,631667,514,3,341,308,33,631667,Харківська область
22456,631668,1978,31,1169,1025,144,631668,Харківська область
22457,631669,1969,28,1309,1151,158,631669,Харківська область
22458,631670,2064,37,1361,1197,164,631670,Харківська область
22459,631671,1997,24,1364,1188,176,631671,Харківська область
22460,631672,2002,31,1359,1183,176,631672,Харківська область
22461,631673,2270,28,1419,1292,127,631673,Харківська область
22462,631674,2089,34,1316,1198,118,631674,Харківська область
22463,631675,2176,21,1312,1169,143,631675,Харківська область
22464,631676,2281,44,1461,1335,126,631676,Харківська область
22465,631677,2258,40,1419,1298,121,631677,Харківська область
22466,631678,2324,27,1463,1352,111,631678,Харківська область
22467,631679,2070,32,1360,1233,127,631679,Харківська область
22468,631680,2164,22,1350,1215,135,631680,Харківська область
22469,631681,2182,29,1354,1251,103,631681,Харківська область
22470,631682,2354,22,1566,1414,152,631682,Харківська область
22471,631683,1825,23,1116,1027,89,631683,Харківська область
22472,631684,1709,19,1077,979,98,631684,Харківська область
22473,631685,1710,13,1057,975,82,631685,Харківська область
22474,631687,52,0,52,48,4,631687,Харківська область
22475,631688,624,18,606,560,46,631688,Харківська область
22476,631689,143,7,131,118,13,631689,Харківська область
22477,1,1936,114,1814,1766,48,1,Харківська область
22478,631177,1142,19,685,584,101,631177,Харківська область
22479,631178,1723,20,1067,914,153,631178,Харківська область
22480,631179,1344,11,680,617,63,631179,Харківська область
22481,631180,2385,16,1418,1214,204,631180,Харківська область
22482,631181,1867,25,1138,985,153,631181,Харківська область
22483,631182,1995,21,1143,981,162,631182,Харківська область
22484,631183,1896,26,1291,1084,207,631183,Харківська область
22485,631184,1844,26,1285,1134,151,631184,Харківська область
22486,631185,2129,29,1493,1276,217,631185,Харківська область
22487,631186,1900,1,1249,1091,158,631186,Харківська область
22488,631187,1622,24,1052,932,120,631187,Харківська область
22489,631188,1347,21,923,809,114,631188,Харківська область
22490,631189,1180,16,750,670,80,631189,Харківська область
22491,631190,2370,35,1568,1359,209,631190,Харківська область
22492,631191,1216,21,764,683,81,631191,Харківська область
22493,631192,2189,30,1287,1124,163,631192,Харківська область
22494,631193,2086,20,1265,1093,172,631193,Харківська область
22495,631194,1896,30,1100,988,112,631194,Харківська область
22496,631195,1290,21,873,773,100,631195,Харківська область
22497,631196,2181,18,1344,1187,157,631196,Харківська область
22498,631197,2194,27,1559,1358,201,631197,Харківська область
22499,631198,2305,35,1508,1289,219,631198,Харківська область
22500,631199,2388,28,1488,1262,226,631199,Харківська область
22501,631200,1298,17,718,614,104,631200,Харківська область
22502,631201,1523,20,1009,865,144,631201,Харківська область
22503,631202,1317,16,877,743,134,631202,Харківська область
22504,631203,1689,27,1147,995,152,631203,Харківська область
22505,631204,1660,26,1190,1000,190,631204,Харківська область
22506,631205,1671,28,1181,1006,175,631205,Харківська область
22507,631206,1537,25,1064,882,182,631206,Харківська область
22508,631207,1534,28,1007,863,144,631207,Харківська область
22509,631208,1350,24,924,766,158,631208,Харківська область
22510,631209,1119,12,740,674,66,631209,Харківська область
22511,631210,2296,30,1538,1327,211,631210,Харківська область
22512,631211,2250,29,1448,1296,152,631211,Харківська область
22513,631212,1545,14,1059,937,122,631212,Харківська область
22514,631213,1216,20,790,699,91,631213,Харківська область
22515,631214,1176,12,788,683,105,631214,Харківська область
22516,631215,2093,35,1388,1229,159,631215,Харківська область
22517,631216,1986,27,1302,1183,119,631216,Харківська область
22518,631217,1668,29,1103,966,137,631217,Харківська область
22519,631218,1995,39,1300,1185,115,631218,Харківська область
22520,631219,2054,34,1371,1236,135,631219,Харківська область
22521,631220,2012,22,1276,1133,143,631220,Харківська область
22522,631221,2205,40,1388,1247,141,631221,Харківська область
22523,631222,933,6,639,550,89,631222,Харківська область
22524,631223,85,2,83,73,10,631223,Харківська область
22525,631224,88,0,84,79,5,631224,Харківська область
22526,631225,48,1,45,39,6,631225,Харківська область
22527,631226,209,2,207,181,26,631226,Харківська область
22528,631227,69,2,66,59,7,631227,Харківська область
22529,631228,72,2,70,67,3,631228,Харківська область
22530,631229,38,1,36,33,3,631229,Харківська область
22531,631230,466,19,447,429,18,631230,Харківська область
22532,631376,2066,33,1387,1179,208,631376,Харківська область
22533,631377,2156,38,1299,1133,166,631377,Харківська область
22534,631378,1532,10,960,848,112,631378,Харківська область
22535,631379,2401,32,1336,1176,160,631379,Харківська область
22536,631380,2317,41,1481,1287,194,631380,Харківська область
22537,631381,1444,21,832,743,89,631381,Харківська область
22538,631382,1648,25,1024,880,144,631382,Харківська область
22539,631383,1242,15,826,712,114,631383,Харківська область
22540,631384,2073,33,1343,1088,255,631384,Харківська область
22541,631385,2392,39,1522,1248,274,631385,Харківська область
22542,631386,2137,40,1384,1172,212,631386,Харківська область
22543,631387,2101,32,1411,1133,278,631387,Харківська область
22544,631388,2104,42,1442,1225,217,631388,Харківська область
22545,631389,2162,33,1428,1238,190,631389,Харківська область
22546,631390,2361,32,1542,1288,254,631390,Харківська область
22547,631391,1913,37,1336,1127,209,631391,Харківська область
22548,631392,2183,41,1498,1295,203,631392,Харківська область
22549,631393,1706,22,1146,1004,142,631393,Харківська область
22550,631394,2412,37,1614,1358,256,631394,Харківська область
22551,631395,1887,29,1226,1075,151,631395,Харківська область
22552,631396,1950,20,1136,1028,108,631396,Харківська область
22553,631397,1308,17,899,792,107,631397,Харківська область
22554,631398,1569,16,927,833,94,631398,Харківська область
22555,631399,2043,31,1316,1204,112,631399,Харківська область
22556,631400,1411,17,882,773,109,631400,Харківська область
22557,631401,1345,22,772,648,124,631401,Харківська область
22558,631402,1955,28,1326,1143,183,631402,Харківська область
22559,631403,2194,36,1410,1254,156,631403,Харківська область
22560,631404,2060,34,1356,1233,123,631404,Харківська область
22561,631405,1994,20,1326,1200,126,631405,Харківська область
22562,631406,2104,24,1362,1228,134,631406,Харківська область
22563,631407,2169,39,1443,1276,167,631407,Харківська область
22564,631408,2081,32,1359,1188,171,631408,Харківська область
22565,631409,1953,38,1325,1166,159,631409,Харківська область
22566,631410,296,14,263,229,34,631410,Харківська область
22567,631411,122,2,120,107,13,631411,Харківська область
22568,631412,45,1,42,39,3,631412,Харківська область
22569,631413,87,0,87,73,14,631413,Харківська область
22570,631414,13,0,13,12,1,631414,Харківська область
22571,631700,1469,19,863,761,102,631700,Харківська область
22572,630315,832,12,586,514,72,630315,Харківська область
22573,630316,2186,22,1432,1248,184,630316,Харківська область
22574,630317,1620,24,1120,955,165,630317,Харківська область
22575,630318,2051,25,1390,1198,192,630318,Харківська область
22576,630319,1770,23,1268,1114,154,630319,Харківська область
22577,630320,1781,11,1187,1041,146,630320,Харківська область
22578,630321,1731,28,1096,959,137,630321,Харківська область
22579,630322,1395,26,885,822,63,630322,Харківська область
22580,630323,1318,13,835,745,90,630323,Харківська область
22581,630324,1714,28,1020,903,117,630324,Харківська область
22582,630325,2135,17,1283,1171,112,630325,Харківська область
22583,630326,1545,19,925,836,89,630326,Харківська область
22584,630327,1975,20,1182,1075,107,630327,Харківська область
22585,630328,2039,21,1120,1071,49,630328,Харківська область
22586,630329,1303,12,719,667,52,630329,Харківська область
22587,630330,1577,12,1000,954,46,630330,Харківська область
22588,630331,431,2,215,206,9,630331,Харківська область
22589,630332,1752,21,1133,973,160,630332,Харківська область
22590,630333,2295,23,1572,1363,209,630333,Харківська область
22591,630334,2097,19,1348,1229,119,630334,Харківська область
22592,630335,1901,25,1138,1061,77,630335,Харківська область
22593,630336,1955,24,1250,1150,100,630336,Харківська область
22594,630337,1830,13,1130,1049,81,630337,Харківська область
22595,630338,994,8,636,579,57,630338,Харківська область
22596,630339,1612,12,1082,992,90,630339,Харківська область
22597,630340,760,4,499,447,52,630340,Харківська область
22598,630341,1814,19,1109,1040,69,630341,Харківська область
22599,630342,1592,14,1010,934,76,630342,Харківська область
22600,630343,1823,10,1118,1029,89,630343,Харківська область
22601,630344,354,0,224,205,19,630344,Харківська область
22602,630345,2006,23,1277,1142,135,630345,Харківська область
22603,630346,189,1,119,101,18,630346,Харківська область
22604,630347,2148,16,1383,1224,159,630347,Харківська область
22605,630348,2197,24,1413,1268,145,630348,Харківська область
22606,630349,2110,22,1395,1226,169,630349,Харківська область
22607,630350,1873,13,1229,1085,144,630350,Харківська область
22608,630351,1402,18,825,766,59,630351,Харківська область
22609,630352,1480,16,949,867,82,630352,Харківська область
22610,630353,2118,17,1356,1254,102,630353,Харківська область
22611,630354,305,2,209,186,23,630354,Харківська область
22612,630355,306,0,204,187,17,630355,Харківська область
22613,630356,906,11,582,532,50,630356,Харківська область
22614,630357,339,2,222,197,25,630357,Харківська область
22615,630358,720,6,449,396,53,630358,Харківська область
22616,630359,646,3,436,372,64,630359,Харківська область
22617,630360,345,1,232,199,33,630360,Харківська область
22618,630361,2022,19,1253,1194,59,630361,Харківська область
22619,630362,2028,13,1301,1245,56,630362,Харківська область
22620,630363,916,7,549,475,74,630363,Харківська область
22621,630364,605,6,411,367,44,630364,Харківська область
22622,630365,1521,24,1002,874,128,630365,Харківська область
22623,630366,1824,17,1229,1059,170,630366,Харківська область
22624,630367,775,12,515,465,50,630367,Харківська область
22625,630368,102,0,8,7,1,630368,Харківська область
22626,630369,39,0,39,36,3,630369,Харківська область
22627,630810,1148,12,744,635,109,630810,Харківська область
22628,630811,1394,19,966,886,80,630811,Харківська область
22629,630812,1143,10,701,631,70,630812,Харківська область
22630,630813,758,6,481,448,33,630813,Харківська область
22631,630817,505,5,301,271,30,630817,Харківська область
22632,630818,1163,11,761,686,75,630818,Харківська область
22633,630819,1153,13,782,694,88,630819,Харківська область
22634,630829,1197,6,735,693,42,630829,Харківська область
22635,630830,475,3,296,267,29,630830,Харківська область
22636,630831,542,5,303,271,32,630831,Харківська область
22637,630833,1526,37,1001,907,94,630833,Харківська область
22638,630834,1988,30,1173,1095,78,630834,Харківська область
22639,630835,855,9,559,477,82,630835,Харківська область
22640,630836,459,3,266,254,12,630836,Харківська область
22641,630840,1161,9,671,601,70,630840,Харківська область
22642,630841,1603,4,975,895,80,630841,Харківська область
22643,630842,1001,16,644,583,61,630842,Харківська область
22644,630843,1643,19,1056,940,116,630843,Харківська область
22645,630844,1233,15,798,716,82,630844,Харківська область
22646,630848,1053,7,654,585,69,630848,Харківська область
22647,630849,1114,15,722,631,91,630849,Харківська область
22648,630850,1510,16,948,839,109,630850,Харківська область
22649,630851,2060,25,1288,1127,161,630851,Харківська область
22650,630852,2043,23,1295,1113,182,630852,Харківська область
22651,630853,2291,21,1484,1277,207,630853,Харківська область
22652,630854,576,2,355,319,36,630854,Харківська область
22653,630855,536,10,359,306,53,630855,Харківська область
22654,630856,2154,36,1470,1265,205,630856,Харківська область
22655,630857,2145,37,1469,1310,159,630857,Харківська область
22656,630858,1676,23,1191,1032,159,630858,Харківська область
22657,630859,1477,31,971,857,114,630859,Харківська область
22658,630874,1040,5,645,592,53,630874,Харківська область
22659,630875,70,1,49,46,3,630875,Харківська область
22660,630876,1109,16,674,618,56,630876,Харківська область
22661,630877,493,1,276,252,24,630877,Харківська область
22662,630878,963,3,579,550,29,630878,Харківська область
22663,630879,955,14,667,632,35,630879,Харківська область
22664,630881,455,29,419,345,74,630881,Харківська область
22665,631038,1130,9,661,600,61,631038,Харківська область
22666,631039,1815,25,1103,994,109,631039,Харківська область
22667,631040,865,16,476,444,32,631040,Харківська область
22668,631041,1516,18,987,892,95,631041,Харківська область
22669,631042,841,15,546,491,55,631042,Харківська область
22670,631043,1449,15,959,851,108,631043,Харківська область
22671,631044,1260,18,758,690,68,631044,Харківська область
22672,631045,917,13,561,516,45,631045,Харківська область
22673,631046,1333,21,817,708,109,631046,Харківська область
22674,631047,1435,12,864,804,60,631047,Харківська область
22675,631048,773,12,475,441,34,631048,Харківська область
22676,631049,1270,5,719,669,50,631049,Харківська область
22677,631050,1254,20,779,702,77,631050,Харківська область
22678,631051,1077,17,665,582,83,631051,Харківська область
22679,631052,1158,15,760,691,69,631052,Харківська область
22680,631053,907,11,549,497,52,631053,Харківська область
22681,631054,937,6,561,502,59,631054,Харківська область
22682,631055,740,10,445,412,33,631055,Харківська область
22683,1,19,0,18,8,10,1,Харківська область
22684,630215,673,9,424,392,32,630215,Харківська область
22685,630216,1389,8,911,832,79,630216,Харківська область
22686,630217,1387,11,906,828,78,630217,Харківська область
22687,630218,734,4,399,375,24,630218,Харківська область
22688,630219,581,4,348,322,26,630219,Харківська область
22689,630220,120,2,68,60,8,630220,Харківська область
22690,630221,988,8,581,515,66,630221,Харківська область
22691,630222,971,5,595,579,16,630222,Харківська область
22692,630223,729,6,408,378,30,630223,Харківська область
22693,630224,834,6,456,421,35,630224,Харківська область
22694,630225,146,1,100,99,1,630225,Харківська область
22695,630226,997,12,482,461,21,630226,Харківська область
22696,630227,138,3,98,88,10,630227,Харківська область
22697,630228,431,2,246,229,17,630228,Харківська область
22698,630229,368,1,223,204,19,630229,Харківська область
22699,630230,472,0,298,280,18,630230,Харківська область
22700,630231,519,4,321,292,29,630231,Харківська область
22701,630232,221,3,129,120,9,630232,Харківська область
22702,630233,150,0,104,90,14,630233,Харківська область
22703,630234,364,2,166,160,6,630234,Харківська область
22704,630235,411,2,227,219,8,630235,Харківська область
22705,630236,971,7,495,455,40,630236,Харківська область
22706,630237,410,2,197,187,10,630237,Харківська область
22707,630238,572,2,312,287,25,630238,Харківська область
22708,630239,402,1,259,238,21,630239,Харківська область
22709,630240,925,2,567,504,63,630240,Харківська область
22710,630241,380,9,256,243,13,630241,Харківська область
22711,630242,1057,4,690,661,29,630242,Харківська область
22712,630243,2159,13,1418,1307,111,630243,Харківська область
22713,630244,2200,30,1332,1227,105,630244,Харківська область
22714,630245,2024,27,1267,1192,75,630245,Харківська область
22715,630246,2299,17,1274,1206,68,630246,Харківська область
22716,630247,1634,9,945,891,54,630247,Харківська область
22717,630248,1628,23,974,916,58,630248,Харківська область
22718,630249,1571,11,985,932,53,630249,Харківська область
22719,630250,1845,21,1103,975,128,630250,Харківська область
22720,630251,1476,14,799,754,45,630251,Харківська область
22721,630252,1373,10,696,654,42,630252,Харківська область
22722,630253,1392,13,924,804,120,630253,Харківська область
22723,630254,1750,22,1060,956,104,630254,Харківська область
22724,630255,1161,14,594,554,40,630255,Харківська область
22725,630256,585,3,328,307,21,630256,Харківська область
22726,630257,1231,8,764,725,39,630257,Харківська область
22727,630258,457,3,271,262,9,630258,Харківська область
22728,630259,482,0,277,256,21,630259,Харківська область
22729,630260,267,2,165,156,9,630260,Харківська область
22730,630261,204,3,129,120,9,630261,Харківська область
22731,630262,309,2,200,161,39,630262,Харківська область
22732,630263,616,4,360,322,38,630263,Харківська область
22733,630264,326,5,227,213,14,630264,Харківська область
22734,630265,263,0,193,176,17,630265,Харківська область
22735,630266,222,0,185,177,8,630266,Харківська область
22736,630267,314,3,252,244,8,630267,Харківська область
22737,630268,173,2,82,70,12,630268,Харківська область
22738,630269,413,3,238,221,17,630269,Харківська область
22739,630270,132,0,86,72,14,630270,Харківська область
22740,630271,703,0,385,363,22,630271,Харківська область
22741,630272,187,0,117,111,6,630272,Харківська область
22742,630273,321,4,193,166,27,630273,Харківська область
22743,630274,280,3,220,202,18,630274,Харківська область
22744,630275,282,2,178,162,16,630275,Харківська область
22745,630276,247,4,158,122,36,630276,Харківська область
22746,630277,651,9,423,377,46,630277,Харківська область
22747,630278,196,0,134,120,14,630278,Харківська область
22748,630279,265,3,180,158,22,630279,Харківська область
22749,630280,621,4,400,350,50,630280,Харківська область
22750,630281,345,2,225,218,7,630281,Харківська область
22751,630282,893,11,523,488,35,630282,Харківська область
22752,630283,515,2,295,278,17,630283,Харківська область
22753,630284,518,9,356,321,35,630284,Харківська область
22754,630286,299,0,185,160,25,630286,Харківська область
22755,630287,413,4,283,249,34,630287,Харківська область
22756,630288,495,3,328,290,38,630288,Харківська область
22757,630289,654,3,409,376,33,630289,Харківська область
22758,630290,2221,22,1435,1329,106,630290,Харківська область
22759,630291,1048,9,668,639,29,630291,Харківська область
22760,630292,220,0,143,125,18,630292,Харківська область
22761,630293,930,10,569,543,26,630293,Харківська область
22762,630294,129,0,77,74,3,630294,Харківська область
22763,630295,273,2,165,159,6,630295,Харківська область
22764,630296,634,1,426,407,19,630296,Харківська область
22765,630297,733,4,473,440,33,630297,Харківська область
22766,630298,130,1,79,68,11,630298,Харківська область
22767,630299,784,7,495,465,30,630299,Харківська область
22768,630300,110,0,81,71,10,630300,Харківська область
22769,630301,57,0,40,38,2,630301,Харківська область
22770,630302,506,3,330,310,20,630302,Харківська область
22771,630303,381,3,242,233,9,630303,Харківська область
22772,630304,342,6,230,194,36,630304,Харківська область
22773,630305,504,3,321,297,24,630305,Харківська область
22774,630306,205,4,140,105,35,630306,Харківська область
22775,630307,216,2,135,127,8,630307,Харківська область
22776,630308,116,0,74,66,8,630308,Харківська область
22777,630309,498,0,297,261,36,630309,Харківська область
22778,630310,902,4,668,620,48,630310,Харківська область
22779,630311,422,0,273,255,18,630311,Харківська область
22780,630312,1019,5,594,562,32,630312,Харківська область
22781,630313,1081,8,633,588,45,630313,Харківська область
22782,630314,402,6,322,305,17,630314,Харківська область
22783,630734,1560,10,948,853,95,630734,Харківська область
22784,630735,1732,21,1005,920,85,630735,Харківська область
22785,630736,898,9,529,477,52,630736,Харківська область
22786,630738,126,1,94,80,14,630738,Харківська область
22787,630739,212,0,160,142,18,630739,Харківська область
22788,630740,249,0,150,135,15,630740,Харківська область
22789,630741,820,14,510,477,33,630741,Харківська область
22790,630742,177,1,101,88,13,630742,Харківська область
22791,630743,1508,12,854,791,63,630743,Харківська область
22792,630744,560,9,334,263,71,630744,Харківська область
22793,630884,1802,10,1136,1079,57,630884,Харківська область
22794,630885,1202,6,755,728,27,630885,Харківська область
22795,630886,1275,8,802,768,34,630886,Харківська область
22796,630887,509,3,296,279,17,630887,Харківська область
22797,630888,2085,23,1343,1273,70,630888,Харківська область
22798,630889,2031,25,1205,1151,54,630889,Харківська область
22799,630890,1407,19,930,860,70,630890,Харківська область
22800,630891,1026,23,683,629,54,630891,Харківська область
22801,630892,1562,26,906,834,72,630892,Харківська область
22802,630893,1819,25,1132,1052,80,630893,Харківська область
22803,630894,1966,18,1119,1036,83,630894,Харківська область
22804,630895,2016,23,1342,1271,71,630895,Харківська область
22805,630896,1982,21,1380,1314,66,630896,Харківська область
22806,630897,1775,15,1141,1096,45,630897,Харківська область
22807,630898,1740,14,1089,1029,60,630898,Харківська область
22808,630899,345,6,212,200,12,630899,Харківська область
22809,630900,480,3,291,257,34,630900,Харківська область
22810,630901,468,7,255,221,34,630901,Харківська область
22811,630902,969,22,598,530,68,630902,Харківська область
22812,630903,547,5,363,344,19,630903,Харківська область
22813,630904,239,4,162,149,13,630904,Харківська область
22814,630905,561,2,364,267,97,630905,Харківська область
22815,630906,876,8,625,589,36,630906,Харківська область
22816,630907,1580,19,1025,986,39,630907,Харківська область
22817,630908,2173,21,1373,1308,65,630908,Харківська область
22818,630909,303,3,197,188,9,630909,Харківська область
22819,630910,1258,16,844,739,105,630910,Харківська область
22820,630911,726,11,394,337,57,630911,Харківська область
22821,630912,571,3,373,314,59,630912,Харківська область
22822,630913,761,13,467,451,16,630913,Харківська область
22823,630914,262,1,142,124,18,630914,Харківська область
22824,631072,1648,21,1044,987,57,631072,Харківська область
22825,631073,1709,25,1152,1040,112,631073,Харківська область
22826,631074,2130,25,1386,1267,119,631074,Харківська область
22827,631075,1316,19,851,799,52,631075,Харківська область
22828,631076,1808,24,1234,1142,92,631076,Харківська область
22829,631077,1495,25,977,890,87,631077,Харківська область
22830,631078,1958,26,1405,1276,129,631078,Харківська область
22831,631079,1481,24,976,896,80,631079,Харківська область
22832,631080,1704,8,1104,1009,95,631080,Харківська область
22833,631081,1890,21,1339,1233,106,631081,Харківська область
22834,631082,2292,15,1517,1404,113,631082,Харківська область
22835,631083,1927,25,1190,1106,84,631083,Харківська область
22836,631084,1190,8,706,651,55,631084,Харківська область
22837,631085,1597,25,973,904,69,631085,Харківська область
22838,631086,1918,27,1186,915,271,631086,Харківська область
22839,631087,2190,25,1468,1322,146,631087,Харківська область
22840,631088,45,0,45,30,15,631088,Харківська область
22841,630166,1652,11,981,865,116,630166,Харківська область
22842,630167,392,7,273,225,48,630167,Харківська область
22843,630168,1809,14,1140,998,142,630168,Харківська область
22844,630169,1106,6,652,590,62,630169,Харківська область
22845,630170,290,3,182,160,22,630170,Харківська область
22846,630171,420,1,237,206,31,630171,Харківська область
22847,630172,946,9,554,495,59,630172,Харківська область
22848,630173,351,2,215,194,21,630173,Харківська область
22849,630174,269,5,168,149,19,630174,Харківська область
22850,630175,261,1,164,148,16,630175,Харківська область
22851,630176,314,1,217,185,32,630176,Харківська область
22852,630177,285,3,181,160,21,630177,Харківська область
22853,630178,306,1,171,158,13,630178,Харківська область
22854,630179,438,0,244,230,14,630179,Харківська область
22855,630180,848,8,395,365,30,630180,Харківська область
22856,630181,498,5,304,264,40,630181,Харківська область
22857,630182,127,0,85,61,24,630182,Харківська область
22858,630183,1043,3,608,552,56,630183,Харківська область
22859,630184,769,2,491,434,57,630184,Харківська область
22860,630185,892,27,554,505,49,630185,Харківська область
22861,630186,103,1,66,60,6,630186,Харківська область
22862,630187,508,9,308,259,49,630187,Харківська область
22863,630473,187,3,125,110,15,630473,Харківська область
22864,630474,270,0,165,149,16,630474,Харківська область
22865,630475,281,2,200,190,10,630475,Харківська область
22866,630476,591,2,427,363,64,630476,Харківська область
22867,630477,177,0,130,122,8,630477,Харківська область
22868,630478,1039,14,739,430,309,630478,Харківська область
22869,630479,497,4,314,289,25,630479,Харківська область
22870,630480,502,6,335,309,26,630480,Харківська область
22871,630481,375,3,206,186,20,630481,Харківська область
22872,630482,297,2,204,183,21,630482,Харківська область
22873,630483,553,6,289,275,14,630483,Харківська область
22874,630484,948,5,584,539,45,630484,Харківська область
22875,630485,1335,16,865,801,64,630485,Харківська область
22876,630486,469,8,295,261,34,630486,Харківська область
22877,630487,484,2,297,270,27,630487,Харківська область
22878,630488,598,6,332,311,21,630488,Харківська область
22879,630489,587,3,356,311,45,630489,Харківська область
22880,630490,186,0,91,84,7,630490,Харківська область
22881,630491,395,1,209,187,22,630491,Харківська область
22882,630492,454,4,271,236,35,630492,Харківська область
22883,630493,935,12,559,506,53,630493,Харківська область
22884,630494,201,2,112,90,22,630494,Харківська область
22885,630495,1704,18,1014,886,128,630495,Харківська область
22886,630496,522,6,297,277,20,630496,Харківська область
22887,630497,318,10,280,202,78,630497,Харківська область
22888,630602,469,1,283,268,15,630602,Харківська область
22889,630603,164,1,99,84,15,630603,Харківська область
22890,630604,577,2,331,309,22,630604,Харківська область
22891,630605,505,3,326,297,29,630605,Харківська область
22892,630606,874,7,550,510,40,630606,Харківська область
22893,630607,441,0,251,228,23,630607,Харківська область
22894,630608,331,2,190,171,19,630608,Харківська область
22895,630609,354,1,240,235,5,630609,Харківська область
22896,630610,887,11,564,527,37,630610,Харківська область
22897,630611,260,0,165,145,20,630611,Харківська область
22898,630612,746,2,441,417,24,630612,Харківська область
22899,630613,124,0,69,52,17,630613,Харківська область
22900,630615,479,3,257,227,30,630615,Харківська область
22901,630616,64,0,28,21,7,630616,Харківська область
22902,630617,322,5,157,136,21,630617,Харківська область
22903,630618,130,1,67,56,11,630618,Харківська область
22904,630619,193,0,113,100,13,630619,Харківська область
22905,630620,780,3,462,402,60,630620,Харківська область
22906,630621,790,5,433,396,37,630621,Харківська область
22907,630622,308,3,205,181,24,630622,Харківська область
22908,630623,721,3,452,424,28,630623,Харківська область
22909,630624,1641,12,904,855,49,630624,Харківська область
22910,630625,1450,8,990,916,74,630625,Харківська область
22911,630626,1712,12,1018,939,79,630626,Харківська область
22912,630627,97,2,53,46,7,630627,Харківська область
22913,630628,824,10,488,465,23,630628,Харківська область
22914,630629,305,1,214,198,16,630629,Харківська область
22915,630630,117,0,81,71,10,630630,Харківська область
22916,630631,666,4,349,331,18,630631,Харківська область
22917,630632,342,4,184,174,10,630632,Харківська область
22918,630633,122,2,88,73,15,630633,Харківська область
22919,630634,134,0,76,68,8,630634,Харківська область
22920,630635,1084,11,730,695,35,630635,Харківська область
22921,630636,604,3,388,371,17,630636,Харківська область
22922,630637,268,2,165,157,8,630637,Харківська область
22923,630638,447,4,326,308,18,630638,Харківська область
22924,630915,1471,17,875,767,108,630915,Харківська область
22925,630916,1472,21,942,833,109,630916,Харківська область
22926,630917,1833,24,1131,1021,110,630917,Харківська область
22927,630918,888,6,494,448,46,630918,Харківська область
22928,630919,168,1,96,81,15,630919,Харківська область
22929,630920,209,1,124,113,11,630920,Харківська область
22930,630921,325,2,201,179,22,630921,Харківська область
22931,630922,526,4,314,285,29,630922,Харківська область
22932,630923,129,1,88,84,4,630923,Харківська область
22933,630924,387,1,175,159,16,630924,Харківська область
22934,630925,595,2,251,235,16,630925,Харківська область
22935,630926,201,0,106,94,12,630926,Харківська область
22936,630927,258,0,132,112,20,630927,Харківська область
22937,630928,622,6,394,347,47,630928,Харківська область
22938,630929,490,3,271,253,18,630929,Харківська область
22939,630930,523,6,316,301,15,630930,Харківська область
22940,630931,499,4,233,213,20,630931,Харківська область
22941,630932,742,10,392,361,31,630932,Харківська область
22942,630933,258,4,113,97,16,630933,Харківська область
22943,630934,545,0,304,289,15,630934,Харківська область
22944,630935,525,5,303,285,18,630935,Харківська область
22945,630936,469,4,279,251,28,630936,Харківська область
22946,630937,473,3,225,213,12,630937,Харківська область
22947,630938,493,5,261,230,31,630938,Харківська область
22948,630939,369,7,195,166,29,630939,Харківська область
22949,630940,929,5,546,498,48,630940,Харківська область
22950,630941,1812,20,1058,982,76,630941,Харківська область
22951,630942,1458,22,903,816,87,630942,Харківська область
22952,630943,2017,29,1187,1089,98,630943,Харківська область
22953,630944,1707,19,1030,913,117,630944,Харківська область
22954,630945,1815,23,1093,979,114,630945,Харківська область
22955,630946,1573,16,881,795,86,630946,Харківська область
22956,630947,1635,17,965,851,114,630947,Харківська область
22957,630948,1609,22,991,876,115,630948,Харківська область
22958,630949,1826,16,1083,960,123,630949,Харківська область
22959,630950,1698,14,1066,974,92,630950,Харківська область
22960,630951,1310,11,810,750,60,630951,Харківська область
22961,630952,2108,16,1299,1203,96,630952,Харківська область
22962,630953,2109,27,1288,1190,98,630953,Харківська область
22963,630954,1850,14,1140,1072,68,630954,Харківська область
22964,630955,1659,19,993,911,82,630955,Харківська область
22965,630956,1870,16,1067,995,72,630956,Харківська область
22966,630957,1240,21,684,608,76,630957,Харківська область
22967,630958,1639,22,995,930,65,630958,Харківська область
22968,630959,1998,22,1192,1105,87,630959,Харківська область
22969,630960,1893,23,1138,1056,82,630960,Харківська область
22970,630961,1935,15,1200,1088,112,630961,Харківська область
22971,630962,1947,15,997,920,77,630962,Харківська область
22972,630963,57,1,52,49,3,630963,Харківська область
22973,630964,29,1,22,21,1,630964,Харківська область
22974,630965,1988,20,1243,1115,128,630965,Харківська область
22975,630966,2086,29,1295,1180,115,630966,Харківська область
22976,630967,1432,17,920,838,82,630967,Харківська область
22977,630968,1677,16,1055,952,103,630968,Харківська область
22978,630970,2214,23,1293,1195,98,630970,Харківська область
22979,630971,1431,12,896,842,54,630971,Харківська область
22980,630972,2034,24,1282,1162,120,630972,Харківська область
22981,630973,2180,13,1409,1284,125,630973,Харківська область
22982,630974,944,6,609,570,39,630974,Харківська область
22983,630975,1938,34,1130,1029,101,630975,Харківська область
22984,630976,2009,26,1256,1176,80,630976,Харківська область
22985,630977,1710,20,1015,921,94,630977,Харківська область
22986,630978,1061,4,734,700,34,630978,Харківська область
22987,630979,1020,5,674,628,46,630979,Харківська область
22988,630980,1779,17,1117,1072,45,630980,Харківська область
22989,630982,1057,16,674,639,35,630982,Харківська область
22990,630983,1094,10,665,630,35,630983,Харківська область
22991,630984,1203,12,797,754,43,630984,Харківська область
22992,630985,1032,6,659,625,34,630985,Харківська область
22993,630986,1425,9,800,762,38,630986,Харківська область
22994,630987,1609,18,908,842,66,630987,Харківська область
22995,630988,1538,7,701,672,29,630988,Харківська область
22996,630989,1902,11,1025,973,52,630989,Харківська область
22997,630990,1439,14,824,765,59,630990,Харківська область
22998,630991,1317,14,708,663,45,630991,Харківська область
22999,630992,1506,17,842,786,56,630992,Харківська область
23000,630993,1604,23,926,863,63,630993,Харківська область
23001,630994,1640,17,972,926,46,630994,Харківська область
23002,630995,52,0,46,44,2,630995,Харківська область
23003,630998,15,0,14,14,0,630998,Харківська область
23004,630001,1099,9,730,664,66,630001,Харківська область
23005,630002,1715,22,1098,1023,75,630002,Харківська область
23006,630003,1728,14,1149,1060,89,630003,Харківська область
23007,630004,2217,24,1401,1322,79,630004,Харківська область
23008,630005,1988,38,1364,1263,101,630005,Харківська область
23009,630006,2232,26,1410,1306,104,630006,Харківська область
23010,630007,2404,24,1539,1458,81,630007,Харківська область
23011,630008,2099,26,1271,1199,72,630008,Харківська область
23012,630009,1305,15,761,707,54,630009,Харківська область
23013,630010,2172,17,1382,1301,81,630010,Харківська область
23014,630011,304,6,217,204,13,630011,Харківська область
23015,630012,1490,7,954,900,54,630012,Харківська область
23016,630013,1773,16,1087,1042,45,630013,Харківська область
23017,630014,824,10,532,501,31,630014,Харківська область
23018,630015,2208,21,1279,1199,80,630015,Харківська область
23019,630016,2117,5,1237,1173,64,630016,Харківська область
23020,630017,2086,11,1190,1146,44,630017,Харківська область
23021,630018,2228,18,1281,1206,75,630018,Харківська область
23022,630019,1299,13,720,661,59,630019,Харківська область
23023,630020,602,8,292,270,22,630020,Харківська область
23024,630021,468,3,305,263,42,630021,Харківська область
23025,630022,2291,21,1551,1458,93,630022,Харківська область
23026,630023,718,4,428,401,27,630023,Харківська область
23027,630024,2235,17,1365,1297,68,630024,Харківська область
23028,630025,2210,21,1404,1325,79,630025,Харківська область
23029,630026,568,3,357,350,7,630026,Харківська область
23030,630027,325,2,195,185,10,630027,Харківська область
23031,630028,802,8,568,534,34,630028,Харківська область
23032,630029,605,4,376,346,30,630029,Харківська область
23033,630030,1225,19,817,757,60,630030,Харківська область
23034,630031,1146,14,759,719,40,630031,Харківська область
23035,630032,536,0,312,295,17,630032,Харківська область
23036,630033,365,3,184,174,10,630033,Харківська область
23037,630034,460,1,269,245,24,630034,Харківська область
23038,630035,439,5,264,240,24,630035,Харківська область
23039,630036,814,2,542,514,28,630036,Харківська область
23040,630037,180,0,121,110,11,630037,Харківська область
23041,630038,717,11,471,430,41,630038,Харківська область
23042,630039,469,1,269,244,25,630039,Харківська область
23043,630040,860,3,455,426,29,630040,Харківська область
23044,630041,628,9,388,337,51,630041,Харківська область
23045,630042,299,3,209,178,31,630042,Харківська область
23046,630043,583,3,411,383,28,630043,Харківська область
23047,630044,1263,14,781,752,29,630044,Харківська область
23048,630045,310,1,201,188,13,630045,Харківська область
23049,630046,1571,14,1116,1076,40,630046,Харківська область
23050,630047,234,2,166,153,13,630047,Харківська область
23051,630048,485,1,301,289,12,630048,Харківська область
23052,630049,675,3,413,399,14,630049,Харківська область
23053,630050,1757,17,1041,992,49,630050,Харківська область
23054,630051,549,11,325,299,26,630051,Харківська область
23055,630052,743,7,510,464,46,630052,Харківська область
23056,630053,314,3,216,199,17,630053,Харківська область
23057,630054,662,5,459,435,24,630054,Харківська область
23058,630055,720,2,505,471,34,630055,Харківська область
23059,630056,192,1,134,104,30,630056,Харківська область
23060,630057,47,2,45,34,11,630057,Харківська область
23061,630059,311,8,303,236,67,630059,Харківська область
23062,630060,661,4,421,401,20,630060,Харківська область
23063,630061,1377,13,813,742,71,630061,Харківська область
23064,630062,1527,24,951,863,88,630062,Харківська область
23065,630063,1151,12,629,557,72,630063,Харківська область
23066,630064,940,17,586,530,56,630064,Харківська область
23067,630065,653,4,413,364,49,630065,Харківська область
23068,630066,1272,9,630,570,60,630066,Харківська область
23069,630067,999,6,496,468,28,630067,Харківська область
23070,630068,320,1,186,166,20,630068,Харківська область
23071,630069,378,2,233,202,31,630069,Харківська область
23072,630070,522,4,347,321,26,630070,Харківська область
23073,630071,492,2,268,230,38,630071,Харківська область
23074,630072,544,4,319,301,18,630072,Харківська область
23075,630073,195,1,113,94,19,630073,Харківська область
23076,630074,469,14,259,236,23,630074,Харківська область
23077,630075,505,5,305,286,19,630075,Харківська область
23078,630076,568,8,347,309,38,630076,Харківська область
23079,630077,337,2,206,194,12,630077,Харківська область
23080,630078,677,9,384,350,34,630078,Харківська область
23081,630079,601,3,368,347,21,630079,Харківська область
23082,630080,533,2,333,293,40,630080,Харківська область
23083,630081,415,1,263,220,43,630081,Харківська область
23084,630082,910,6,505,470,35,630082,Харківська область
23085,630083,258,1,169,141,28,630083,Харківська область
23086,630084,404,2,290,267,23,630084,Харківська область
23087,630085,157,0,104,81,23,630085,Харківська область
23088,630086,71,0,56,45,11,630086,Харківська область
23089,630087,588,9,345,304,41,630087,Харківська область
23090,630088,388,6,285,238,47,630088,Харківська область
23091,630089,180,3,142,107,35,630089,Харківська область
23092,630090,522,6,321,300,21,630090,Харківська область
23093,630091,28,0,28,27,1,630091,Харківська область
23094,630092,65,3,55,44,11,630092,Харківська область
23095,630093,1789,19,1078,957,121,630093,Харківська область
23096,630094,915,8,533,487,46,630094,Харківська область
23097,630095,652,6,392,342,50,630095,Харківська область
23098,630096,411,5,203,181,22,630096,Харківська область
23099,630097,389,6,229,194,35,630097,Харківська область
23100,630098,406,1,215,193,22,630098,Харківська область
23101,630099,650,3,333,304,29,630099,Харківська область
23102,630100,221,3,108,93,15,630100,Харківська область
23103,630101,752,3,431,382,49,630101,Харківська область
23104,630102,614,6,381,325,56,630102,Харківська область
23105,630103,489,4,266,239,27,630103,Харківська область
23106,630104,307,3,180,165,15,630104,Харківська область
23107,630105,724,6,425,370,55,630105,Харківська область
23108,630106,836,6,446,409,37,630106,Харківська область
23109,630107,408,2,220,208,12,630107,Харківська область
23110,630108,420,0,252,225,27,630108,Харківська область
23111,630109,216,4,125,107,18,630109,Харківська область
23112,630110,564,3,309,268,41,630110,Харківська область
23113,630111,387,6,203,168,35,630111,Харківська область
23114,630112,395,1,219,179,40,630112,Харківська область
23115,630113,445,3,260,240,20,630113,Харківська область
23116,630114,274,0,149,137,12,630114,Харківська область
23117,630115,430,3,267,249,18,630115,Харківська область
23118,630116,256,4,177,167,10,630116,Харківська область
23119,630117,321,2,192,173,19,630117,Харківська область
23120,630118,672,7,375,333,42,630118,Харківська область
23121,630119,667,6,413,375,38,630119,Харківська область
23122,630120,1236,7,801,707,94,630120,Харківська область
23123,630121,8,0,8,5,3,630121,Харківська область
23124,630709,218,2,125,111,14,630709,Харківська область
23125,630710,293,1,158,146,12,630710,Харківська область
23126,630711,569,7,361,333,28,630711,Харківська область
23127,630712,149,1,84,66,18,630712,Харківська область
23128,630713,416,1,259,210,49,630713,Харківська область
23129,630714,1040,6,651,588,63,630714,Харківська область
23130,630715,332,1,204,177,27,630715,Харківська область
23131,630716,302,2,169,144,25,630716,Харківська область
23132,630717,746,8,453,426,27,630717,Харківська область
23133,630718,245,0,171,158,13,630718,Харківська область
23134,630719,523,0,327,282,45,630719,Харківська область
23135,630720,240,3,163,150,13,630720,Харківська область
23136,630721,384,0,242,228,14,630721,Харківська область
23137,630722,387,2,242,210,32,630722,Харківська область
23138,630723,849,8,524,466,58,630723,Харківська область
23139,630724,518,8,321,260,61,630724,Харківська область
23140,630725,460,2,312,295,17,630725,Харківська область
23141,630726,440,1,276,254,22,630726,Харківська область
23142,630727,1294,7,730,689,41,630727,Харківська область
23143,630728,637,3,409,373,36,630728,Харківська область
23144,630729,555,3,400,375,25,630729,Харківська область
23145,630730,377,2,233,210,23,630730,Харківська область
23146,630731,445,1,282,258,24,630731,Харківська область
23147,630732,683,1,427,401,26,630732,Харківська область
23148,630733,511,5,275,243,32,630733,Харківська область
23149,631056,429,3,281,256,25,631056,Харківська область
23150,631057,1255,19,731,670,61,631057,Харківська область
23151,631058,338,8,183,173,10,631058,Харківська область
23152,631059,1087,17,698,664,34,631059,Харківська область
23153,631060,2241,32,1346,1255,91,631060,Харківська область
23154,631061,1808,22,1121,1046,75,631061,Харківська область
23155,631062,1661,18,894,832,62,631062,Харківська область
23156,631063,2139,23,1324,1231,93,631063,Харківська область
23157,631064,2118,31,1304,1220,84,631064,Харківська область
23158,631065,1910,26,1206,1136,70,631065,Харківська область
23159,631066,2167,28,1359,1280,79,631066,Харківська область
23160,631067,2118,15,1346,1263,83,631067,Харківська область
23161,631068,2235,34,1407,1312,95,631068,Харківська область
23162,631069,1929,21,1185,1089,96,631069,Харківська область
23163,631070,24,0,24,19,5,631070,Харківська область
23164,631071,252,1,251,157,94,631071,Харківська область
23165,630371,1225,10,738,683,55,630371,Харківська область
23166,630372,1340,17,801,735,66,630372,Харківська область
23167,630373,695,2,431,404,27,630373,Харківська область
23168,630374,602,1,361,338,23,630374,Харківська область
23169,630375,182,0,114,102,12,630375,Харківська область
23170,630376,678,8,461,419,42,630376,Харківська область
23171,630377,445,5,295,278,17,630377,Харківська область
23172,630378,639,7,440,427,13,630378,Харківська область
23173,630379,330,4,224,197,27,630379,Харківська область
23174,630380,553,3,329,288,41,630380,Харківська область
23175,630381,390,3,267,251,16,630381,Харківська область
23176,630382,607,6,391,329,62,630382,Харківська область
23177,630383,253,2,166,146,20,630383,Харківська область
23178,630384,237,0,167,157,10,630384,Харківська область
23179,630385,211,3,119,102,17,630385,Харківська область
23180,630386,142,0,106,100,6,630386,Харківська область
23181,630387,317,4,201,180,21,630387,Харківська область
23182,630388,323,4,204,193,11,630388,Харківська область
23183,630389,402,0,277,259,18,630389,Харківська область
23184,630390,212,2,144,125,19,630390,Харківська область
23185,630391,767,2,534,496,38,630391,Харківська область
23186,630392,312,5,179,174,5,630392,Харківська область
23187,630393,533,3,315,299,16,630393,Харківська область
23188,630394,179,4,80,72,8,630394,Харківська область
23189,630498,613,2,419,402,17,630498,Харківська область
23190,630499,510,4,307,283,24,630499,Харківська область
23191,630500,441,2,288,250,38,630500,Харківська область
23192,630501,731,7,411,384,27,630501,Харківська область
23193,630502,164,0,120,98,22,630502,Харківська область
23194,630503,1533,11,963,885,78,630503,Харківська область
23195,630504,1509,22,989,899,90,630504,Харківська область
23196,630505,852,8,568,520,48,630505,Харківська область
23197,630506,1052,7,645,597,48,630506,Харківська область
23198,630507,1032,4,573,535,38,630507,Харківська область
23199,630508,461,3,275,255,20,630508,Харківська область
23200,630509,517,2,299,284,15,630509,Харківська область
23201,630510,410,3,250,227,23,630510,Харківська область
23202,630511,458,3,286,245,41,630511,Харківська область
23203,630512,559,3,297,269,28,630512,Харківська область
23204,630513,357,0,235,217,18,630513,Харківська область
23205,630514,349,5,240,223,17,630514,Харківська область
23206,630515,267,2,195,177,18,630515,Харківська область
23207,630516,333,1,191,181,10,630516,Харківська область
23208,630517,1240,5,630,598,32,630517,Харківська область
23209,630518,1508,18,839,770,69,630518,Харківська область
23210,630519,614,0,366,326,40,630519,Харківська область
23211,630530,1448,13,934,871,63,630530,Харківська область
23212,630531,1607,14,1083,1011,72,630531,Харківська область
23213,630532,1651,18,1094,1028,66,630532,Харківська область
23214,630533,1430,12,951,890,61,630533,Харківська область
23215,630534,807,6,532,504,28,630534,Харківська область
23216,630535,765,11,525,490,35,630535,Харківська область
23217,630536,1015,12,695,637,58,630536,Харківська область
23218,630537,1504,18,988,920,68,630537,Харківська область
23219,630538,1157,8,756,704,52,630538,Харківська область
23220,630539,790,7,495,468,27,630539,Харківська область
23221,630540,1511,13,1003,943,60,630540,Харківська область
23222,630541,671,4,430,402,28,630541,Харківська область
23223,630542,672,5,445,418,27,630542,Харківська область
23224,630543,1042,10,656,632,24,630543,Харківська область
23225,630544,571,8,302,285,17,630544,Харківська область
23226,630545,524,2,321,300,21,630545,Харківська область
23227,630546,352,7,212,205,7,630546,Харківська область
23228,630547,460,2,277,255,22,630547,Харківська область
23229,630548,567,5,380,329,51,630548,Харківська область
23230,630549,379,2,262,240,22,630549,Харківська область
23231,630550,436,5,293,286,7,630550,Харківська область
23232,630551,241,0,166,152,14,630551,Харківська область
23233,630552,885,8,492,457,35,630552,Харківська область
23234,630553,902,6,543,500,43,630553,Харківська область
23235,630554,1741,24,1152,1083,69,630554,Харківська область
23236,630555,828,7,502,476,26,630555,Харківська область
23237,630556,664,4,442,421,21,630556,Харківська область
23238,630557,727,8,485,470,15,630557,Харківська область
23239,630558,1242,10,804,773,31,630558,Харківська область
23240,630559,337,3,247,224,23,630559,Харківська область
23241,630560,1532,11,952,918,34,630560,Харківська область
23242,630561,1594,10,1073,1005,68,630561,Харківська область
23243,630562,1019,4,634,617,17,630562,Харківська область
23244,630563,179,1,158,134,24,630563,Харківська область
23245,630564,1024,8,646,600,46,630564,Харківська область
23246,630565,204,1,124,106,18,630565,Харківська область
23247,630566,299,1,202,172,30,630566,Харківська область
23248,630567,312,0,230,224,6,630567,Харківська область
23249,630568,635,7,404,379,25,630568,Харківська область
23250,630569,171,0,119,112,7,630569,Харківська область
23251,630570,167,2,115,110,5,630570,Харківська область
23252,630571,45,0,43,39,4,630571,Харківська область
23253,630639,1608,9,916,856,60,630639,Харківська область
23254,630640,616,3,381,360,21,630640,Харківська область
23255,630641,1504,9,885,817,68,630641,Харківська область
23256,630642,1770,10,1040,980,60,630642,Харківська область
23257,630643,1251,13,685,633,52,630643,Харківська область
23258,630644,1480,4,844,798,46,630644,Харківська область
23259,630645,274,0,118,105,13,630645,Харківська область
23260,630646,364,1,268,231,37,630646,Харківська область
23261,630647,444,5,304,247,57,630647,Харківська область
23262,630648,401,4,248,213,35,630648,Харківська область
23263,630649,687,6,397,374,23,630649,Харківська область
23264,630650,1582,12,1034,926,108,630650,Харківська область
23265,630651,329,3,198,183,15,630651,Харківська область
23266,630652,483,2,307,291,16,630652,Харківська область
23267,630653,888,5,469,441,28,630653,Харківська область
23268,630654,481,5,292,251,41,630654,Харківська область
23269,630655,515,3,381,338,43,630655,Харківська область
23270,630656,933,4,548,510,38,630656,Харківська область
23271,630657,285,2,178,156,22,630657,Харківська область
23272,630658,583,6,376,341,35,630658,Харківська область
23273,630659,304,5,219,185,34,630659,Харківська область
23274,630660,306,8,212,164,48,630660,Харківська область
23275,630661,510,3,356,279,77,630661,Харківська область
23276,630662,907,4,555,529,26,630662,Харківська область
23277,630663,329,2,220,180,40,630663,Харківська область
23278,630664,659,3,424,387,37,630664,Харківська область
23279,630665,362,5,231,193,38,630665,Харківська область
23280,630666,645,3,498,336,162,630666,Харківська область
23281,630667,655,3,420,358,62,630667,Харківська область
23282,630668,990,4,569,541,28,630668,Харківська область
23283,630669,60,1,52,46,6,630669,Харківська область
23284,630745,325,0,179,156,23,630745,Харківська область
23285,630746,455,1,284,252,32,630746,Харківська область
23286,630747,320,3,197,165,32,630747,Харківська область
23287,630748,183,2,108,81,27,630748,Харківська область
23288,630749,126,3,76,50,26,630749,Харківська область
23289,630750,444,5,250,233,17,630750,Харківська область
23290,630751,147,0,90,76,14,630751,Харківська область
23291,630752,123,3,73,60,13,630752,Харківська область
23292,630753,507,1,296,253,43,630753,Харківська область
23293,630754,736,11,423,371,52,630754,Харківська область
23294,630755,220,3,121,110,11,630755,Харківська область
23295,630756,499,6,297,248,49,630756,Харківська область
23296,630757,177,0,104,91,13,630757,Харківська область
23297,630758,743,5,376,346,30,630758,Харківська область
23298,630759,553,6,308,270,38,630759,Харківська область
23299,630760,352,2,188,156,32,630760,Харківська область
23300,630761,166,0,85,69,16,630761,Харківська область
23301,630762,345,2,211,184,27,630762,Харківська область
23302,630763,267,2,184,173,11,630763,Харківська область
23303,630764,677,2,409,354,55,630764,Харківська область
23304,630765,399,4,247,234,13,630765,Харківська область
23305,630766,203,0,127,112,15,630766,Харківська область
23306,630767,94,1,60,57,3,630767,Харківська область
23307,630768,212,0,137,112,25,630768,Харківська область
23308,630769,167,0,96,89,7,630769,Харківська область
23309,630770,594,4,342,320,22,630770,Харківська область
23310,630771,821,7,431,398,33,630771,Харківська область
23311,630772,161,1,79,72,7,630772,Харківська область
23312,630773,425,7,262,246,16,630773,Харківська область
23313,630774,1297,14,784,722,62,630774,Харківська область
23314,630775,881,5,501,453,48,630775,Харківська область
23315,630776,1336,13,725,674,51,630776,Харківська область
23316,630777,801,6,426,390,36,630777,Харківська область
23317,630778,1119,9,660,617,43,630778,Харківська область
23318,630999,1426,30,935,833,102,630999,Харківська область
23319,631000,1733,24,1123,1028,95,631000,Харківська область
23320,631002,1191,7,735,662,73,631002,Харківська область
23321,631003,784,6,438,408,30,631003,Харківська область
23322,631004,1820,15,1182,1093,89,631004,Харківська область
23323,631005,1675,14,1115,1017,98,631005,Харківська область
23324,631006,1577,14,932,854,78,631006,Харківська область
23325,631007,1625,10,1063,969,94,631007,Харківська область
23326,631008,1483,20,996,930,66,631008,Харківська область
23327,631009,1955,20,1161,1071,90,631009,Харківська область
23328,631010,1710,19,1080,964,116,631010,Харківська область
23329,631011,1498,17,917,848,69,631011,Харківська область
23330,631012,1439,19,845,792,53,631012,Харківська область
23331,631013,1809,25,1134,1027,107,631013,Харківська область
23332,631014,1492,17,960,879,81,631014,Харківська область
23333,631015,1848,24,1208,1096,112,631015,Харківська область
23334,631016,1530,14,1010,921,89,631016,Харківська область
23335,631017,1580,20,1018,932,86,631017,Харківська область
23336,631018,2031,27,1174,1093,81,631018,Харківська область
23337,631019,733,6,437,409,28,631019,Харківська область
23338,631020,1476,20,930,838,92,631020,Харківська область
23339,631021,1059,15,683,639,44,631021,Харківська область
23340,631022,1006,6,596,550,46,631022,Харківська область
23341,631023,1041,13,585,540,45,631023,Харківська область
23342,631024,1020,9,638,599,39,631024,Харківська область
23343,631026,1774,18,1087,1020,67,631026,Харківська область
23344,631027,1497,16,871,810,61,631027,Харківська область
23345,631028,885,8,485,430,55,631028,Харківська область
23346,631029,805,4,444,413,31,631029,Харківська область
23347,631030,460,4,280,260,20,631030,Харківська область
23348,631031,2008,35,1180,1096,84,631031,Харківська область
23349,631032,1699,13,1156,1088,68,631032,Харківська область
23350,631033,1287,12,883,848,35,631033,Харківська область
23351,631034,259,1,156,145,11,631034,Харківська область
23352,631035,828,6,501,467,34,631035,Харківська область
23353,631037,66,0,62,56,6,631037,Харківська область
23354,630122,1163,8,664,593,71,630122,Харківська область
23355,630123,1714,15,1081,988,93,630123,Харківська область
23356,630124,1623,19,996,901,95,630124,Харківська область
23357,630125,1189,12,758,679,79,630125,Харківська область
23358,630126,1679,12,1072,961,111,630126,Харківська область
23359,630127,1310,17,724,681,43,630127,Харківська область
23360,630128,1583,11,1018,918,100,630128,Харківська область
23361,630129,1692,18,1018,931,87,630129,Харківська область
23362,630130,620,5,413,353,60,630130,Харківська область
23363,630131,991,4,619,581,38,630131,Харківська область
23364,630132,1919,14,1116,991,125,630132,Харківська область
23365,630134,1098,9,682,616,66,630134,Харківська область
23366,630135,300,2,169,144,25,630135,Харківська область
23367,630136,279,3,184,169,15,630136,Харківська область
23368,630137,1017,8,649,568,81,630137,Харківська область
23369,630138,337,1,191,157,34,630138,Харківська область
23370,630139,231,3,135,115,20,630139,Харківська область
23371,630140,265,3,155,136,19,630140,Харківська область
23372,630141,590,5,346,306,40,630141,Харківська область
23373,630142,407,1,250,203,47,630142,Харківська область
23374,630143,473,3,279,252,27,630143,Харківська область
23375,630144,325,1,201,183,18,630144,Харківська область
23376,630145,709,4,343,318,25,630145,Харківська область
23377,630146,316,3,173,157,16,630146,Харківська область
23378,630147,844,2,479,430,49,630147,Харківська область
23379,630148,749,6,463,418,45,630148,Харківська область
23380,630149,200,1,133,108,25,630149,Харківська область
23381,630150,319,1,215,175,40,630150,Харківська область
23382,630151,799,4,492,442,50,630151,Харківська область
23383,630152,561,6,339,325,14,630152,Харківська область
23384,630153,445,7,282,264,18,630153,Харківська область
23385,630154,656,6,381,334,47,630154,Харківська область
23386,630155,390,1,232,207,25,630155,Харківська область
23387,630156,481,2,316,293,23,630156,Харківська область
23388,630157,522,4,274,240,34,630157,Харківська область
23389,630158,301,1,173,160,13,630158,Харківська область
23390,630159,205,1,105,93,12,630159,Харківська область
23391,630160,315,1,168,156,12,630160,Харківська область
23392,630161,510,2,324,283,41,630161,Харківська область
23393,630162,308,2,200,127,73,630162,Харківська область
23394,630163,231,1,187,135,52,630163,Харківська область
23395,630164,416,4,267,247,20,630164,Харківська область
23396,630165,380,3,262,212,50,630165,Харківська область
23397,630188,1853,23,1190,1030,160,630188,Харківська область
23398,630189,2326,30,1461,1266,195,630189,Харківська область
23399,630190,1968,26,1203,1050,153,630190,Харківська область
23400,630191,1286,12,817,707,110,630191,Харківська область
23401,630192,1330,14,713,639,74,630192,Харківська область
23402,630193,1167,15,590,545,45,630193,Харківська область
23403,630194,1612,9,953,885,68,630194,Харківська область
23404,630195,867,8,546,503,43,630195,Харківська область
23405,630196,824,8,498,446,52,630196,Харківська область
23406,630197,437,1,302,274,28,630197,Харківська область
23407,630198,559,10,318,269,49,630198,Харківська область
23408,630199,1160,9,584,541,43,630199,Харківська область
23409,630200,779,11,479,419,60,630200,Харківська область
23410,630201,556,2,299,267,32,630201,Харківська область
23411,630202,299,6,195,176,19,630202,Харківська область
23412,630203,417,1,263,229,34,630203,Харківська область
23413,630204,717,9,388,368,20,630204,Харківська область
23414,630205,347,0,216,191,25,630205,Харківська область
23415,630206,474,4,298,271,27,630206,Харківська область
23416,630207,762,5,473,435,38,630207,Харківська область
23417,630208,559,6,372,316,56,630208,Харківська область
23418,630209,387,3,248,208,40,630209,Харківська область
23419,630210,740,10,407,371,36,630210,Харківська область
23420,630211,1227,8,772,692,80,630211,Харківська область
23421,630212,613,8,357,303,54,630212,Харківська область
23422,630213,1440,8,913,804,109,630213,Харківська область
23423,630214,29,0,28,21,7,630214,Харківська область
23424,630443,1759,11,1076,977,99,630443,Харківська область
23425,630444,1414,18,876,779,97,630444,Харківська область
23426,630445,1606,12,1014,910,104,630445,Харківська область
23427,630446,2072,33,1303,1173,130,630446,Харківська область
23428,630447,1330,17,789,740,49,630447,Харківська область
23429,630448,930,8,529,497,32,630448,Харківська область
23430,630449,253,0,121,104,17,630449,Харківська область
23431,630450,364,6,239,210,29,630450,Харківська область
23432,630451,302,4,182,154,28,630451,Харківська область
23433,630452,223,1,140,131,9,630452,Харківська область
23434,630453,274,0,158,151,7,630453,Харківська область
23435,630454,163,3,97,88,9,630454,Харківська область
23436,630455,1026,11,639,586,53,630455,Харківська область
23437,630456,528,4,290,274,16,630456,Харківська область
23438,630457,180,2,80,65,15,630457,Харківська область
23439,630458,581,7,330,268,62,630458,Харківська область
23440,630459,414,1,250,159,91,630459,Харківська область
23441,630460,807,6,405,367,38,630460,Харківська область
23442,630461,868,3,434,409,25,630461,Харківська область
23443,630462,730,10,437,399,38,630462,Харківська область
23444,630463,347,3,197,181,16,630463,Харківська область
23445,630464,1334,13,771,718,53,630464,Харківська область
23446,630465,743,7,525,389,136,630465,Харківська область
23447,630466,377,3,198,181,17,630466,Харківська область
23448,630467,76,2,49,32,17,630467,Харківська область
23449,630468,261,1,156,118,38,630468,Харківська область
23450,630469,350,1,222,195,27,630469,Харківська область
23451,630470,823,2,429,397,32,630470,Харківська область
23452,630471,1271,16,710,662,48,630471,Харківська область
23453,630472,1000,9,606,564,42,630472,Харківська область
23454,630520,1009,6,577,524,53,630520,Харківська область
23455,630521,801,14,480,421,59,630521,Харківська область
23456,630522,911,5,537,485,52,630522,Харківська область
23457,630523,283,1,174,162,12,630523,Харківська область
23458,630524,660,9,369,316,53,630524,Харківська область
23459,630525,161,2,94,75,19,630525,Харківська область
23460,630526,1479,20,822,748,74,630526,Харківська область
23461,630527,138,1,82,70,12,630527,Харківська область
23462,630528,270,5,174,158,16,630528,Харківська область
23463,630529,19,0,19,17,2,630529,Харківська область
23464,630572,1999,23,1233,1082,151,630572,Харківська область
23465,630573,1369,9,872,785,87,630573,Харківська область
23466,630574,913,14,514,449,65,630574,Харківська область
23467,630575,1539,9,911,837,74,630575,Харківська область
23468,630576,865,7,493,437,56,630576,Харківська область
23469,630577,169,0,117,109,8,630577,Харківська область
23470,630578,1298,4,673,610,63,630578,Харківська область
23471,630579,484,6,305,260,45,630579,Харківська область
23472,630580,500,4,287,243,44,630580,Харківська область
23473,630581,874,11,501,449,52,630581,Харківська область
23474,630582,353,6,263,207,56,630582,Харківська область
23475,630583,593,7,359,315,44,630583,Харківська область
23476,630584,724,4,464,388,76,630584,Харківська область
23477,630585,306,4,176,161,15,630585,Харківська область
23478,630586,647,7,380,358,22,630586,Харківська область
23479,630587,684,4,394,349,45,630587,Харківська область
23480,630588,610,3,365,325,40,630588,Харківська область
23481,630589,983,10,604,555,49,630589,Харківська область
23482,630590,979,15,541,491,50,630590,Харківська область
23483,630591,338,1,233,200,33,630591,Харківська область
23484,630592,226,1,158,146,12,630592,Харківська область
23485,630593,525,1,314,268,46,630593,Харківська область
23486,630594,615,8,413,351,62,630594,Харківська область
23487,630595,173,0,101,78,23,630595,Харківська область
23488,630596,423,3,298,254,44,630596,Харківська область
23489,630597,1229,10,689,644,45,630597,Харківська область
23490,630598,1382,16,712,645,67,630598,Харківська область
23491,630599,391,5,255,216,39,630599,Харківська область
23492,630600,262,1,165,142,23,630600,Харківська область
23493,630601,30,0,30,17,13,630601,Харківська область
23494,630670,561,2,296,273,23,630670,Харківська область
23495,630671,767,7,495,460,35,630671,Харківська область
23496,630673,1603,11,1027,914,113,630673,Харківська область
23497,630674,2324,27,1488,1367,121,630674,Харківська область
23498,630675,1284,12,813,728,85,630675,Харківська область
23499,630676,985,11,659,585,74,630676,Харківська область
23500,630677,2384,28,1439,1296,143,630677,Харківська область
23501,630678,1686,20,1044,941,103,630678,Харківська область
23502,630679,1958,21,1147,1074,73,630679,Харківська область
23503,630680,1486,19,988,933,55,630680,Харківська область
23504,630682,369,2,264,246,18,630682,Харківська область
23505,630683,261,1,175,151,24,630683,Харківська область
23506,630684,374,5,201,169,32,630684,Харківська область
23507,630685,706,1,419,371,48,630685,Харківська область
23508,630686,472,7,294,271,23,630686,Харківська область
23509,630687,293,4,153,143,10,630687,Харківська область
23510,630688,328,1,149,124,25,630688,Харківська область
23511,630689,462,6,279,262,17,630689,Харківська область
23512,630690,546,0,326,303,23,630690,Харківська область
23513,630691,562,0,278,264,14,630691,Харківська область
23514,630692,695,5,409,388,21,630692,Харківська область
23515,630693,278,1,159,147,12,630693,Харківська область
23516,630694,281,5,108,94,14,630694,Харківська область
23517,630695,897,6,574,542,32,630695,Харківська область
23518,630696,614,3,352,314,38,630696,Харківська область
23519,630697,847,6,490,457,33,630697,Харківська область
23520,630698,735,10,438,405,33,630698,Харківська область
23521,630699,218,2,136,121,15,630699,Харківська область
23522,630700,1024,2,526,508,18,630700,Харківська область
23523,630701,468,2,271,256,15,630701,Харківська область
23524,630702,445,8,272,261,11,630702,Харківська область
23525,630703,336,2,228,217,11,630703,Харківська область
23526,630704,114,0,69,59,10,630704,Харківська область
23527,630705,80,0,56,54,2,630705,Харківська область
23528,630706,541,4,356,339,17,630706,Харківська область
23529,630707,553,4,358,321,37,630707,Харківська область
23530,630708,20,1,19,16,3,630708,Харківська область
23531,630820,1333,11,789,730,59,630820,Харківська область
23532,630821,1365,5,804,749,55,630821,Харківська область
23533,630822,542,6,369,346,23,630822,Харківська область
23534,630395,1716,24,1092,983,109,630395,Харківська область
23535,630396,1841,27,1288,1043,245,630396,Харківська область
23536,630397,1820,17,1125,1034,91,630397,Харківська область
23537,630398,1834,26,1219,1079,140,630398,Харківська область
23538,630399,1977,25,1325,1199,126,630399,Харківська область
23539,630400,1908,23,1209,1086,123,630400,Харківська область
23540,630401,1977,24,1191,1091,100,630401,Харківська область
23541,630402,971,18,619,566,53,630402,Харківська область
23542,630403,2178,27,1389,1270,119,630403,Харківська область
23543,630404,1232,18,694,646,48,630404,Харківська область
23544,630405,1803,28,1217,1123,94,630405,Харківська область
23545,630406,1850,25,1215,1113,102,630406,Харківська область
23546,630407,1918,13,1231,1149,82,630407,Харківська область
23547,630408,1919,30,1228,1141,87,630408,Харківська область
23548,630409,1887,27,1247,1131,116,630409,Харківська область
23549,630410,1855,20,1231,1151,80,630410,Харківська область
23550,630411,1286,4,783,734,49,630411,Харківська область
23551,630412,382,1,210,188,22,630412,Харківська область
23552,630413,2030,20,1291,1130,161,630413,Харківська область
23553,630414,2049,17,1130,1005,125,630414,Харківська область
23554,630415,550,6,401,387,14,630415,Харківська область
23555,630416,765,3,513,492,21,630416,Харківська область
23556,630417,822,8,508,490,18,630417,Харківська область
23557,630418,569,3,351,335,16,630418,Харківська область
23558,630419,210,1,117,104,13,630419,Харківська область
23559,630420,288,3,169,141,28,630420,Харківська область
23560,630421,414,2,261,249,12,630421,Харківська область
23561,630422,1238,7,763,722,41,630422,Харківська область
23562,630423,833,15,518,487,31,630423,Харківська область
23563,630424,470,5,273,257,16,630424,Харківська область
23564,630425,671,2,452,406,46,630425,Харківська область
23565,630426,175,0,116,94,22,630426,Харківська область
23566,630427,1726,20,1047,956,91,630427,Харківська область
23567,630428,1124,11,733,643,90,630428,Харківська область
23568,630429,444,1,271,245,26,630429,Харківська область
23569,630430,352,4,242,210,32,630430,Харківська область
23570,630431,978,9,554,519,35,630431,Харківська область
23571,630432,1117,9,578,482,96,630432,Харківська область
23572,630433,2166,26,1251,1165,86,630433,Харківська область
23573,630434,1905,18,998,945,53,630434,Харківська область
23574,630435,209,3,118,116,2,630435,Харківська область
23575,630436,798,4,550,497,53,630436,Харківська область
23576,630437,218,2,134,120,14,630437,Харківська область
23577,630438,1779,11,1153,1044,109,630438,Харківська область
23578,630439,724,4,397,363,34,630439,Харківська область
23579,630440,484,7,386,330,56,630440,Харківська область
23580,630441,1874,16,1105,1004,101,630441,Харківська область
23581,630442,40,0,37,32,5,630442,Харківська область
23582,630779,2230,24,1315,1166,149,630779,Харківська область
23583,630780,1766,21,1095,974,121,630780,Харківська область
23584,630781,2111,31,1204,1077,127,630781,Харківська область
23585,630782,1967,18,1223,1098,125,630782,Харківська область
23586,630783,2288,20,1326,1216,110,630783,Харківська область
23587,630784,2220,15,1186,1075,111,630784,Харківська область
23588,630785,1865,27,1059,961,98,630785,Харківська область
23589,630786,1228,11,713,628,85,630786,Харківська область
23590,630787,2122,12,1251,1150,101,630787,Харківська область
23591,630788,2129,22,1281,1185,96,630788,Харківська область
23592,630789,1166,26,779,699,80,630789,Харківська область
23593,630790,1802,18,1151,1044,107,630790,Харківська область
23594,630791,1852,15,1204,1094,110,630791,Харківська область
23595,630792,1786,27,1216,1085,131,630792,Харківська область
23596,630793,2076,25,1268,1188,80,630793,Харківська область
23597,630794,1765,16,1168,1079,89,630794,Харківська область
23598,630795,1955,17,1255,1165,90,630795,Харківська область
23599,630796,1716,16,1057,978,79,630796,Харківська область
23600,630797,1246,18,810,733,77,630797,Харківська область
23601,630798,1666,62,951,896,55,630798,Харківська область
23602,630799,1776,20,1144,1076,68,630799,Харківська область
23603,630800,1741,15,1067,975,92,630800,Харківська область
23604,630801,116,2,66,58,8,630801,Харківська область
23605,630802,2326,38,1431,1349,82,630802,Харківська область
23606,630803,2192,17,1351,1279,72,630803,Харківська область
23607,630804,1590,16,936,857,79,630804,Харківська область
23608,630805,1234,11,759,665,94,630805,Харківська область
23609,630806,1423,20,779,714,65,630806,Харківська область
23610,630807,1242,20,708,582,126,630807,Харківська область
23611,630808,1945,35,1208,1101,107,630808,Харківська область
23612,630809,1673,17,1050,940,110,630809,Харківська область
23613,630823,908,8,564,486,78,630823,Харківська область
23614,630824,1609,16,943,836,107,630824,Харківська область
23615,630825,1860,26,1123,972,151,630825,Харківська область
23616,630826,1776,23,1049,971,78,630826,Харківська область
23617,630827,825,33,471,427,44,630827,Харківська область
23618,630828,1865,30,1259,1169,90,630828,Харківська область
23619,630832,1910,22,1203,1128,75,630832,Харківська область
23620,630837,1972,12,1310,1192,118,630837,Харківська область
23621,630838,1784,17,1181,1086,95,630838,Харківська область
23622,630839,1089,15,697,655,42,630839,Харківська область
23623,630846,612,6,411,372,39,630846,Харківська область
23624,630847,280,3,212,183,29,630847,Харківська область
23625,630860,1723,31,1056,980,76,630860,Харківська область
23626,630861,1364,27,847,748,99,630861,Харківська область
23627,630862,2091,23,1333,1156,177,630862,Харківська область
23628,630863,1825,19,1109,982,127,630863,Харківська область
23629,630864,1753,17,1192,1100,92,630864,Харківська область
23630,630865,2198,23,1433,1325,108,630865,Харківська область
23631,630866,1492,19,901,821,80,630866,Харківська область
23632,630867,2120,34,1348,1194,154,630867,Харківська область
23633,630868,954,5,510,470,40,630868,Харківська область
23634,630869,1035,11,706,667,39,630869,Харківська область
23635,630870,248,2,119,111,8,630870,Харківська область
23636,630871,168,2,86,84,2,630871,Харківська область
23637,630872,2154,27,1401,1251,150,630872,Харківська область
23638,630873,1483,32,972,866,106,630873,Харківська область
23639,630880,35,0,34,32,2,630880,Харківська область
23640,630882,881,21,860,761,99,630882,Харківська область
23641,630883,112,2,109,103,6,630883,Харківська область
23642,1,430,44,386,377,9,1,Херсонська область
23643,2,17,0,17,14,3,2,Херсонська область
23644,3,88,5,83,76,7,3,Херсонська область
23645,650622,1307,17,762,638,124,650622,Херсонська область
23646,650623,1855,21,1060,915,145,650623,Херсонська область
23647,650624,1866,15,998,831,167,650624,Херсонська область
23648,650625,1842,24,1128,946,182,650625,Херсонська область
23649,650626,1185,15,750,607,143,650626,Херсонська область
23650,650627,1873,27,1126,921,205,650627,Херсонська область
23651,650628,952,10,523,420,103,650628,Херсонська область
23652,650629,1118,19,690,567,123,650629,Херсонська область
23653,650630,1144,13,674,550,124,650630,Херсонська область
23654,650631,2103,30,1286,1077,209,650631,Херсонська область
23655,650632,2070,25,1189,945,244,650632,Херсонська область
23656,650633,1786,37,1006,814,192,650633,Херсонська область
23657,650634,1426,12,761,642,119,650634,Херсонська область
23658,650635,2083,36,1234,1029,205,650635,Херсонська область
23659,650636,1552,17,844,694,150,650636,Херсонська область
23660,650637,2006,24,1089,904,185,650637,Херсонська область
23661,650638,1206,17,649,539,110,650638,Херсонська область
23662,650639,1302,17,768,624,144,650639,Херсонська область
23663,650640,2127,23,1162,979,183,650640,Херсонська область
23664,650641,1821,16,949,796,153,650641,Херсонська область
23665,650642,1681,17,911,741,170,650642,Херсонська область
23666,650643,1352,23,817,665,152,650643,Херсонська область
23667,650644,1676,36,987,791,196,650644,Херсонська область
23668,650645,2126,25,1248,1029,219,650645,Херсонська область
23669,650646,2125,31,1326,1067,259,650646,Херсонська область
23670,650647,2108,22,1266,1037,229,650647,Херсонська область
23671,650648,2271,26,1338,1093,245,650648,Херсонська область
23672,650649,1325,17,701,596,105,650649,Херсонська область
23673,650650,2143,17,1289,1087,202,650650,Херсонська область
23674,650651,1640,19,920,764,156,650651,Херсонська область
23675,650652,1702,33,1016,868,148,650652,Херсонська область
23676,650653,1845,28,1066,890,176,650653,Херсонська область
23677,650662,1471,6,795,684,111,650662,Херсонська область
23678,650663,1608,17,895,787,108,650663,Херсонська область
23679,650664,1388,16,765,678,87,650664,Херсонська область
23680,650665,365,2,210,171,39,650665,Херсонська область
23681,650666,228,0,95,80,15,650666,Херсонська область
23682,650667,560,9,362,301,61,650667,Херсонська область
23683,650668,109,2,106,91,15,650668,Херсонська область
23684,650669,49,0,44,35,9,650669,Херсонська область
23685,650670,9,0,9,6,3,650670,Херсонська область
23686,650726,2318,20,1327,1087,240,650726,Херсонська область
23687,650727,1950,34,1147,880,267,650727,Херсонська область
23688,650728,1655,25,1022,818,204,650728,Херсонська область
23689,650729,2031,38,1132,930,202,650729,Херсонська область
23690,650730,2127,35,1313,1056,257,650730,Херсонська область
23691,650731,2129,25,1235,997,238,650731,Херсонська область
23692,650732,2301,31,1385,1134,251,650732,Херсонська область
23693,650733,2101,26,1267,1033,234,650733,Херсонська область
23694,650734,2042,19,1209,959,250,650734,Херсонська область
23695,650735,1897,14,1063,879,184,650735,Херсонська область
23696,650736,1433,25,848,679,169,650736,Херсонська область
23697,650737,1522,26,875,663,212,650737,Херсонська область
23698,650738,2057,33,1067,906,161,650738,Херсонська область
23699,650739,1652,19,990,751,239,650739,Херсонська область
23700,650740,2036,28,1119,922,197,650740,Херсонська область
23701,650741,1974,18,1170,960,210,650741,Херсонська область
23702,650742,1949,36,1135,921,214,650742,Херсонська область
23703,650743,2198,46,1328,1113,215,650743,Херсонська область
23704,650744,2130,15,1245,1037,208,650744,Херсонська область
23705,650745,1901,28,1089,910,179,650745,Херсонська область
23706,650746,1726,31,1015,854,161,650746,Херсонська область
23707,650747,1962,38,1066,921,145,650747,Херсонська область
23708,650748,2243,30,1245,1045,200,650748,Херсонська область
23709,650749,2121,19,1231,1028,203,650749,Херсонська область
23710,650750,2228,38,1321,1103,218,650750,Херсонська область
23711,650751,2312,31,1381,1161,220,650751,Херсонська область
23712,650752,1809,24,1076,913,163,650752,Херсонська область
23713,650753,2367,44,1297,1052,245,650753,Херсонська область
23714,650754,2061,21,1237,1034,203,650754,Херсонська область
23715,650755,1786,33,1121,935,186,650755,Херсонська область
23716,650756,2181,30,1356,1175,181,650756,Херсонська область
23717,650757,2224,32,1329,1150,179,650757,Херсонська область
23718,650758,2258,36,1372,1188,184,650758,Херсонська область
23719,650759,2462,27,1560,1308,252,650759,Херсонська область
23720,650760,2271,19,1424,1167,257,650760,Херсонська область
23721,650761,2282,41,1392,1146,246,650761,Херсонська область
23722,650762,2345,25,1476,1170,306,650762,Херсонська область
23723,650763,2339,44,1396,1129,267,650763,Херсонська область
23724,650764,2310,32,1361,1092,269,650764,Херсонська область
23725,650765,2248,27,1389,1118,271,650765,Херсонська область
23726,650766,2257,30,1402,1159,243,650766,Херсонська область
23727,650767,2227,34,1331,1102,229,650767,Херсонська область
23728,650768,2241,35,1375,1110,265,650768,Херсонська область
23729,650773,51,0,29,26,3,650773,Херсонська область
23730,650774,115,3,109,98,11,650774,Херсонська область
23731,650775,41,1,39,30,9,650775,Херсонська область
23732,650776,53,0,27,18,9,650776,Херсонська область
23733,650777,15,0,14,11,3,650777,Херсонська область
23734,650778,37,2,35,29,6,650778,Херсонська область
23735,650779,108,4,97,77,20,650779,Херсонська область
23736,650780,86,2,81,71,10,650780,Херсонська область
23737,650781,169,8,139,124,15,650781,Херсонська область
23738,650782,688,38,608,570,38,650782,Херсонська область
23739,650783,2176,7,291,235,56,650783,Херсонська область
23740,1,138,13,125,116,9,1,Херсонська область
23741,650047,2224,24,1242,993,249,650047,Херсонська область
23742,650048,1847,18,1059,818,241,650048,Херсонська область
23743,650049,2056,17,1087,882,205,650049,Херсонська область
23744,650050,1815,18,958,735,223,650050,Херсонська область
23745,650051,1441,17,802,657,145,650051,Херсонська область
23746,650052,1288,6,713,586,127,650052,Херсонська область
23747,650053,1144,12,582,501,81,650053,Херсонська область
23748,650054,1016,6,550,432,118,650054,Херсонська область
23749,650055,1716,10,882,747,135,650055,Херсонська область
23750,650056,1682,9,880,691,189,650056,Херсонська область
23751,650057,1834,12,884,739,145,650057,Херсонська область
23752,650058,840,14,493,377,116,650058,Херсонська область
23753,650059,271,4,177,144,33,650059,Херсонська область
23754,650060,1719,11,876,771,105,650060,Херсонська область
23755,650061,362,2,167,117,50,650061,Херсонська область
23756,650062,1101,14,538,444,94,650062,Херсонська область
23757,650063,481,2,238,206,32,650063,Херсонська область
23758,650064,1503,6,718,575,143,650064,Херсонська область
23759,650065,1718,23,921,791,130,650065,Херсонська область
23760,650066,2198,27,1285,1067,218,650066,Херсонська область
23761,650067,1586,17,800,635,165,650067,Херсонська область
23762,650068,2069,13,1038,884,154,650068,Херсонська область
23763,650070,1920,14,1070,936,134,650070,Херсонська область
23764,650071,758,7,347,266,81,650071,Херсонська область
23765,650072,2026,23,977,831,146,650072,Херсонська область
23766,650073,668,6,351,283,68,650073,Херсонська область
23767,650074,1124,10,571,471,100,650074,Херсонська область
23768,650075,616,6,326,239,87,650075,Херсонська область
23769,650076,274,0,137,113,24,650076,Херсонська область
23770,650077,1033,7,553,428,125,650077,Херсонська область
23771,650078,514,5,272,189,83,650078,Херсонська область
23772,650079,490,4,243,199,44,650079,Херсонська область
23773,650080,854,0,502,418,84,650080,Херсонська область
23774,650081,394,4,217,188,29,650081,Херсонська область
23775,650082,2342,42,1256,1071,185,650082,Херсонська область
23776,650083,2378,36,1267,1069,198,650083,Херсонська область
23777,650084,2408,30,1411,1161,250,650084,Херсонська область
23778,650085,133,0,84,72,12,650085,Херсонська область
23779,650086,372,33,339,321,18,650086,Херсонська область
23780,650654,2149,34,1283,1079,204,650654,Херсонська область
23781,650655,2113,22,1221,1002,219,650655,Херсонська область
23782,650656,1934,29,1087,891,196,650656,Херсонська область
23783,650657,2195,13,1124,957,167,650657,Херсонська область
23784,650658,2256,27,1285,1092,193,650658,Херсонська область
23785,650659,806,14,447,371,76,650659,Херсонська область
23786,650660,1163,7,622,523,99,650660,Херсонська область
23787,650661,833,5,565,437,128,650661,Херсонська область
23788,650671,103,0,91,79,12,650671,Херсонська область
23789,650672,2268,27,1435,1167,268,650672,Херсонська область
23790,650673,2127,35,1332,1087,245,650673,Херсонська область
23791,650674,2160,36,1302,1071,231,650674,Херсонська область
23792,650675,2040,29,1087,884,203,650675,Херсонська область
23793,650676,2041,33,1204,983,221,650676,Херсонська область
23794,650677,2215,40,1195,983,212,650677,Херсонська область
23795,650678,2052,24,1226,991,235,650678,Херсонська область
23796,650679,1398,20,843,691,152,650679,Херсонська область
23797,650680,1676,28,919,766,153,650680,Херсонська область
23798,650681,2322,24,1232,1014,218,650681,Херсонська область
23799,650682,629,9,310,247,63,650682,Херсонська область
23800,650683,2158,29,1258,1008,250,650683,Херсонська область
23801,650684,2246,29,1223,977,246,650684,Херсонська область
23802,650685,1232,17,727,595,132,650685,Херсонська область
23803,650686,1850,36,1080,893,187,650686,Херсонська область
23804,650687,1816,30,925,755,170,650687,Херсонська область
23805,650688,2035,44,1092,897,195,650688,Херсонська область
23806,650689,1792,35,1080,911,169,650689,Херсонська область
23807,650690,1813,30,1047,852,195,650690,Херсонська область
23808,650691,1510,23,898,702,196,650691,Херсонська область
23809,650692,1569,18,866,736,130,650692,Херсонська область
23810,650693,1862,24,1069,871,198,650693,Херсонська область
23811,650694,2168,25,1270,1029,241,650694,Херсонська область
23812,650695,2258,33,1296,1080,216,650695,Херсонська область
23813,650696,1976,24,1093,904,189,650696,Херсонська область
23814,650697,2040,22,1129,928,201,650697,Херсонська область
23815,650698,1942,25,1136,948,188,650698,Херсонська область
23816,650699,2261,17,1229,1019,210,650699,Херсонська область
23817,650700,1272,14,743,607,136,650700,Херсонська область
23818,650701,1458,11,807,686,121,650701,Херсонська область
23819,650702,1014,10,621,510,111,650702,Херсонська область
23820,650703,1970,17,1161,984,177,650703,Херсонська область
23821,650704,1953,23,1183,993,190,650704,Херсонська область
23822,650705,1779,24,966,827,139,650705,Херсонська область
23823,650706,1733,17,1012,839,173,650706,Херсонська область
23824,650707,1754,22,1092,891,201,650707,Херсонська область
23825,650708,1810,28,1104,888,216,650708,Херсонська область
23826,650709,2053,30,1215,1016,199,650709,Херсонська область
23827,650710,1686,31,978,795,183,650710,Херсонська область
23828,650711,1688,25,1014,837,177,650711,Херсонська область
23829,650712,1315,12,750,620,130,650712,Херсонська область
23830,650713,2105,39,1269,1051,218,650713,Херсонська область
23831,650714,1330,17,822,669,153,650714,Херсонська область
23832,650715,1574,27,975,829,146,650715,Херсонська область
23833,650716,1862,28,1054,866,188,650716,Херсонська область
23834,650717,1629,31,793,684,109,650717,Херсонська область
23835,650718,1871,25,989,878,111,650718,Херсонська область
23836,650719,2151,21,1066,944,122,650719,Херсонська область
23837,650720,1478,11,811,706,105,650720,Херсонська область
23838,650721,1166,10,673,576,97,650721,Херсонська область
23839,650722,305,6,229,210,19,650722,Херсонська область
23840,650723,34,1,32,28,4,650723,Херсонська область
23841,650724,51,0,49,40,9,650724,Херсонська область
23842,650725,14,0,13,13,0,650725,Херсонська область
23843,650769,1547,25,884,741,143,650769,Херсонська область
23844,650770,1405,16,806,706,100,650770,Херсонська область
23845,650771,212,4,203,156,47,650771,Херсонська область
23846,650772,28,2,25,18,7,650772,Херсонська область
23847,650001,2276,15,1109,993,116,650001,Херсонська область
23848,650002,1932,18,991,855,136,650002,Херсонська область
23849,650003,1208,10,674,583,91,650003,Херсонська область
23850,650004,1838,13,1065,916,149,650004,Херсонська область
23851,650005,1650,16,962,810,152,650005,Херсонська область
23852,650006,1869,15,1014,910,104,650006,Херсонська область
23853,650007,836,2,434,384,50,650007,Херсонська область
23854,650008,1897,23,1099,949,150,650008,Херсонська область
23855,650009,1630,20,940,847,93,650009,Херсонська область
23856,650010,1396,14,725,632,93,650010,Херсонська область
23857,650011,1639,20,869,801,68,650011,Херсонська область
23858,650012,560,7,328,308,20,650012,Херсонська область
23859,650013,1377,15,684,571,113,650013,Херсонська область
23860,650014,826,7,433,316,117,650014,Херсонська область
23861,650017,415,6,258,201,57,650017,Херсонська область
23862,650018,1375,15,811,564,247,650018,Херсонська область
23863,650019,320,1,174,166,8,650019,Херсонська область
23864,650020,1148,9,560,463,97,650020,Херсонська область
23865,650021,172,1,86,65,21,650021,Херсонська область
23866,650022,632,2,358,267,91,650022,Херсонська область
23867,650023,180,2,85,42,43,650023,Херсонська область
23868,650025,341,1,135,113,22,650025,Херсонська область
23869,650026,1615,14,791,696,95,650026,Херсонська область
23870,650027,313,3,160,134,26,650027,Херсонська область
23871,650028,757,5,422,350,72,650028,Херсонська область
23872,650029,146,0,82,65,17,650029,Херсонська область
23873,650030,69,3,38,21,17,650030,Херсонська область
23874,650031,805,5,486,450,36,650031,Херсонська область
23875,650032,821,6,399,295,104,650032,Херсонська область
23876,650033,174,1,113,92,21,650033,Херсонська область
23877,650034,1606,8,856,725,131,650034,Херсонська область
23878,650035,393,3,213,161,52,650035,Херсонська область
23879,650037,847,5,476,403,73,650037,Херсонська область
23880,650038,305,4,238,214,24,650038,Херсонська область
23881,650039,500,0,306,265,41,650039,Херсонська область
23882,650040,559,4,297,241,56,650040,Херсонська область
23883,650041,514,8,224,179,45,650041,Херсонська область
23884,650042,1072,12,541,439,102,650042,Херсонська область
23885,650043,89,0,46,40,6,650043,Херсонська область
23886,650044,226,5,125,101,24,650044,Херсонська область
23887,650045,759,6,423,372,51,650045,Херсонська область
23888,650046,29,0,28,25,3,650046,Херсонська область
23889,650088,1658,18,886,796,90,650088,Херсонська область
23890,650089,1366,17,718,641,77,650089,Херсонська область
23891,650090,1360,11,721,620,101,650090,Херсонська область
23892,650091,1521,11,809,703,106,650091,Херсонська область
23893,650092,1200,9,615,528,87,650092,Херсонська область
23894,650093,198,0,109,87,22,650093,Херсонська область
23895,650094,120,0,88,62,26,650094,Херсонська область
23896,650095,328,4,200,187,13,650095,Херсонська область
23897,650096,200,2,113,99,14,650096,Херсонська область
23898,650097,1198,7,625,518,107,650097,Херсонська область
23899,650098,60,1,48,27,21,650098,Херсонська область
23900,650099,905,6,515,460,55,650099,Херсонська область
23901,650100,458,7,268,209,59,650100,Херсонська область
23902,650102,374,7,262,251,11,650102,Херсонська область
23903,650103,1022,8,524,445,79,650103,Херсонська область
23904,650104,763,8,404,326,78,650104,Херсонська область
23905,650105,591,3,294,279,15,650105,Херсонська область
23906,650106,40,0,31,22,9,650106,Херсонська область
23907,650107,24,0,24,18,6,650107,Херсонська область
23908,650108,1129,10,659,593,66,650108,Херсонська область
23909,650109,1101,8,606,546,60,650109,Херсонська область
23910,650110,1776,14,959,856,103,650110,Херсонська область
23911,650111,1371,10,868,734,134,650111,Херсонська область
23912,650112,272,2,193,181,12,650112,Херсонська область
23913,650113,1188,10,679,589,90,650113,Херсонська область
23914,650114,384,2,211,174,37,650114,Херсонська область
23915,650115,891,5,496,452,44,650115,Херсонська область
23916,650116,1213,12,705,610,95,650116,Херсонська область
23917,650117,710,13,481,430,51,650117,Херсонська область
23918,650118,643,5,386,326,60,650118,Херсонська область
23919,650119,1256,10,650,561,89,650119,Херсонська область
23920,650120,255,2,138,117,21,650120,Херсонська область
23921,650121,421,1,205,191,14,650121,Херсонська область
23922,650122,1357,13,851,729,122,650122,Херсонська область
23923,650123,268,2,130,103,27,650123,Херсонська область
23924,650124,389,3,214,183,31,650124,Херсонська область
23925,650125,132,1,77,60,17,650125,Херсонська область
23926,650126,330,3,214,188,26,650126,Херсонська область
23927,650127,208,4,111,84,27,650127,Херсонська область
23928,650128,342,3,226,182,44,650128,Херсонська область
23929,650129,534,7,312,250,62,650129,Херсонська область
23930,650130,317,4,171,150,21,650130,Херсонська область
23931,650131,459,0,249,196,53,650131,Херсонська область
23932,650132,547,5,349,257,92,650132,Херсонська область
23933,650133,441,6,238,207,31,650133,Херсонська область
23934,650134,632,6,364,311,53,650134,Херсонська область
23935,650135,154,3,84,78,6,650135,Херсонська область
23936,650136,73,0,42,37,5,650136,Херсонська область
23937,650137,58,0,36,26,10,650137,Херсонська область
23938,650138,324,0,198,173,25,650138,Херсонська область
23939,650139,163,4,79,62,17,650139,Херсонська область
23940,650140,99,2,52,32,20,650140,Херсонська область
23941,650163,1615,19,858,727,131,650163,Херсонська область
23942,650164,1027,11,624,536,88,650164,Херсонська область
23943,650165,969,8,524,450,74,650165,Херсонська область
23944,650166,323,5,219,197,22,650166,Херсонська область
23945,650167,306,5,167,129,38,650167,Херсонська область
23946,650168,146,0,101,84,17,650168,Херсонська область
23947,650169,586,6,347,268,79,650169,Херсонська область
23948,650170,556,3,315,279,36,650170,Херсонська область
23949,650171,492,3,300,239,61,650171,Херсонська область
23950,650172,229,1,118,110,8,650172,Херсонська область
23951,650173,1507,21,798,730,68,650173,Херсонська область
23952,650174,563,8,332,297,35,650174,Херсонська область
23953,650175,247,1,141,120,21,650175,Херсонська область
23954,650176,448,5,257,226,31,650176,Херсонська область
23955,650177,211,1,131,117,14,650177,Херсонська область
23956,650178,504,3,314,284,30,650178,Херсонська область
23957,650179,630,3,356,307,49,650179,Херсонська область
23958,650180,380,3,236,204,32,650180,Херсонська область
23959,650181,142,4,104,95,9,650181,Херсонська область
23960,650182,436,4,274,244,30,650182,Херсонська область
23961,650288,2188,32,1184,949,235,650288,Херсонська область
23962,650289,2186,21,1273,1071,202,650289,Херсонська область
23963,650290,139,0,71,57,14,650290,Херсонська область
23964,650291,1364,10,710,593,117,650291,Херсонська область
23965,650292,818,8,444,375,69,650292,Херсонська область
23966,650293,448,6,230,184,46,650293,Херсонська область
23967,650294,639,6,350,293,57,650294,Херсонська область
23968,650295,79,0,49,39,10,650295,Херсонська область
23969,650296,672,3,385,324,61,650296,Херсонська область
23970,650297,704,8,352,289,63,650297,Херсонська область
23971,650298,394,7,219,168,51,650298,Херсонська область
23972,650299,1271,7,618,511,107,650299,Херсонська область
23973,650300,379,5,217,168,49,650300,Херсонська область
23974,650301,746,10,471,324,147,650301,Херсонська область
23975,650302,262,3,158,133,25,650302,Херсонська область
23976,650303,71,1,31,18,13,650303,Херсонська область
23977,650304,670,2,376,309,67,650304,Херсонська область
23978,650305,584,5,367,293,74,650305,Херсонська область
23979,650394,2100,35,1158,971,187,650394,Херсонська область
23980,650395,2082,26,1178,963,215,650395,Херсонська область
23981,650396,725,4,401,337,64,650396,Херсонська область
23982,650397,161,0,84,73,11,650397,Херсонська область
23983,650398,436,6,213,184,29,650398,Херсонська область
23984,650399,1074,8,558,462,96,650399,Херсонська область
23985,650400,415,5,247,213,34,650400,Херсонська область
23986,650401,72,1,46,33,13,650401,Херсонська область
23987,650402,892,9,475,302,173,650402,Херсонська область
23988,650403,403,0,235,186,49,650403,Херсонська область
23989,650404,153,2,89,74,15,650404,Херсонська область
23990,650405,696,9,378,316,62,650405,Херсонська область
23991,650406,1032,10,486,300,186,650406,Херсонська область
23992,650407,351,1,190,143,47,650407,Херсонська область
23993,650408,893,12,499,403,96,650408,Херсонська область
23994,650409,889,16,505,394,111,650409,Херсонська область
23995,650410,776,11,490,356,134,650410,Херсонська область
23996,650411,1015,9,543,401,142,650411,Херсонська область
23997,650412,1392,9,794,698,96,650412,Херсонська область
23998,650413,270,6,144,133,11,650413,Херсонська область
23999,650584,1370,16,798,716,82,650584,Херсонська область
24000,650585,1447,7,842,754,88,650585,Херсонська область
24001,650586,2222,29,1285,1147,138,650586,Херсонська область
24002,650587,1089,17,654,565,89,650587,Херсонська область
24003,650588,2363,24,1313,1137,176,650588,Херсонська область
24004,650589,830,15,460,389,71,650589,Херсонська область
24005,650590,2259,32,1374,1163,211,650590,Херсонська область
24006,650591,2220,23,1253,1075,178,650591,Херсонська область
24007,650592,2307,25,1389,1186,203,650592,Херсонська область
24008,650593,2339,29,1456,1276,180,650593,Херсонська область
24009,650594,2243,20,1354,1137,217,650594,Херсонська область
24010,650595,2376,38,1452,1242,210,650595,Херсонська область
24011,650596,1436,13,797,685,112,650596,Херсонська область
24012,650597,1290,18,785,644,141,650597,Херсонська область
24013,650598,2224,33,1301,1107,194,650598,Херсонська область
24014,650599,2000,26,1288,1084,204,650599,Херсонська область
24015,650600,1740,12,1078,893,185,650600,Херсонська область
24016,650601,893,12,538,466,72,650601,Херсонська область
24017,650602,1284,19,723,629,94,650602,Херсонська область
24018,650603,1113,20,656,553,103,650603,Херсонська область
24019,650604,933,13,608,465,143,650604,Херсонська область
24020,650605,949,21,609,496,113,650605,Херсонська область
24021,650606,1392,27,825,712,113,650606,Херсонська область
24022,650607,1701,15,1000,851,149,650607,Херсонська область
24023,650608,1758,21,1020,907,113,650608,Херсонська область
24024,650609,1077,29,675,589,86,650609,Херсонська область
24025,650610,1430,20,833,708,125,650610,Херсонська область
24026,650611,820,1,460,380,80,650611,Херсонська область
24027,650612,918,9,559,477,82,650612,Херсонська область
24028,650613,1728,24,1016,921,95,650613,Херсонська область
24029,650614,1997,22,1130,1017,113,650614,Херсонська область
24030,650615,1340,11,756,645,111,650615,Херсонська область
24031,650616,1003,18,548,464,84,650616,Херсонська область
24032,650617,473,1,269,237,32,650617,Херсонська область
24033,650618,549,2,311,273,38,650618,Херсонська область
24034,650619,712,14,465,407,58,650619,Херсонська область
24035,650620,987,9,553,495,58,650620,Херсонська область
24036,650621,42,0,38,35,3,650621,Херсонська область
24037,650142,426,3,275,195,80,650142,Херсонська область
24038,650143,458,5,320,281,39,650143,Херсонська область
24039,650144,643,2,404,347,57,650144,Херсонська область
24040,650145,862,6,496,421,75,650145,Херсонська область
24041,650146,1465,9,874,764,110,650146,Херсонська область
24042,650147,734,5,457,398,59,650147,Херсонська область
24043,650148,341,2,208,179,29,650148,Херсонська область
24044,650149,179,0,139,126,13,650149,Херсонська область
24045,650150,134,0,90,77,13,650150,Херсонська область
24046,650151,82,1,47,40,7,650151,Херсонська область
24047,650152,410,6,254,212,42,650152,Херсонська область
24048,650153,944,8,553,477,76,650153,Херсонська область
24049,650154,113,1,90,84,6,650154,Херсонська область
24050,650155,166,1,114,86,28,650155,Херсонська область
24051,650156,369,7,267,224,43,650156,Херсонська область
24052,650157,571,4,314,264,50,650157,Херсонська область
24053,650158,144,1,91,63,28,650158,Херсонська область
24054,650159,103,0,66,50,16,650159,Херсонська область
24055,650160,532,4,272,204,68,650160,Херсонська область
24056,650183,828,16,469,411,58,650183,Херсонська область
24057,650184,1088,16,621,552,69,650184,Херсонська область
24058,650185,1519,18,821,724,97,650185,Херсонська область
24059,650186,1768,18,990,896,94,650186,Херсонська область
24060,650187,2224,19,1307,1198,109,650187,Херсонська область
24061,650188,2021,22,1183,1101,82,650188,Херсонська область
24062,650189,1324,13,722,674,48,650189,Херсонська область
24063,650190,1251,16,701,644,57,650190,Херсонська область
24064,650191,1195,15,630,571,59,650191,Херсонська область
24065,650192,982,14,574,529,45,650192,Херсонська область
24066,650193,1797,14,1055,970,85,650193,Херсонська область
24067,650194,1388,9,640,510,130,650194,Херсонська область
24068,650195,1305,11,642,491,151,650195,Херсонська область
24069,650196,1510,11,763,590,173,650196,Херсонська область
24070,650197,1342,9,565,412,153,650197,Херсонська область
24071,650198,1308,16,576,442,134,650198,Херсонська область
24072,650199,1188,7,546,463,83,650199,Херсонська область
24073,650200,1399,17,644,541,103,650200,Херсонська область
24074,650201,648,3,382,356,26,650201,Херсонська область
24075,650203,735,1,421,386,35,650203,Херсонська область
24076,650204,733,7,360,346,14,650204,Херсонська область
24077,650205,850,8,387,316,71,650205,Херсонська область
24078,650206,207,1,131,118,13,650206,Херсонська область
24079,650207,316,3,221,196,25,650207,Херсонська область
24080,650208,115,0,43,39,4,650208,Херсонська область
24081,650209,1016,14,530,494,36,650209,Херсонська область
24082,650210,1176,7,610,589,21,650210,Херсонська область
24083,650211,591,4,341,292,49,650211,Херсонська область
24084,650212,614,6,346,323,23,650212,Херсонська область
24085,650213,154,1,101,74,27,650213,Херсонська область
24086,650214,489,6,306,277,29,650214,Херсонська область
24087,650215,494,5,234,211,23,650215,Херсонська область
24088,650216,159,1,118,103,15,650216,Херсонська область
24089,650217,777,6,424,383,41,650217,Херсонська область
24090,650218,574,8,344,300,44,650218,Херсонська область
24091,650219,1111,12,628,573,55,650219,Херсонська область
24092,650220,1131,14,641,585,56,650220,Херсонська область
24093,650221,884,10,520,488,32,650221,Херсонська область
24094,650222,472,6,265,233,32,650222,Херсонська область
24095,650223,381,4,226,200,26,650223,Херсонська область
24096,650224,87,2,46,41,5,650224,Херсонська область
24097,650225,65,1,42,38,4,650225,Херсонська область
24098,650226,1089,9,619,510,109,650226,Херсонська область
24099,650227,153,3,80,74,6,650227,Херсонська область
24100,650228,401,3,234,216,18,650228,Херсонська область
24101,650229,241,2,125,109,16,650229,Херсонська область
24102,650230,151,3,71,65,6,650230,Херсонська область
24103,650231,1263,10,671,580,91,650231,Херсонська область
24104,650232,487,6,278,234,44,650232,Херсонська область
24105,650233,186,2,91,82,9,650233,Херсонська область
24106,650234,1045,9,590,535,55,650234,Херсонська область
24107,650306,1776,17,970,783,187,650306,Херсонська область
24108,650307,1113,12,577,458,119,650307,Херсонська область
24109,650309,370,1,199,153,46,650309,Херсонська область
24110,650310,324,2,212,145,67,650310,Херсонська область
24111,650311,297,4,159,142,17,650311,Херсонська область
24112,650312,343,3,213,187,26,650312,Херсонська область
24113,650313,601,3,348,235,113,650313,Херсонська область
24114,650314,628,4,314,262,52,650314,Херсонська область
24115,650315,398,2,244,191,53,650315,Херсонська область
24116,650316,593,5,346,258,88,650316,Херсонська область
24117,650317,763,1,428,396,32,650317,Херсонська область
24118,650318,893,5,386,313,73,650318,Херсонська область
24119,650319,549,1,309,262,47,650319,Херсонська область
24120,650320,643,6,348,313,35,650320,Херсонська область
24121,650321,535,3,260,218,42,650321,Херсонська область
24122,650322,345,3,177,151,26,650322,Херсонська область
24123,650341,2239,33,1284,1172,112,650341,Херсонська область
24124,650342,2133,17,1239,1092,147,650342,Херсонська область
24125,650343,1077,5,576,473,103,650343,Херсонська область
24126,650344,169,0,115,90,25,650344,Херсонська область
24127,650345,472,3,267,228,39,650345,Херсонська область
24128,650346,422,2,201,180,21,650346,Херсонська область
24129,650347,596,5,301,233,68,650347,Херсонська область
24130,650348,639,8,342,305,37,650348,Херсонська область
24131,650349,151,1,89,78,11,650349,Херсонська область
24132,650350,455,3,220,196,24,650350,Херсонська область
24133,650351,177,2,115,80,35,650351,Херсонська область
24134,650352,520,5,370,324,46,650352,Херсонська область
24135,650353,525,9,334,292,42,650353,Херсонська область
24136,650354,616,12,362,336,26,650354,Херсонська область
24137,650355,321,1,248,223,25,650355,Херсонська область
24138,650356,1431,10,777,662,115,650356,Херсонська область
24139,650357,470,2,267,236,31,650357,Херсонська область
24140,650358,585,3,323,294,29,650358,Херсонська область
24141,650359,197,1,100,88,12,650359,Херсонська область
24142,650360,2389,21,1472,1308,164,650360,Херсонська область
24143,650361,416,4,261,212,49,650361,Херсонська область
24144,650362,1767,18,1002,860,142,650362,Херсонська область
24145,650363,611,2,305,253,52,650363,Херсонська область
24146,650364,76,0,49,40,9,650364,Херсонська область
24147,650365,646,11,433,371,62,650365,Херсонська область
24148,650366,699,9,329,298,31,650366,Херсонська область
24149,650367,1372,6,897,814,83,650367,Херсонська область
24150,650368,449,3,239,185,54,650368,Херсонська область
24151,650369,836,3,421,330,91,650369,Херсонська область
24152,650370,324,4,181,126,55,650370,Херсонська область
24153,650371,294,4,152,128,24,650371,Херсонська область
24154,650372,316,3,179,160,19,650372,Херсонська область
24155,650373,770,7,409,336,73,650373,Херсонська область
24156,650374,1228,11,697,621,76,650374,Херсонська область
24157,650375,1407,14,796,712,84,650375,Херсонська область
24158,650376,285,5,186,158,28,650376,Херсонська область
24159,650377,343,0,192,173,19,650377,Херсонська область
24160,650378,635,3,342,281,61,650378,Херсонська область
24161,650379,1161,12,591,551,40,650379,Херсонська область
24162,650380,342,1,207,178,29,650380,Херсонська область
24163,650381,567,5,319,285,34,650381,Херсонська область
24164,650382,512,7,263,216,47,650382,Херсонська область
24165,650383,306,2,165,140,25,650383,Херсонська область
24166,650384,936,5,507,451,56,650384,Херсонська область
24167,650385,340,4,174,141,33,650385,Херсонська область
24168,650386,1277,12,772,647,125,650386,Херсонська область
24169,650387,1382,10,787,681,106,650387,Херсонська область
24170,650388,466,2,244,224,20,650388,Херсонська область
24171,650389,799,7,431,382,49,650389,Херсонська область
24172,650390,856,10,416,360,56,650390,Херсонська область
24173,650391,677,5,368,280,88,650391,Херсонська область
24174,650392,514,6,292,270,22,650392,Херсонська область
24175,650393,542,1,250,200,50,650393,Херсонська область
24176,650414,1555,16,762,670,92,650414,Херсонська область
24177,650415,1440,12,736,644,92,650415,Херсонська область
24178,650416,1678,14,814,728,86,650416,Херсонська область
24179,650417,1676,14,818,741,77,650417,Херсонська область
24180,650418,1075,6,485,433,52,650418,Херсонська область
24181,650419,1398,8,620,550,70,650419,Херсонська область
24182,650420,261,5,160,141,19,650420,Херсонська область
24183,650421,61,1,41,36,5,650421,Херсонська область
24184,650422,424,6,229,209,20,650422,Херсонська область
24185,650423,499,2,254,234,20,650423,Херсонська область
24186,650424,392,0,250,209,41,650424,Херсонська область
24187,650425,656,4,327,293,34,650425,Херсонська область
24188,650426,210,0,161,156,5,650426,Херсонська область
24189,650427,278,3,209,198,11,650427,Херсонська область
24190,650428,479,1,269,221,48,650428,Херсонська область
24191,650429,300,4,152,142,10,650429,Херсонська область
24192,650430,309,2,175,156,19,650430,Херсонська область
24193,650431,236,4,106,90,16,650431,Херсонська область
24194,650432,697,9,392,350,42,650432,Херсонська область
24195,650433,1588,11,810,695,115,650433,Херсонська область
24196,650434,1635,15,845,757,88,650434,Херсонська область
24197,650435,417,2,200,194,6,650435,Херсонська область
24198,650436,124,1,62,55,7,650436,Херсонська область
24199,650437,559,11,290,256,34,650437,Херсонська область
24200,650438,252,3,147,126,21,650438,Херсонська область
24201,650439,382,5,202,160,42,650439,Херсонська область
24202,650440,659,3,331,295,36,650440,Херсонська область
24203,650441,1662,13,807,672,135,650441,Херсонська область
24204,650442,590,0,335,302,33,650442,Херсонська область
24205,650443,112,1,89,76,13,650443,Херсонська область
24206,650444,252,0,154,141,13,650444,Херсонська область
24207,650445,531,1,280,242,38,650445,Херсонська область
24208,650446,805,5,397,375,22,650446,Херсонська область
24209,650447,67,0,56,45,11,650447,Херсонська область
24210,650448,1216,6,709,650,59,650448,Херсонська область
24211,650449,155,3,80,72,8,650449,Херсонська область
24212,650450,773,2,332,314,18,650450,Херсонська область
24213,650451,688,5,343,306,37,650451,Херсонська область
24214,650452,114,1,87,70,17,650452,Херсонська область
24215,650453,136,0,86,66,20,650453,Херсонська область
24216,650454,603,5,282,229,53,650454,Херсонська область
24217,650455,1089,4,476,419,57,650455,Херсонська область
24218,650534,1270,8,669,587,82,650534,Херсонська область
24219,650535,1415,5,860,792,68,650535,Херсонська область
24220,650536,380,3,210,180,30,650536,Херсонська область
24221,650537,483,6,262,237,25,650537,Херсонська область
24222,650538,488,1,264,234,30,650538,Херсонська область
24223,650545,682,6,365,297,68,650545,Херсонська область
24224,650546,424,5,222,191,31,650546,Херсонська область
24225,650548,658,2,320,257,63,650548,Херсонська область
24226,650562,601,6,335,263,72,650562,Херсонська область
24227,650563,592,5,320,259,61,650563,Херсонська область
24228,650564,1491,15,803,700,103,650564,Херсонська область
24229,650565,1775,19,1014,880,134,650565,Херсонська область
24230,650566,2057,10,1258,1104,154,650566,Херсонська область
24231,650567,2061,24,1296,1134,162,650567,Херсонська область
24232,650568,1651,23,1006,866,140,650568,Херсонська область
24233,650569,1892,24,1200,1025,175,650569,Херсонська область
24234,650570,1808,26,1127,952,175,650570,Херсонська область
24235,650571,1207,12,721,628,93,650571,Херсонська область
24236,650572,1429,12,827,712,115,650572,Херсонська область
24237,650573,1975,17,1115,1000,115,650573,Херсонська область
24238,650575,1990,24,1096,950,146,650575,Херсонська область
24239,650576,2006,43,1284,1090,194,650576,Херсонська область
24240,650577,1975,22,1162,995,167,650577,Херсонська область
24241,650578,1840,24,1173,1014,159,650578,Херсонська область
24242,650580,1876,26,1209,1053,156,650580,Херсонська область
24243,650581,194,10,171,104,67,650581,Херсонська область
24244,650582,96,0,88,81,7,650582,Херсонська область
24245,650583,17,0,15,12,3,650583,Херсонська область
24246,650235,2149,17,1230,1054,176,650235,Херсонська область
24247,650236,1092,15,608,539,69,650236,Херсонська область
24248,650237,2134,16,1213,1054,159,650237,Херсонська область
24249,650238,2104,20,1250,1073,177,650238,Херсонська область
24250,650239,1585,8,854,748,106,650239,Херсонська область
24251,650240,1665,13,927,793,134,650240,Херсонська область
24252,650241,1908,13,1046,922,124,650241,Херсонська область
24253,650242,202,4,169,141,28,650242,Херсонська область
24254,650243,120,0,66,60,6,650243,Херсонська область
24255,650244,1017,4,531,468,63,650244,Херсонська область
24256,650245,800,7,465,386,79,650245,Херсонська область
24257,650246,870,4,439,384,55,650246,Херсонська область
24258,650247,392,2,218,197,21,650247,Херсонська область
24259,650248,388,3,223,191,32,650248,Херсонська область
24260,650249,1831,14,866,707,159,650249,Херсонська область
24261,650250,103,0,60,49,11,650250,Херсонська область
24262,650251,1541,14,706,549,157,650251,Херсонська область
24263,650252,721,8,372,294,78,650252,Херсонська область
24264,650253,762,2,421,338,83,650253,Херсонська область
24265,650254,682,12,358,311,47,650254,Херсонська область
24266,650255,286,3,200,152,48,650255,Херсонська область
24267,650256,1609,16,854,749,105,650256,Херсонська область
24268,650257,2315,16,1135,1020,115,650257,Херсонська область
24269,650258,1706,9,876,801,75,650258,Херсонська область
24270,650259,1444,12,697,600,97,650259,Херсонська область
24271,650260,693,5,400,324,76,650260,Херсонська область
24272,650261,1362,14,688,559,129,650261,Херсонська область
24273,650262,1118,7,579,439,140,650262,Херсонська область
24274,650263,1043,17,515,386,129,650263,Херсонська область
24275,650264,175,0,103,78,25,650264,Херсонська область
24276,650265,756,7,338,248,90,650265,Херсонська область
24277,650266,216,3,137,120,17,650266,Херсонська область
24278,650267,224,1,124,107,17,650267,Херсонська область
24279,650268,917,4,442,372,70,650268,Херсонська область
24280,650269,671,8,346,256,90,650269,Херсонська область
24281,650270,93,0,68,58,10,650270,Херсонська область
24282,650271,347,3,238,207,31,650271,Херсонська область
24283,650272,97,2,61,49,12,650272,Херсонська область
24284,650273,901,7,526,428,98,650273,Херсонська область
24285,650274,241,2,129,121,8,650274,Херсонська область
24286,650275,697,5,366,263,103,650275,Херсонська область
24287,650276,326,5,156,118,38,650276,Херсонська область
24288,650277,151,1,91,71,20,650277,Херсонська область
24289,650278,870,8,478,418,60,650278,Херсонська область
24290,650279,225,1,135,122,13,650279,Херсонська область
24291,650280,165,0,101,81,20,650280,Херсонська область
24292,650281,703,7,377,282,95,650281,Херсонська область
24293,650282,802,3,402,340,62,650282,Херсонська область
24294,650283,276,0,186,164,22,650283,Херсонська область
24295,650284,2132,24,1126,970,156,650284,Херсонська область
24296,650285,1471,22,726,573,153,650285,Херсонська область
24297,650286,219,0,105,77,28,650286,Херсонська область
24298,650287,110,7,103,96,7,650287,Херсонська область
24299,650323,2400,27,1370,1058,312,650323,Херсонська область
24300,650324,2022,23,1141,942,199,650324,Херсонська область
24301,650325,2296,32,1274,1087,187,650325,Херсонська область
24302,650326,1628,25,928,775,153,650326,Херсонська область
24303,650327,1119,17,573,483,90,650327,Херсонська область
24304,650328,499,8,284,254,30,650328,Херсонська область
24305,650329,912,12,663,617,46,650329,Херсонська область
24306,650330,1489,13,812,728,84,650330,Херсонська область
24307,650331,885,6,524,492,32,650331,Херсонська область
24308,650332,684,4,428,404,24,650332,Херсонська область
24309,650333,323,3,188,171,17,650333,Херсонська область
24310,650334,474,1,253,179,74,650334,Херсонська область
24311,650335,423,1,231,188,43,650335,Херсонська область
24312,650336,886,6,494,423,71,650336,Херсонська область
24313,650337,418,3,267,238,29,650337,Херсонська область
24314,650338,1141,5,626,537,89,650338,Херсонська область
24315,650339,378,3,200,173,27,650339,Херсонська область
24316,650340,260,4,126,88,38,650340,Херсонська область
24317,650456,1682,24,881,762,119,650456,Херсонська область
24318,650457,1545,9,854,749,105,650457,Херсонська область
24319,650458,1964,33,1176,1024,152,650458,Херсонська область
24320,650459,1910,30,1055,935,120,650459,Херсонська область
24321,650460,2207,29,1235,1098,137,650460,Херсонська область
24322,650461,2125,26,1195,1048,147,650461,Херсонська область
24323,650462,1738,25,999,891,108,650462,Херсонська область
24324,650463,1905,22,1130,986,144,650463,Херсонська область
24325,650464,1479,25,867,780,87,650464,Херсонська область
24326,650465,1386,20,687,578,109,650465,Херсонська область
24327,650466,2032,6,985,862,123,650466,Херсонська область
24328,650467,2343,21,1321,1149,172,650467,Херсонська область
24329,650468,1455,18,831,722,109,650468,Херсонська область
24330,650469,463,3,196,174,22,650469,Херсонська область
24331,650470,1328,18,699,544,155,650470,Херсонська область
24332,650471,1267,9,636,508,128,650471,Херсонська область
24333,650472,1161,10,638,604,34,650472,Херсонська область
24334,650473,924,8,468,402,66,650473,Херсонська область
24335,650474,227,7,116,97,19,650474,Херсонська область
24336,650475,1065,11,577,505,72,650475,Херсонська область
24337,650476,371,2,177,156,21,650476,Херсонська область
24338,650477,840,4,391,359,32,650477,Херсонська область
24339,650478,206,6,117,95,22,650478,Херсонська область
24340,650479,701,8,393,360,33,650479,Херсонська область
24341,650480,434,4,241,210,31,650480,Херсонська область
24342,650482,826,7,475,408,67,650482,Херсонська область
24343,650484,944,5,488,427,61,650484,Херсонська область
24344,650485,1367,9,719,639,80,650485,Херсонська область
24345,650486,2194,31,1275,990,285,650486,Херсонська область
24346,650487,1230,16,703,580,123,650487,Херсонська область
24347,650488,1811,22,943,798,145,650488,Херсонська область
24348,650489,1729,18,897,740,157,650489,Херсонська область
24349,650490,1496,14,866,686,180,650490,Херсонська область
24350,650491,976,5,538,453,85,650491,Херсонська область
24351,650492,1936,17,1086,888,198,650492,Херсонська область
24352,650493,1404,27,832,695,137,650493,Херсонська область
24353,650494,2025,33,1132,963,169,650494,Херсонська область
24354,650495,1455,18,774,664,110,650495,Херсонська область
24355,650496,1215,16,770,645,125,650496,Херсонська область
24356,650497,664,9,301,268,33,650497,Херсонська область
24357,650498,1122,7,677,576,101,650498,Херсонська область
24358,650499,327,3,184,161,23,650499,Херсонська область
24359,650500,728,6,408,341,67,650500,Херсонська область
24360,650501,440,3,240,212,28,650501,Херсонська область
24361,650502,416,5,238,186,52,650502,Херсонська область
24362,650503,467,5,258,241,17,650503,Херсонська область
24363,650504,382,3,246,213,33,650504,Херсонська область
24364,650505,1569,4,828,669,159,650505,Херсонська область
24365,650506,1359,10,778,674,104,650506,Херсонська область
24366,650507,457,2,259,222,37,650507,Херсонська область
24367,650508,1026,5,549,438,111,650508,Херсонська область
24368,650509,1251,6,683,607,76,650509,Херсонська область
24369,650510,2076,10,1032,916,116,650510,Херсонська область
24370,650511,316,4,164,134,30,650511,Херсонська область
24371,650512,855,7,423,383,40,650512,Херсонська область
24372,650513,613,2,339,315,24,650513,Херсонська область
24373,650514,847,3,387,351,36,650514,Херсонська область
24374,650515,703,0,391,374,17,650515,Херсонська область
24375,650516,1014,4,504,459,45,650516,Херсонська область
24376,650517,1015,2,511,485,26,650517,Херсонська область
24377,650518,946,10,490,413,77,650518,Херсонська область
24378,650519,2172,22,1140,1005,135,650519,Херсонська область
24379,650520,2073,14,966,840,126,650520,Херсонська область
24380,650521,278,4,165,129,36,650521,Херсонська область
24381,650522,1661,7,928,860,68,650522,Херсонська область
24382,650523,1607,7,913,840,73,650523,Херсонська область
24383,650525,1271,7,712,638,74,650525,Херсонська область
24384,650526,750,3,373,326,47,650526,Херсонська область
24385,650527,1429,10,676,561,115,650527,Херсонська область
24386,650528,1454,11,783,712,71,650528,Херсонська область
24387,650529,422,7,266,239,27,650529,Херсонська область
24388,650530,389,3,213,191,22,650530,Херсонська область
24389,650531,1193,3,623,571,52,650531,Херсонська область
24390,650532,1139,7,642,530,112,650532,Херсонська область
24391,650533,112,0,60,57,3,650533,Херсонська область
24392,650539,924,7,354,317,37,650539,Херсонська область
24393,650541,1028,11,483,416,67,650541,Херсонська область
24394,650542,682,7,377,325,52,650542,Херсонська область
24395,650543,692,11,326,290,36,650543,Херсонська область
24396,650547,1068,9,568,548,20,650547,Херсонська область
24397,650549,915,2,449,401,48,650549,Херсонська область
24398,650550,940,3,438,351,87,650550,Херсонська область
24399,650551,1274,12,589,512,77,650551,Херсонська область
24400,650552,622,8,275,216,59,650552,Херсонська область
24401,650553,725,5,321,283,38,650553,Херсонська область
24402,650554,817,10,440,402,38,650554,Херсонська область
24403,650555,1247,7,635,563,72,650555,Херсонська область
24404,650556,1719,16,980,853,127,650556,Херсонська область
24405,650557,1627,14,961,845,116,650557,Херсонська область
24406,650558,1616,12,873,776,97,650558,Херсонська область
24407,650559,1523,18,804,721,83,650559,Херсонська область
24408,650560,1386,6,763,675,88,650560,Херсонська область
24409,650561,194,1,121,97,24,650561,Херсонська область
24410,1,477,62,409,378,31,1,Хмельницька область
24411,681455,1134,10,712,529,183,681455,Хмельницька область
24412,681456,1907,38,1097,873,224,681456,Хмельницька область
24413,681457,1448,29,859,664,195,681457,Хмельницька область
24414,681458,1482,26,926,695,231,681458,Хмельницька область
24415,681459,2010,38,1194,902,292,681459,Хмельницька область
24416,681460,1986,41,1256,921,335,681460,Хмельницька область
24417,681461,2354,37,1594,1132,462,681461,Хмельницька область
24418,681462,2186,43,1393,1056,337,681462,Хмельницька область
24419,681463,1349,25,852,660,192,681463,Хмельницька область
24420,681464,1753,33,1130,792,338,681464,Хмельницька область
24421,681465,2313,53,1506,1040,466,681465,Хмельницька область
24422,681466,2101,46,1328,1022,306,681466,Хмельницька область
24423,681467,2134,27,1357,973,384,681467,Хмельницька область
24424,681468,2333,37,1457,1052,405,681468,Хмельницька область
24425,681469,2211,46,1400,1006,394,681469,Хмельницька область
24426,681470,2362,22,1522,1099,423,681470,Хмельницька область
24427,681471,1662,36,1010,737,273,681471,Хмельницька область
24428,681472,2196,39,1427,1013,414,681472,Хмельницька область
24429,681473,1836,34,1113,832,281,681473,Хмельницька область
24430,681474,1908,29,1152,850,302,681474,Хмельницька область
24431,681475,1516,34,881,624,257,681475,Хмельницька область
24432,681476,1707,36,1067,769,298,681476,Хмельницька область
24433,681477,2181,25,1072,814,258,681477,Хмельницька область
24434,681478,2091,50,1329,917,412,681478,Хмельницька область
24435,681479,1988,28,1143,873,270,681479,Хмельницька область
24436,681480,2013,27,1264,934,330,681480,Хмельницька область
24437,681481,1891,32,1159,861,298,681481,Хмельницька область
24438,681482,2324,37,1500,1079,421,681482,Хмельницька область
24439,681483,1945,31,1246,905,341,681483,Хмельницька область
24440,681484,1851,37,1172,845,327,681484,Хмельницька область
24441,681485,1591,36,985,720,265,681485,Хмельницька область
24442,681486,1924,40,1237,859,378,681486,Хмельницька область
24443,681487,2058,42,1289,868,421,681487,Хмельницька область
24444,681488,1193,32,783,540,243,681488,Хмельницька область
24445,681489,2112,43,1325,932,393,681489,Хмельницька область
24446,681490,1923,39,1247,861,386,681490,Хмельницька область
24447,681491,2094,44,1347,965,382,681491,Хмельницька область
24448,681492,2159,42,1372,1010,362,681492,Хмельницька область
24449,681493,2082,41,1375,956,419,681493,Хмельницька область
24450,681494,2223,35,1407,965,442,681494,Хмельницька область
24451,681495,2322,55,1615,1137,478,681495,Хмельницька область
24452,681496,1971,35,1242,859,383,681496,Хмельницька область
24453,681497,1798,43,1121,765,356,681497,Хмельницька область
24454,681498,2343,45,1394,946,448,681498,Хмельницька область
24455,681499,1692,34,1121,827,294,681499,Хмельницька область
24456,681500,2000,47,1258,962,296,681500,Хмельницька область
24457,681501,2103,46,1334,988,346,681501,Хмельницька область
24458,681502,1990,32,1286,927,359,681502,Хмельницька область
24459,681503,2316,33,1415,1014,401,681503,Хмельницька область
24460,681504,2094,26,1236,915,321,681504,Хмельницька область
24461,681505,2305,34,1421,1066,355,681505,Хмельницька область
24462,681506,2169,54,1418,1024,394,681506,Хмельницька область
24463,681507,2405,46,1601,1055,546,681507,Хмельницька область
24464,681508,2078,39,1385,948,437,681508,Хмельницька область
24465,681509,1804,29,1218,865,353,681509,Хмельницька область
24466,681510,2213,33,1413,1020,393,681510,Хмельницька область
24467,681511,2283,43,1426,1026,400,681511,Хмельницька область
24468,681512,2284,34,1517,1054,463,681512,Хмельницька область
24469,681513,2184,32,1306,974,332,681513,Хмельницька область
24470,681514,2085,35,1176,876,300,681514,Хмельницька область
24471,681515,2224,38,1480,1132,348,681515,Хмельницька область
24472,681516,2068,35,1293,961,332,681516,Хмельницька область
24473,681517,1935,46,1189,942,247,681517,Хмельницька область
24474,681518,2291,33,1455,978,477,681518,Хмельницька область
24475,681519,1805,34,1126,853,273,681519,Хмельницька область
24476,681520,2084,37,1359,1021,338,681520,Хмельницька область
24477,681521,1460,20,986,720,266,681521,Хмельницька область
24478,681522,1729,37,1049,804,245,681522,Хмельницька область
24479,681523,1537,16,1044,819,225,681523,Хмельницька область
24480,681524,20,0,15,10,5,681524,Хмельницька область
24481,681525,21,1,17,15,2,681525,Хмельницька область
24482,681526,129,3,104,88,16,681526,Хмельницька область
24483,681527,74,1,63,49,14,681527,Хмельницька область
24484,681528,4,0,4,2,2,681528,Хмельницька область
24485,681529,71,4,64,50,14,681529,Хмельницька область
24486,681530,17,1,16,14,2,681530,Хмельницька область
24487,681533,274,8,175,140,35,681533,Хмельницька область
24488,681535,4,0,4,3,1,681535,Хмельницька область
24489,681536,29,0,13,11,2,681536,Хмельницька область
24490,681560,1922,33,1318,935,383,681560,Хмельницька область
24491,681562,1636,30,994,794,200,681562,Хмельницька область
24492,680105,420,2,290,173,117,680105,Хмельницька область
24493,680106,328,5,214,169,45,680106,Хмельницька область
24494,680107,289,4,218,155,63,680107,Хмельницька область
24495,680108,100,5,66,47,19,680108,Хмельницька область
24496,680109,247,2,164,116,48,680109,Хмельницька область
24497,680110,194,1,150,100,50,680110,Хмельницька область
24498,680111,667,13,420,311,109,680111,Хмельницька область
24499,680112,124,2,86,57,29,680112,Хмельницька область
24500,680113,229,2,191,124,67,680113,Хмельницька область
24501,680114,734,7,516,372,144,680114,Хмельницька область
24502,680115,1949,36,1160,873,287,680115,Хмельницька область
24503,680116,1111,13,632,460,172,680116,Хмельницька область
24504,680117,2078,25,1207,926,281,680117,Хмельницька область
24505,680118,1438,20,824,657,167,680118,Хмельницька область
24506,680119,2335,39,1326,963,363,680119,Хмельницька область
24507,680120,2397,43,1327,991,336,680120,Хмельницька область
24508,680121,1999,31,1114,883,231,680121,Хмельницька область
24509,680122,2145,42,1171,906,265,680122,Хмельницька область
24510,680123,439,1,247,208,39,680123,Хмельницька область
24511,680124,441,6,293,217,76,680124,Хмельницька область
24512,680125,294,4,189,142,47,680125,Хмельницька область
24513,680126,301,4,197,139,58,680126,Хмельницька область
24514,680127,405,8,279,222,57,680127,Хмельницька область
24515,680128,284,7,174,134,40,680128,Хмельницька область
24516,680129,132,2,108,61,47,680129,Хмельницька область
24517,680130,176,6,136,98,38,680130,Хмельницька область
24518,680131,349,7,254,199,55,680131,Хмельницька область
24519,680132,433,3,312,246,66,680132,Хмельницька область
24520,680133,656,11,433,343,90,680133,Хмельницька область
24521,680134,528,10,392,297,95,680134,Хмельницька область
24522,680135,267,2,172,133,39,680135,Хмельницька область
24523,680136,1206,16,751,578,173,680136,Хмельницька область
24524,680137,636,5,380,301,79,680137,Хмельницька область
24525,680138,670,4,447,373,74,680138,Хмельницька область
24526,680139,303,2,190,143,47,680139,Хмельницька область
24527,680140,513,4,350,225,125,680140,Хмельницька область
24528,680141,192,1,136,95,41,680141,Хмельницька область
24529,680142,433,7,297,237,60,680142,Хмельницька область
24530,680143,557,7,373,305,68,680143,Хмельницька область
24531,680144,1136,21,728,465,263,680144,Хмельницька область
24532,680145,748,7,443,314,129,680145,Хмельницька область
24533,680146,140,1,93,73,20,680146,Хмельницька область
24534,680147,173,1,116,88,28,680147,Хмельницька область
24535,680148,347,5,213,165,48,680148,Хмельницька область
24536,680149,195,4,119,84,35,680149,Хмельницька область
24537,680150,56,1,39,30,9,680150,Хмельницька область
24538,680151,306,4,194,151,43,680151,Хмельницька область
24539,680152,95,2,60,34,26,680152,Хмельницька область
24540,680153,209,4,121,80,41,680153,Хмельницька область
24541,680154,68,0,46,27,19,680154,Хмельницька область
24542,680155,1263,19,802,547,255,680155,Хмельницька область
24543,680156,639,10,369,286,83,680156,Хмельницька область
24544,680157,167,2,114,74,40,680157,Хмельницька область
24545,680158,71,0,59,45,14,680158,Хмельницька область
24546,680159,300,0,267,215,52,680159,Хмельницька область
24547,680160,136,5,108,91,17,680160,Хмельницька область
24548,680161,85,1,67,52,15,680161,Хмельницька область
24549,680162,348,2,227,155,72,680162,Хмельницька область
24550,680163,256,1,189,140,49,680163,Хмельницька область
24551,680164,80,0,62,47,15,680164,Хмельницька область
24552,680165,243,3,177,126,51,680165,Хмельницька область
24553,680166,106,2,88,74,14,680166,Хмельницька область
24554,680167,709,5,457,386,71,680167,Хмельницька область
24555,680168,408,4,262,219,43,680168,Хмельницька область
24556,680169,61,1,42,29,13,680169,Хмельницька область
24557,680170,405,9,264,192,72,680170,Хмельницька область
24558,680171,191,3,110,72,38,680171,Хмельницька область
24559,680172,159,1,118,86,32,680172,Хмельницька область
24560,680173,367,3,280,231,49,680173,Хмельницька область
24561,680174,317,6,211,171,40,680174,Хмельницька область
24562,680175,357,6,265,204,61,680175,Хмельницька область
24563,680176,248,1,201,146,55,680176,Хмельницька область
24564,680177,215,5,148,111,37,680177,Хмельницька область
24565,680178,275,2,151,97,54,680178,Хмельницька область
24566,680179,209,3,144,88,56,680179,Хмельницька область
24567,680180,437,7,279,211,68,680180,Хмельницька область
24568,680181,62,1,43,26,17,680181,Хмельницька область
24569,680182,236,0,173,129,44,680182,Хмельницька область
24570,680183,151,2,110,70,40,680183,Хмельницька область
24571,680184,536,7,324,234,90,680184,Хмельницька область
24572,680185,505,4,356,278,78,680185,Хмельницька область
24573,680186,364,6,280,185,95,680186,Хмельницька область
24574,681062,436,7,299,239,60,681062,Хмельницька область
24575,681063,356,8,219,171,48,681063,Хмельницька область
24576,681064,323,4,230,185,45,681064,Хмельницька область
24577,681065,447,1,293,219,74,681065,Хмельницька область
24578,681066,274,4,173,125,48,681066,Хмельницька область
24579,681067,1065,23,621,501,120,681067,Хмельницька область
24580,681068,282,3,182,143,39,681068,Хмельницька область
24581,681069,187,0,100,73,27,681069,Хмельницька область
24582,681070,161,0,99,60,39,681070,Хмельницька область
24583,681071,710,13,423,318,105,681071,Хмельницька область
24584,681072,352,5,221,160,61,681072,Хмельницька область
24585,681073,322,3,223,172,51,681073,Хмельницька область
24586,681074,1663,25,1021,716,305,681074,Хмельницька область
24587,681075,462,10,301,243,58,681075,Хмельницька область
24588,681076,345,2,190,101,89,681076,Хмельницька область
24589,681077,2375,25,1408,1040,368,681077,Хмельницька область
24590,681078,1542,20,934,717,217,681078,Хмельницька область
24591,681079,130,1,98,59,39,681079,Хмельницька область
24592,681080,443,9,317,223,94,681080,Хмельницька область
24593,681081,335,4,210,179,31,681081,Хмельницька область
24594,681082,523,7,314,241,73,681082,Хмельницька область
24595,681083,649,11,412,316,96,681083,Хмельницька область
24596,681084,513,8,333,235,98,681084,Хмельницька область
24597,681085,223,3,189,121,68,681085,Хмельницька область
24598,681086,304,2,208,155,53,681086,Хмельницька область
24599,681087,188,3,119,90,29,681087,Хмельницька область
24600,681088,391,6,244,194,50,681088,Хмельницька область
24601,681089,1063,16,668,548,120,681089,Хмельницька область
24602,681090,72,0,53,44,9,681090,Хмельницька область
24603,681091,132,1,89,43,46,681091,Хмельницька область
24604,681092,1997,13,1291,1033,258,681092,Хмельницька область
24605,681093,106,1,65,41,24,681093,Хмельницька область
24606,681094,449,7,257,172,85,681094,Хмельницька область
24607,681095,779,13,463,317,146,681095,Хмельницька область
24608,681096,121,2,71,47,24,681096,Хмельницька область
24609,681097,1321,16,766,553,213,681097,Хмельницька область
24610,681098,266,4,180,131,49,681098,Хмельницька область
24611,681099,659,16,439,313,126,681099,Хмельницька область
24612,681100,841,12,504,395,109,681100,Хмельницька область
24613,681101,232,2,142,93,49,681101,Хмельницька область
24614,681102,308,3,158,119,39,681102,Хмельницька область
24615,681103,76,0,60,32,28,681103,Хмельницька область
24616,681104,487,4,279,211,68,681104,Хмельницька область
24617,681105,289,3,172,134,38,681105,Хмельницька область
24618,681106,1950,19,1307,1015,292,681106,Хмельницька область
24619,681107,101,2,72,45,27,681107,Хмельницька область
24620,681108,702,11,420,307,113,681108,Хмельницька область
24621,681109,644,6,355,268,87,681109,Хмельницька область
24622,681110,387,8,256,207,49,681110,Хмельницька область
24623,681111,356,6,261,192,69,681111,Хмельницька область
24624,681112,298,2,169,129,40,681112,Хмельницька область
24625,681113,1045,30,737,604,133,681113,Хмельницька область
24626,681114,165,2,129,96,33,681114,Хмельницька область
24627,681115,1134,17,704,535,169,681115,Хмельницька область
24628,681116,187,0,151,106,45,681116,Хмельницька область
24629,681117,388,8,264,160,104,681117,Хмельницька область
24630,681118,484,5,283,190,93,681118,Хмельницька область
24631,681119,1010,17,594,487,107,681119,Хмельницька область
24632,681120,1182,20,714,513,201,681120,Хмельницька область
24633,681121,172,1,124,88,36,681121,Хмельницька область
24634,681122,311,0,214,174,40,681122,Хмельницька область
24635,681123,887,6,575,424,151,681123,Хмельницька область
24636,681124,429,3,254,202,52,681124,Хмельницька область
24637,681125,96,0,96,60,36,681125,Хмельницька область
24638,681126,186,1,117,73,44,681126,Хмельницька область
24639,681127,251,1,149,85,64,681127,Хмельницька область
24640,681128,77,0,56,38,18,681128,Хмельницька область
24641,681129,367,1,216,156,60,681129,Хмельницька область
24642,681130,255,2,177,91,86,681130,Хмельницька область
24643,681131,656,6,373,285,88,681131,Хмельницька область
24644,681132,1802,25,1113,876,237,681132,Хмельницька область
24645,681133,313,7,198,133,65,681133,Хмельницька область
24646,681134,488,6,307,235,72,681134,Хмельницька область
24647,681135,22,1,20,18,2,681135,Хмельницька область
24648,681136,128,6,121,86,35,681136,Хмельницька область
24649,681137,44,2,37,30,7,681137,Хмельницька область
24650,681138,562,35,527,498,29,681138,Хмельницька область
24651,681427,1882,29,1115,795,320,681427,Хмельницька область
24652,681428,2350,32,1508,1103,405,681428,Хмельницька область
24653,681429,2413,59,1586,1134,452,681429,Хмельницька область
24654,681430,2270,49,1465,1048,417,681430,Хмельницька область
24655,681431,2326,36,1496,1090,406,681431,Хмельницька область
24656,681432,2168,34,1278,954,324,681432,Хмельницька область
24657,681433,2208,26,1291,974,317,681433,Хмельницька область
24658,681434,2405,37,1538,1079,459,681434,Хмельницька область
24659,681435,2098,37,1277,917,360,681435,Хмельницька область
24660,681436,1321,31,796,555,241,681436,Хмельницька область
24661,681437,1836,34,1141,821,320,681437,Хмельницька область
24662,681438,1915,35,1204,870,334,681438,Хмельницька область
24663,681439,2170,31,1309,930,379,681439,Хмельницька область
24664,681440,2234,42,1280,997,283,681440,Хмельницька область
24665,681441,1824,43,1159,821,338,681441,Хмельницька область
24666,681442,1735,24,1156,836,320,681442,Хмельницька область
24667,681443,2438,31,1602,1168,434,681443,Хмельницька область
24668,681444,2566,50,1698,1222,476,681444,Хмельницька область
24669,681445,2240,38,1434,1052,382,681445,Хмельницька область
24670,681446,2522,30,1553,1088,465,681446,Хмельницька область
24671,681447,1558,18,1025,715,310,681447,Хмельницька область
24672,681448,1762,25,1134,812,322,681448,Хмельницька область
24673,681449,2352,47,1477,1059,418,681449,Хмельницька область
24674,681450,1995,37,1351,916,435,681450,Хмельницька область
24675,681451,2013,37,1277,921,356,681451,Хмельницька область
24676,681452,2293,28,1443,1020,423,681452,Хмельницька область
24677,681453,2051,32,1295,940,355,681453,Хмельницька область
24678,681454,2511,38,1546,1138,408,681454,Хмельницька область
24679,681559,2042,41,1331,945,386,681559,Хмельницька область
24680,681563,2485,29,1631,1225,406,681563,Хмельницька область
24681,681565,1482,17,948,654,294,681565,Хмельницька область
24682,681566,1405,21,890,669,221,681566,Хмельницька область
24683,680001,1101,7,663,476,187,680001,Хмельницька область
24684,680002,2191,33,1287,982,305,680002,Хмельницька область
24685,680003,1016,8,588,501,87,680003,Хмельницька область
24686,680004,252,2,150,134,16,680004,Хмельницька область
24687,680005,148,1,97,76,21,680005,Хмельницька область
24688,680006,270,2,178,127,51,680006,Хмельницька область
24689,680007,56,4,30,21,9,680007,Хмельницька область
24690,680008,254,0,126,78,48,680008,Хмельницька область
24691,680010,221,1,145,96,49,680010,Хмельницька область
24692,680011,196,2,125,88,37,680011,Хмельницька область
24693,680012,282,0,172,145,27,680012,Хмельницька область
24694,680013,227,4,152,114,38,680013,Хмельницька область
24695,680014,206,3,134,104,30,680014,Хмельницька область
24696,680015,702,6,514,407,107,680015,Хмельницька область
24697,680017,502,7,307,242,65,680017,Хмельницька область
24698,680019,140,1,84,64,20,680019,Хмельницька область
24699,680020,288,1,240,184,56,680020,Хмельницька область
24700,680021,216,2,161,106,55,680021,Хмельницька область
24701,680022,79,1,63,43,20,680022,Хмельницька область
24702,680023,368,13,211,160,51,680023,Хмельницька область
24703,680024,798,6,440,296,144,680024,Хмельницька область
24704,680027,178,1,104,79,25,680027,Хмельницька область
24705,680028,66,1,38,21,17,680028,Хмельницька область
24706,680029,74,0,48,35,13,680029,Хмельницька область
24707,680030,260,4,211,128,83,680030,Хмельницька область
24708,680031,371,2,289,246,43,680031,Хмельницька область
24709,680032,188,0,157,109,48,680032,Хмельницька область
24710,680033,292,4,182,123,59,680033,Хмельницька область
24711,680035,146,1,93,60,33,680035,Хмельницька область
24712,680036,297,1,189,138,51,680036,Хмельницька область
24713,680037,56,0,32,16,16,680037,Хмельницька область
24714,680038,183,6,121,102,19,680038,Хмельницька область
24715,680039,155,0,107,82,25,680039,Хмельницька область
24716,680040,164,1,101,66,35,680040,Хмельницька область
24717,680041,325,6,208,178,30,680041,Хмельницька область
24718,680042,563,6,359,265,94,680042,Хмельницька область
24719,680043,487,4,358,286,72,680043,Хмельницька область
24720,680044,330,1,220,190,30,680044,Хмельницька область
24721,680045,450,8,276,213,63,680045,Хмельницька область
24722,680046,137,0,85,51,34,680046,Хмельницька область
24723,680048,436,2,293,217,76,680048,Хмельницька область
24724,680049,274,4,188,144,44,680049,Хмельницька область
24725,680050,115,1,84,61,23,680050,Хмельницька область
24726,680051,327,4,181,119,62,680051,Хмельницька область
24727,680052,379,3,245,186,59,680052,Хмельницька область
24728,680054,228,4,146,108,38,680054,Хмельницька область
24729,680055,80,1,61,39,22,680055,Хмельницька область
24730,680056,454,2,308,235,73,680056,Хмельницька область
24731,680057,266,1,217,98,119,680057,Хмельницька область
24732,680058,167,1,116,74,42,680058,Хмельницька область
24733,680059,282,8,178,112,66,680059,Хмельницька область
24734,680060,249,3,155,108,47,680060,Хмельницька область
24735,680061,217,2,141,115,26,680061,Хмельницька область
24736,680062,1407,20,858,636,222,680062,Хмельницька область
24737,680063,466,11,347,254,93,680063,Хмельницька область
24738,680064,552,6,311,224,87,680064,Хмельницька область
24739,680065,427,13,342,261,81,680065,Хмельницька область
24740,680388,431,6,243,181,62,680388,Хмельницька область
24741,680389,371,4,230,164,66,680389,Хмельницька область
24742,680390,1134,18,684,438,246,680390,Хмельницька область
24743,680391,118,0,81,47,34,680391,Хмельницька область
24744,680392,118,5,79,42,37,680392,Хмельницька область
24745,680393,804,3,454,351,103,680393,Хмельницька область
24746,680394,63,0,46,17,29,680394,Хмельницька область
24747,680395,314,2,172,98,74,680395,Хмельницька область
24748,680396,334,6,215,158,57,680396,Хмельницька область
24749,680397,126,0,72,43,29,680397,Хмельницька область
24750,680398,164,1,109,61,48,680398,Хмельницька область
24751,680399,72,0,47,26,21,680399,Хмельницька область
24752,680401,168,3,94,73,21,680401,Хмельницька область
24753,680402,82,1,55,37,18,680402,Хмельницька область
24754,680403,73,1,40,22,18,680403,Хмельницька область
24755,680404,1098,21,642,411,231,680404,Хмельницька область
24756,680405,1767,33,957,675,282,680405,Хмельницька область
24757,680406,1372,15,773,562,211,680406,Хмельницька область
24758,680407,1580,21,894,677,217,680407,Хмельницька область
24759,680408,1204,11,702,503,199,680408,Хмельницька область
24760,680409,1356,19,780,524,256,680409,Хмельницька область
24761,680410,1781,35,963,725,238,680410,Хмельницька область
24762,680411,1216,21,631,488,143,680411,Хмельницька область
24763,680412,1384,19,711,539,172,680412,Хмельницька область
24764,680413,442,7,240,168,72,680413,Хмельницька область
24765,680414,388,4,254,122,132,680414,Хмельницька область
24766,680415,118,0,75,40,35,680415,Хмельницька область
24767,680416,241,3,145,100,45,680416,Хмельницька область
24768,680418,180,2,120,89,31,680418,Хмельницька область
24769,680419,322,4,248,195,53,680419,Хмельницька область
24770,680420,254,2,189,134,55,680420,Хмельницька область
24771,680421,633,3,349,283,66,680421,Хмельницька область
24772,680422,429,5,283,172,111,680422,Хмельницька область
24773,680423,283,4,180,128,52,680423,Хмельницька область
24774,680424,636,10,566,385,181,680424,Хмельницька область
24775,680425,153,4,130,82,48,680425,Хмельницька область
24776,680426,108,2,84,52,32,680426,Хмельницька область
24777,680427,779,10,452,243,209,680427,Хмельницька область
24778,680428,293,5,192,122,70,680428,Хмельницька область
24779,680429,238,4,157,102,55,680429,Хмельницька область
24780,680430,63,1,38,25,13,680430,Хмельницька область
24781,680431,542,7,270,188,82,680431,Хмельницька область
24782,680432,141,1,112,73,39,680432,Хмельницька область
24783,680433,1067,7,576,372,204,680433,Хмельницька область
24784,680434,859,7,494,352,142,680434,Хмельницька область
24785,680435,193,1,129,90,39,680435,Хмельницька область
24786,680436,439,2,264,97,167,680436,Хмельницька область
24787,680437,1085,10,650,460,190,680437,Хмельницька область
24788,680438,270,3,137,89,48,680438,Хмельницька область
24789,680439,437,5,236,146,90,680439,Хмельницька область
24790,680440,246,2,136,91,45,680440,Хмельницька область
24791,680441,188,1,109,77,32,680441,Хмельницька область
24792,680442,184,1,124,74,50,680442,Хмельницька область
24793,680443,305,7,198,150,48,680443,Хмельницька область
24794,680444,58,0,40,25,15,680444,Хмельницька область
24795,680445,355,0,198,142,56,680445,Хмельницька область
24796,680446,77,7,51,39,12,680446,Хмельницька область
24797,680447,121,3,83,50,33,680447,Хмельницька область
24798,680448,147,4,99,66,33,680448,Хмельницька область
24799,680449,276,6,191,137,54,680449,Хмельницька область
24800,680450,171,1,98,72,26,680450,Хмельницька область
24801,680451,165,0,81,48,33,680451,Хмельницька область
24802,680452,224,2,131,67,64,680452,Хмельницька область
24803,680453,199,2,133,92,41,680453,Хмельницька область
24804,680454,123,3,89,59,30,680454,Хмельницька область
24805,680455,308,4,249,163,86,680455,Хмельницька область
24806,680456,147,1,109,54,55,680456,Хмельницька область
24807,680457,335,2,208,138,70,680457,Хмельницька область
24808,680458,55,0,50,17,33,680458,Хмельницька область
24809,680459,324,4,196,116,80,680459,Хмельницька область
24810,680460,147,3,96,61,35,680460,Хмельницька область
24811,680461,156,0,122,80,42,680461,Хмельницька область
24812,680462,204,9,187,166,21,680462,Хмельницька область
24813,680463,107,4,101,91,10,680463,Хмельницька область
24814,680578,1647,26,917,720,197,680578,Хмельницька область
24815,680579,1434,20,813,647,166,680579,Хмельницька область
24816,680580,2188,43,1182,931,251,680580,Хмельницька область
24817,680581,2268,23,1348,1053,295,680581,Хмельницька область
24818,680582,1908,23,1137,948,189,680582,Хмельницька область
24819,680583,2037,32,1172,914,258,680583,Хмельницька область
24820,680584,1592,26,917,718,199,680584,Хмельницька область
24821,680585,1932,37,1087,882,205,680585,Хмельницька область
24822,680586,790,8,476,345,131,680586,Хмельницька область
24823,680587,921,12,546,438,108,680587,Хмельницька область
24824,680588,407,2,264,204,60,680588,Хмельницька область
24825,680589,164,3,120,84,36,680589,Хмельницька область
24826,680590,171,5,114,79,35,680590,Хмельницька область
24827,680591,166,2,109,76,33,680591,Хмельницька область
24828,680592,546,7,313,286,27,680592,Хмельницька область
24829,680593,216,2,134,117,17,680593,Хмельницька область
24830,680594,62,0,41,35,6,680594,Хмельницька область
24831,680595,221,0,148,117,31,680595,Хмельницька область
24832,680596,80,2,55,23,32,680596,Хмельницька область
24833,680597,392,4,251,210,41,680597,Хмельницька область
24834,680598,219,1,125,99,26,680598,Хмельницька область
24835,680599,300,3,179,144,35,680599,Хмельницька область
24836,680600,191,2,123,98,25,680600,Хмельницька область
24837,680601,58,0,32,19,13,680601,Хмельницька область
24838,680602,160,0,105,71,34,680602,Хмельницька область
24839,680603,588,5,425,303,122,680603,Хмельницька область
24840,680604,278,2,196,139,57,680604,Хмельницька область
24841,680605,242,6,140,112,28,680605,Хмельницька область
24842,680606,254,3,167,134,33,680606,Хмельницька область
24843,680607,198,3,148,110,38,680607,Хмельницька область
24844,680608,209,0,135,102,33,680608,Хмельницька область
24845,680609,136,4,93,72,21,680609,Хмельницька область
24846,680610,675,10,436,319,117,680610,Хмельницька область
24847,680611,601,6,349,275,74,680611,Хмельницька область
24848,680612,135,5,83,63,20,680612,Хмельницька область
24849,680613,960,15,574,472,102,680613,Хмельницька область
24850,680614,215,1,141,101,40,680614,Хмельницька область
24851,680615,432,2,307,239,68,680615,Хмельницька область
24852,680616,487,1,279,223,56,680616,Хмельницька область
24853,680617,241,2,145,130,15,680617,Хмельницька область
24854,680618,149,1,105,88,17,680618,Хмельницька область
24855,680619,1083,4,644,468,176,680619,Хмельницька область
24856,680620,127,1,91,63,28,680620,Хмельницька область
24857,680621,151,0,121,53,68,680621,Хмельницька область
24858,680622,157,0,99,81,18,680622,Хмельницька область
24859,680623,214,0,89,38,51,680623,Хмельницька область
24860,680624,113,3,75,46,29,680624,Хмельницька область
24861,680625,734,3,475,402,73,680625,Хмельницька область
24862,680626,633,7,404,348,56,680626,Хмельницька область
24863,680627,691,6,443,391,52,680627,Хмельницька область
24864,680628,508,5,334,241,93,680628,Хмельницька область
24865,680629,631,5,386,344,42,680629,Хмельницька область
24866,680630,132,0,100,56,44,680630,Хмельницька область
24867,680631,125,0,101,48,53,680631,Хмельницька область
24868,680632,93,0,61,45,16,680632,Хмельницька область
24869,680633,330,8,233,183,50,680633,Хмельницька область
24870,680634,357,5,252,220,32,680634,Хмельницька область
24871,680635,314,3,194,161,33,680635,Хмельницька область
24872,680636,171,1,96,72,24,680636,Хмельницька область
24873,680637,212,1,146,125,21,680637,Хмельницька область
24874,680638,407,6,268,223,45,680638,Хмельницька область
24875,680639,422,11,256,203,53,680639,Хмельницька область
24876,680640,232,0,161,114,47,680640,Хмельницька область
24877,680641,237,8,143,105,38,680641,Хмельницька область
24878,680642,82,1,77,48,29,680642,Хмельницька область
24879,680643,361,5,259,186,73,680643,Хмельницька область
24880,680644,298,1,205,152,53,680644,Хмельницька область
24881,680645,621,4,419,337,82,680645,Хмельницька область
24882,680646,479,2,250,181,69,680646,Хмельницька область
24883,680647,289,3,197,159,38,680647,Хмельницька область
24884,680648,94,3,61,40,21,680648,Хмельницька область
24885,680649,268,6,198,135,63,680649,Хмельницька область
24886,680650,217,3,151,88,63,680650,Хмельницька область
24887,680651,756,11,463,340,123,680651,Хмельницька область
24888,680652,711,7,379,320,59,680652,Хмельницька область
24889,680653,241,2,161,133,28,680653,Хмельницька область
24890,680654,108,0,81,61,20,680654,Хмельницька область
24891,680655,187,3,116,90,26,680655,Хмельницька область
24892,680656,575,6,384,315,69,680656,Хмельницька область
24893,680657,655,11,466,377,89,680657,Хмельницька область
24894,680658,187,1,143,104,39,680658,Хмельницька область
24895,680659,213,0,169,125,44,680659,Хмельницька область
24896,680660,477,10,305,261,44,680660,Хмельницька область
24897,680661,488,5,307,249,58,680661,Хмельницька область
24898,680662,35,1,31,23,8,680662,Хмельницька область
24899,680663,21,1,20,13,7,680663,Хмельницька область
24900,681012,1348,22,748,563,185,681012,Хмельницька область
24901,681013,231,1,195,161,34,681013,Хмельницька область
24902,681014,126,2,88,73,15,681014,Хмельницька область
24903,681015,284,1,158,94,64,681015,Хмельницька область
24904,681016,262,3,175,136,39,681016,Хмельницька область
24905,681017,113,2,81,65,16,681017,Хмельницька область
24906,681018,571,9,391,321,70,681018,Хмельницька область
24907,681019,558,7,370,294,76,681019,Хмельницька область
24908,681020,339,1,249,201,48,681020,Хмельницька область
24909,681021,142,0,111,98,13,681021,Хмельницька область
24910,681022,474,5,340,261,79,681022,Хмельницька область
24911,681023,90,0,81,59,22,681023,Хмельницька область
24912,681024,89,2,65,36,29,681024,Хмельницька область
24913,681025,196,2,153,106,47,681025,Хмельницька область
24914,681026,445,4,326,230,96,681026,Хмельницька область
24915,681027,157,1,115,71,44,681027,Хмельницька область
24916,681028,144,3,108,70,38,681028,Хмельницька область
24917,681029,202,2,142,98,44,681029,Хмельницька область
24918,681030,342,4,224,169,55,681030,Хмельницька область
24919,681031,375,5,263,205,58,681031,Хмельницька область
24920,681032,550,15,406,267,139,681032,Хмельницька область
24921,681033,155,1,124,98,26,681033,Хмельницька область
24922,681034,383,6,307,225,82,681034,Хмельницька область
24923,681036,273,1,201,116,85,681036,Хмельницька область
24924,681037,159,3,107,81,26,681037,Хмельницька область
24925,681038,313,3,217,175,42,681038,Хмельницька область
24926,681039,79,0,54,38,16,681039,Хмельницька область
24927,681040,474,5,319,246,73,681040,Хмельницька область
24928,681041,744,10,511,409,102,681041,Хмельницька область
24929,681042,544,2,377,307,70,681042,Хмельницька область
24930,681043,264,1,209,151,58,681043,Хмельницька область
24931,681044,220,1,156,124,32,681044,Хмельницька область
24932,681045,267,1,195,126,69,681045,Хмельницька область
24933,681046,274,3,198,106,92,681046,Хмельницька область
24934,681047,264,5,189,152,37,681047,Хмельницька область
24935,681048,736,8,516,355,161,681048,Хмельницька область
24936,681049,281,2,191,155,36,681049,Хмельницька область
24937,681050,1584,31,1136,842,294,681050,Хмельницька область
24938,681051,475,9,404,257,147,681051,Хмельницька область
24939,681052,212,2,163,105,58,681052,Хмельницька область
24940,681053,1926,26,1209,905,304,681053,Хмельницька область
24941,681054,1699,15,1093,793,300,681054,Хмельницька область
24942,681055,1740,28,1093,810,283,681055,Хмельницька область
24943,681056,262,6,218,178,40,681056,Хмельницька область
24944,681057,156,1,128,101,27,681057,Хмельницька область
24945,681058,514,7,368,298,70,681058,Хмельницька область
24946,681059,92,0,63,47,16,681059,Хмельницька область
24947,681060,555,5,374,254,120,681060,Хмельницька область
24948,681061,147,0,105,65,40,681061,Хмельницька область
24949,681375,1286,16,787,455,332,681375,Хмельницька область
24950,681376,1151,13,703,404,299,681376,Хмельницька область
24951,681377,1172,19,676,390,286,681377,Хмельницька область
24952,681378,2121,34,1332,752,580,681378,Хмельницька область
24953,681379,2087,34,1263,706,557,681379,Хмельницька область
24954,681380,2023,31,1259,679,580,681380,Хмельницька область
24955,681381,1688,22,1021,590,431,681381,Хмельницька область
24956,681382,1872,26,1089,646,443,681382,Хмельницька область
24957,681383,1762,34,1054,580,474,681383,Хмельницька область
24958,681384,2068,35,1299,770,529,681384,Хмельницька область
24959,681385,2396,47,1476,847,629,681385,Хмельницька область
24960,681386,1569,31,867,503,364,681386,Хмельницька область
24961,681387,1465,28,797,507,290,681387,Хмельницька область
24962,681388,1415,20,771,462,309,681388,Хмельницька область
24963,681389,817,9,444,287,157,681389,Хмельницька область
24964,681390,610,10,334,194,140,681390,Хмельницька область
24965,681561,122,0,75,59,16,681561,Хмельницька область
24966,1,11,0,11,10,1,1,Хмельницька область
24967,680772,314,9,187,143,44,680772,Хмельницька область
24968,680773,362,2,219,142,77,680773,Хмельницька область
24969,680774,185,1,129,60,69,680774,Хмельницька область
24970,680775,66,0,45,28,17,680775,Хмельницька область
24971,680776,618,0,319,231,88,680776,Хмельницька область
24972,680777,75,2,49,35,14,680777,Хмельницька область
24973,680779,811,9,455,306,149,680779,Хмельницька область
24974,680780,274,2,165,91,74,680780,Хмельницька область
24975,680781,237,9,149,85,64,680781,Хмельницька область
24976,680782,141,1,74,50,24,680782,Хмельницька область
24977,680783,284,2,193,134,59,680783,Хмельницька область
24978,680784,289,2,203,159,44,680784,Хмельницька область
24979,680785,435,7,254,158,96,680785,Хмельницька область
24980,680786,533,7,343,236,107,680786,Хмельницька область
24981,680787,177,1,124,104,20,680787,Хмельницька область
24982,680788,105,0,59,38,21,680788,Хмельницька область
24983,680789,623,7,340,242,98,680789,Хмельницька область
24984,680790,115,5,65,49,16,680790,Хмельницька область
24985,680791,120,2,88,65,23,680791,Хмельницька область
24986,680792,368,3,214,135,79,680792,Хмельницька область
24987,680793,550,11,283,172,111,680793,Хмельницька область
24988,680794,392,4,232,155,77,680794,Хмельницька область
24989,680795,297,1,171,109,62,680795,Хмельницька область
24990,680796,489,6,304,195,109,680796,Хмельницька область
24991,680797,1191,15,728,515,213,680797,Хмельницька область
24992,680798,1187,18,781,589,192,680798,Хмельницька область
24993,680799,135,1,86,56,30,680799,Хмельницька область
24994,680800,418,10,231,167,64,680800,Хмельницька область
24995,680801,2321,44,1274,968,306,680801,Хмельницька область
24996,680802,2371,39,1193,928,265,680802,Хмельницька область
24997,680803,2420,19,1320,983,337,680803,Хмельницька область
24998,680804,2397,34,1167,876,291,680804,Хмельницька область
24999,680805,1958,28,993,737,256,680805,Хмельницька область
25000,680806,1983,28,1091,809,282,680806,Хмельницька область
25001,680807,2056,29,1117,853,264,680807,Хмельницька область
25002,680808,1226,18,601,456,145,680808,Хмельницька область
25003,680809,255,1,155,104,51,680809,Хмельницька область
25004,680810,1259,18,637,468,169,680810,Хмельницька область
25005,680811,1152,22,587,451,136,680811,Хмельницька область
25006,680812,1285,14,658,512,146,680812,Хмельницька область
25007,680813,938,10,508,376,132,680813,Хмельницька область
25008,680814,422,5,200,179,21,680814,Хмельницька область
25009,680815,555,2,289,222,67,680815,Хмельницька область
25010,680816,124,2,72,55,17,680816,Хмельницька область
25011,680817,537,13,305,202,103,680817,Хмельницька область
25012,680819,249,1,185,136,49,680819,Хмельницька область
25013,680820,141,1,74,49,25,680820,Хмельницька область
25014,680821,175,0,129,81,48,680821,Хмельницька область
25015,680822,177,2,101,66,35,680822,Хмельницька область
25016,680823,351,8,194,131,63,680823,Хмельницька область
25017,680824,235,4,144,82,62,680824,Хмельницька область
25018,680825,963,11,516,369,147,680825,Хмельницька область
25019,680826,403,8,258,168,90,680826,Хмельницька область
25020,680827,331,2,209,154,55,680827,Хмельницька область
25021,680828,288,4,189,135,54,680828,Хмельницька область
25022,680829,304,7,186,118,68,680829,Хмельницька область
25023,680830,329,2,216,142,74,680830,Хмельницька область
25024,680831,214,1,160,96,64,680831,Хмельницька область
25025,680832,357,2,256,148,108,680832,Хмельницька область
25026,680833,244,2,145,86,59,680833,Хмельницька область
25027,680834,351,5,220,119,101,680834,Хмельницька область
25028,680835,876,9,491,271,220,680835,Хмельницька область
25029,680836,140,1,85,47,38,680836,Хмельницька область
25030,680837,129,1,81,61,20,680837,Хмельницька область
25031,680838,283,1,156,86,70,680838,Хмельницька область
25032,680839,413,2,259,161,98,680839,Хмельницька область
25033,680840,354,3,232,165,67,680840,Хмельницька область
25034,680841,277,1,186,115,71,680841,Хмельницька область
25035,680842,588,9,397,209,188,680842,Хмельницька область
25036,680843,279,4,180,118,62,680843,Хмельницька область
25037,680844,161,3,98,70,28,680844,Хмельницька область
25038,680845,414,5,263,153,110,680845,Хмельницька область
25039,680846,378,5,236,132,104,680846,Хмельницька область
25040,680847,115,1,64,34,30,680847,Хмельницька область
25041,680848,526,3,351,208,143,680848,Хмельницька область
25042,680849,464,7,288,204,84,680849,Хмельницька область
25043,680850,981,11,623,447,176,680850,Хмельницька область
25044,680851,326,3,202,147,55,680851,Хмельницька область
25045,680852,98,0,56,34,22,680852,Хмельницька область
25046,680853,312,8,192,110,82,680853,Хмельницька область
25047,680854,380,2,242,138,104,680854,Хмельницька область
25048,680855,593,6,399,271,128,680855,Хмельницька область
25049,680856,309,8,177,118,59,680856,Хмельницька область
25050,680857,232,1,182,113,69,680857,Хмельницька область
25051,680858,218,2,149,78,71,680858,Хмельницька область
25052,680859,648,10,339,205,134,680859,Хмельницька область
25053,680860,146,1,96,63,33,680860,Хмельницька область
25054,680861,101,2,67,48,19,680861,Хмельницька область
25055,680862,348,3,218,135,83,680862,Хмельницька область
25056,680863,242,3,184,107,77,680863,Хмельницька область
25057,680864,393,10,240,180,60,680864,Хмельницька область
25058,680865,113,1,78,51,27,680865,Хмельницька область
25059,680866,154,3,118,69,49,680866,Хмельницька область
25060,680867,366,9,262,158,104,680867,Хмельницька область
25061,680868,302,2,153,80,73,680868,Хмельницька область
25062,680869,338,8,226,118,108,680869,Хмельницька область
25063,680870,253,3,153,106,47,680870,Хмельницька область
25064,680871,317,6,202,114,88,680871,Хмельницька область
25065,680872,249,4,165,79,86,680872,Хмельницька область
25066,680873,179,3,142,94,48,680873,Хмельницька область
25067,680874,212,2,163,81,82,680874,Хмельницька область
25068,680875,1119,25,735,468,267,680875,Хмельницька область
25069,680876,179,2,111,76,35,680876,Хмельницька область
25070,680877,516,6,373,237,136,680877,Хмельницька область
25071,680878,1044,3,577,421,156,680878,Хмельницька область
25072,680879,130,2,106,60,46,680879,Хмельницька область
25073,680880,237,1,147,79,68,680880,Хмельницька область
25074,680881,277,1,166,88,78,680881,Хмельницька область
25075,680882,119,2,71,39,32,680882,Хмельницька область
25076,680883,123,1,85,42,43,680883,Хмельницька область
25077,680884,124,0,122,45,77,680884,Хмельницька область
25078,680885,348,3,207,112,95,680885,Хмельницька область
25079,680886,366,5,246,150,96,680886,Хмельницька область
25080,680887,376,5,225,171,54,680887,Хмельницька область
25081,680888,188,0,121,73,48,680888,Хмельницька область
25082,680889,1292,15,794,602,192,680889,Хмельницька область
25083,681204,442,5,257,178,79,681204,Хмельницька область
25084,681205,327,3,197,161,36,681205,Хмельницька область
25085,681206,307,6,181,102,79,681206,Хмельницька область
25086,681207,94,1,63,32,31,681207,Хмельницька область
25087,681208,91,0,63,33,30,681208,Хмельницька область
25088,681209,454,2,214,149,65,681209,Хмельницька область
25089,681210,388,4,181,115,66,681210,Хмельницька область
25090,681211,286,4,165,91,74,681211,Хмельницька область
25091,681212,338,2,186,126,60,681212,Хмельницька область
25092,681213,79,0,48,26,22,681213,Хмельницька область
25093,681214,174,0,108,65,43,681214,Хмельницька область
25094,681215,127,3,83,55,28,681215,Хмельницька область
25095,681216,352,4,193,137,56,681216,Хмельницька область
25096,681217,1330,37,776,531,245,681217,Хмельницька область
25097,681218,257,3,153,102,51,681218,Хмельницька область
25098,681219,306,3,191,153,38,681219,Хмельницька область
25099,681220,1390,10,782,592,190,681220,Хмельницька область
25100,681221,1108,13,658,466,192,681221,Хмельницька область
25101,681222,185,2,117,86,31,681222,Хмельницька область
25102,681223,500,2,300,196,104,681223,Хмельницька область
25103,681224,431,7,257,150,107,681224,Хмельницька область
25104,681225,245,3,150,87,63,681225,Хмельницька область
25105,681226,711,11,402,237,165,681226,Хмельницька область
25106,681227,299,2,245,186,59,681227,Хмельницька область
25107,681228,697,11,427,265,162,681228,Хмельницька область
25108,681229,501,8,311,184,127,681229,Хмельницька область
25109,681230,249,1,167,120,47,681230,Хмельницька область
25110,681231,121,2,66,35,31,681231,Хмельницька область
25111,681232,1072,13,529,409,120,681232,Хмельницька область
25112,681233,110,1,65,37,28,681233,Хмельницька область
25113,681234,228,1,141,112,29,681234,Хмельницька область
25114,681235,63,3,52,42,10,681235,Хмельницька область
25115,681236,17,0,10,7,3,681236,Хмельницька область
25116,681237,294,8,167,120,47,681237,Хмельницька область
25117,681238,56,0,36,22,14,681238,Хмельницька область
25118,681239,506,2,220,174,46,681239,Хмельницька область
25119,681240,675,12,386,229,157,681240,Хмельницька область
25120,681241,290,0,178,129,49,681241,Хмельницька область
25121,681242,761,8,433,300,133,681242,Хмельницька область
25122,681243,231,1,196,83,113,681243,Хмельницька область
25123,681244,149,4,101,64,37,681244,Хмельницька область
25124,681245,186,1,126,58,68,681245,Хмельницька область
25125,681246,73,2,49,25,24,681246,Хмельницька область
25126,681247,76,2,32,16,16,681247,Хмельницька область
25127,681248,124,2,83,37,46,681248,Хмельницька область
25128,681249,151,0,95,51,44,681249,Хмельницька область
25129,681250,86,1,50,23,27,681250,Хмельницька область
25130,681251,59,0,35,22,13,681251,Хмельницька область
25131,681252,510,10,318,194,124,681252,Хмельницька область
25132,681253,80,1,51,34,17,681253,Хмельницька область
25133,681254,1669,26,819,581,238,681254,Хмельницька область
25134,681255,1195,20,647,413,234,681255,Хмельницька область
25135,681256,722,8,358,241,117,681256,Хмельницька область
25136,681257,414,9,212,139,73,681257,Хмельницька область
25137,681258,185,1,108,81,27,681258,Хмельницька область
25138,681259,495,6,278,191,87,681259,Хмельницька область
25139,681260,136,0,83,57,26,681260,Хмельницька область
25140,681261,511,3,320,221,99,681261,Хмельницька область
25141,681262,363,6,215,132,83,681262,Хмельницька область
25142,681263,475,4,287,176,111,681263,Хмельницька область
25143,681264,97,1,67,29,38,681264,Хмельницька область
25144,681265,829,9,653,458,195,681265,Хмельницька область
25145,681266,485,40,442,408,34,681266,Хмельницька область
25146,681391,1026,18,579,444,135,681391,Хмельницька область
25147,681392,1227,16,658,489,169,681392,Хмельницька область
25148,681393,1114,14,604,497,107,681393,Хмельницька область
25149,681394,1115,18,605,444,161,681394,Хмельницька область
25150,681395,2190,31,1258,973,285,681395,Хмельницька область
25151,681396,2006,44,1128,873,255,681396,Хмельницька область
25152,681397,2029,23,1142,882,260,681397,Хмельницька область
25153,681398,1388,24,810,650,160,681398,Хмельницька область
25154,681399,2276,48,1345,1046,299,681399,Хмельницька область
25155,681400,1313,21,732,581,151,681400,Хмельницька область
25156,681401,1264,19,693,514,179,681401,Хмельницька область
25157,681402,1011,12,609,462,147,681402,Хмельницька область
25158,681403,2258,40,1229,966,263,681403,Хмельницька область
25159,681404,2011,39,1194,923,271,681404,Хмельницька область
25160,681405,1127,22,678,516,162,681405,Хмельницька область
25161,681406,1199,18,658,535,123,681406,Хмельницька область
25162,681407,1200,20,655,516,139,681407,Хмельницька область
25163,681408,48,1,35,28,7,681408,Хмельницька область
25164,681537,1294,16,662,525,137,681537,Хмельницька область
25165,681538,1402,23,626,469,157,681538,Хмельницька область
25166,681539,1788,38,1004,780,224,681539,Хмельницька область
25167,681540,2136,30,1193,921,272,681540,Хмельницька область
25168,681541,2270,36,1214,867,347,681541,Хмельницька область
25169,681542,2146,40,1229,900,329,681542,Хмельницька область
25170,681543,1629,29,885,634,251,681543,Хмельницька область
25171,681544,1846,25,957,707,250,681544,Хмельницька область
25172,681545,1677,24,957,695,262,681545,Хмельницька область
25173,681546,1650,32,881,629,252,681546,Хмельницька область
25174,681547,1797,23,997,788,209,681547,Хмельницька область
25175,681548,2027,39,1098,809,289,681548,Хмельницька область
25176,681549,1552,12,856,639,217,681549,Хмельницька область
25177,681550,2035,41,1113,799,314,681550,Хмельницька область
25178,681551,1624,24,860,622,238,681551,Хмельницька область
25179,681552,1925,33,971,727,244,681552,Хмельницька область
25180,681553,1709,25,908,669,239,681553,Хмельницька область
25181,681554,1566,26,823,612,211,681554,Хмельницька область
25182,681555,1625,20,857,630,227,681555,Хмельницька область
25183,681556,830,13,473,355,118,681556,Хмельницька область
25184,681557,62,2,53,45,8,681557,Хмельницька область
25185,681558,19,0,19,15,4,681558,Хмельницька область
25186,681564,162,2,88,71,17,681564,Хмельницька область
25187,680066,647,4,443,302,141,680066,Хмельницька область
25188,680067,1421,30,853,586,267,680067,Хмельницька область
25189,680068,1487,29,793,585,208,680068,Хмельницька область
25190,680069,907,17,513,367,146,680069,Хмельницька область
25191,680070,950,11,552,406,146,680070,Хмельницька область
25192,680071,108,0,60,47,13,680071,Хмельницька область
25193,680072,382,2,235,151,84,680072,Хмельницька область
25194,680073,606,7,362,268,94,680073,Хмельницька область
25195,680074,421,2,355,275,80,680074,Хмельницька область
25196,680075,144,2,83,56,27,680075,Хмельницька область
25197,680076,331,5,197,150,47,680076,Хмельницька область
25198,680077,257,9,153,85,68,680077,Хмельницька область
25199,680078,397,2,310,162,148,680078,Хмельницька область
25200,680079,870,7,495,367,128,680079,Хмельницька область
25201,680080,725,10,419,334,85,680080,Хмельницька область
25202,680081,181,1,142,99,43,680081,Хмельницька область
25203,680082,994,21,561,419,142,680082,Хмельницька область
25204,680083,167,0,121,68,53,680083,Хмельницька область
25205,680084,414,4,226,150,76,680084,Хмельницька область
25206,680085,411,5,220,130,90,680085,Хмельницька область
25207,680086,361,7,202,118,84,680086,Хмельницька область
25208,680087,122,0,70,52,18,680087,Хмельницька область
25209,680088,357,2,231,142,89,680088,Хмельницька область
25210,680089,68,0,50,26,24,680089,Хмельницька область
25211,680090,660,16,567,421,146,680090,Хмельницька область
25212,680091,58,0,50,23,27,680091,Хмельницька область
25213,680092,376,2,214,135,79,680092,Хмельницька область
25214,680093,327,3,200,163,37,680093,Хмельницька область
25215,680094,92,1,54,42,12,680094,Хмельницька область
25216,680095,858,8,534,397,137,680095,Хмельницька область
25217,680096,633,4,377,278,99,680096,Хмельницька область
25218,680097,614,8,367,274,93,680097,Хмельницька область
25219,680098,403,5,222,123,99,680098,Хмельницька область
25220,680099,274,6,127,107,20,680099,Хмельницька область
25221,680100,392,12,190,129,61,680100,Хмельницька область
25222,680101,583,5,353,241,112,680101,Хмельницька область
25223,680102,412,2,289,178,111,680102,Хмельницька область
25224,680103,367,7,231,171,60,680103,Хмельницька область
25225,680104,143,0,97,73,24,680104,Хмельницька область
25226,680257,641,5,426,321,105,680257,Хмельницька область
25227,680258,473,5,308,226,82,680258,Хмельницька область
25228,680259,337,5,216,141,75,680259,Хмельницька область
25229,680260,105,2,68,46,22,680260,Хмельницька область
25230,680261,978,15,526,382,144,680261,Хмельницька область
25231,680262,837,5,446,319,127,680262,Хмельницька область
25232,680263,129,1,67,39,28,680263,Хмельницька область
25233,680264,161,1,108,55,53,680264,Хмельницька область
25234,680265,414,3,264,204,60,680265,Хмельницька область
25235,680266,323,6,205,161,44,680266,Хмельницька область
25236,680267,324,11,173,97,76,680267,Хмельницька область
25237,680268,41,0,30,8,22,680268,Хмельницька область
25238,680269,258,3,164,106,58,680269,Хмельницька область
25239,680270,1432,22,825,620,205,680270,Хмельницька область
25240,680271,1289,22,752,583,169,680271,Хмельницька область
25241,680272,1290,21,694,510,184,680272,Хмельницька область
25242,680273,2130,27,1276,959,317,680273,Хмельницька область
25243,680274,1546,29,864,679,185,680274,Хмельницька область
25244,680275,442,7,324,239,85,680275,Хмельницька область
25245,680276,552,3,321,234,87,680276,Хмельницька область
25246,680277,267,7,150,94,56,680277,Хмельницька область
25247,680278,86,1,64,42,22,680278,Хмельницька область
25248,680279,420,2,274,162,112,680279,Хмельницька область
25249,680280,96,1,65,30,35,680280,Хмельницька область
25250,680281,110,3,81,45,36,680281,Хмельницька область
25251,680282,83,1,56,33,23,680282,Хмельницька область
25252,680283,576,8,394,274,120,680283,Хмельницька область
25253,680284,295,1,222,160,62,680284,Хмельницька область
25254,680285,497,9,292,191,101,680285,Хмельницька область
25255,680286,1060,15,644,478,166,680286,Хмельницька область
25256,680287,88,1,63,44,19,680287,Хмельницька область
25257,680288,442,2,379,284,95,680288,Хмельницька область
25258,680289,188,3,118,61,57,680289,Хмельницька область
25259,680290,103,2,72,27,45,680290,Хмельницька область
25260,680291,133,3,97,57,40,680291,Хмельницька область
25261,680292,787,9,500,397,103,680292,Хмельницька область
25262,680293,415,5,271,210,61,680293,Хмельницька область
25263,680294,196,1,140,89,51,680294,Хмельницька область
25264,680295,133,1,96,67,29,680295,Хмельницька область
25265,680296,331,7,218,156,62,680296,Хмельницька область
25266,680297,273,4,198,144,54,680297,Хмельницька область
25267,680298,135,1,95,53,42,680298,Хмельницька область
25268,680299,225,4,132,84,48,680299,Хмельницька область
25269,680300,553,1,317,222,95,680300,Хмельницька область
25270,680301,139,1,94,56,38,680301,Хмельницька область
25271,680302,513,5,330,280,50,680302,Хмельницька область
25272,680303,139,0,116,89,27,680303,Хмельницька область
25273,680304,376,8,252,206,46,680304,Хмельницька область
25274,680305,348,2,235,165,70,680305,Хмельницька область
25275,680306,246,3,161,119,42,680306,Хмельницька область
25276,680307,91,2,55,24,31,680307,Хмельницька область
25277,680308,237,6,141,91,50,680308,Хмельницька область
25278,680309,347,8,205,119,86,680309,Хмельницька область
25279,680310,401,4,287,148,139,680310,Хмельницька область
25280,680311,119,1,91,69,22,680311,Хмельницька область
25281,680312,203,1,92,58,34,680312,Хмельницька область
25282,680664,303,6,210,132,78,680664,Хмельницька область
25283,680665,432,3,280,134,146,680665,Хмельницька область
25284,680666,84,0,52,45,7,680666,Хмельницька область
25285,680667,148,3,115,50,65,680667,Хмельницька область
25286,680668,135,0,114,50,64,680668,Хмельницька область
25287,680669,908,10,608,434,174,680669,Хмельницька область
25288,680670,154,1,115,85,30,680670,Хмельницька область
25289,680671,275,3,182,126,56,680671,Хмельницька область
25290,680672,138,2,93,66,27,680672,Хмельницька область
25291,680673,397,7,267,153,114,680673,Хмельницька область
25292,680674,162,1,95,62,33,680674,Хмельницька область
25293,680675,400,6,219,135,84,680675,Хмельницька область
25294,680676,330,2,226,177,49,680676,Хмельницька область
25295,680677,384,10,270,182,88,680677,Хмельницька область
25296,680678,99,2,67,48,19,680678,Хмельницька область
25297,680679,171,1,126,76,50,680679,Хмельницька область
25298,680680,133,0,105,59,46,680680,Хмельницька область
25299,680681,1619,29,985,666,319,680681,Хмельницька область
25300,680682,1938,41,1160,779,381,680682,Хмельницька область
25301,680683,1797,31,1097,758,339,680683,Хмельницька область
25302,680684,1011,13,605,444,161,680684,Хмельницька область
25303,680685,452,4,290,206,84,680685,Хмельницька область
25304,680686,583,13,370,219,151,680686,Хмельницька область
25305,680687,781,13,465,336,129,680687,Хмельницька область
25306,680688,161,0,121,73,48,680688,Хмельницька область
25307,680689,82,0,71,47,24,680689,Хмельницька область
25308,680690,1034,14,614,432,182,680690,Хмельницька область
25309,680691,709,4,475,356,119,680691,Хмельницька область
25310,680692,315,6,227,152,75,680692,Хмельницька область
25311,680693,248,2,161,112,49,680693,Хмельницька область
25312,680694,125,5,86,44,42,680694,Хмельницька область
25313,680695,252,7,159,96,63,680695,Хмельницька область
25314,680696,175,0,105,39,66,680696,Хмельницька область
25315,680697,218,2,135,91,44,680697,Хмельницька область
25316,680698,69,0,46,30,16,680698,Хмельницька область
25317,680699,472,6,296,205,91,680699,Хмельницька область
25318,680700,78,2,54,22,32,680700,Хмельницька область
25319,680701,209,2,127,90,37,680701,Хмельницька область
25320,680702,404,1,329,156,173,680702,Хмельницька область
25321,680703,190,3,145,92,53,680703,Хмельницька область
25322,680704,983,12,583,418,165,680704,Хмельницька область
25323,680705,512,7,348,264,84,680705,Хмельницька область
25324,680706,671,10,426,259,167,680706,Хмельницька область
25325,680707,146,0,104,62,42,680707,Хмельницька область
25326,680708,168,2,123,55,68,680708,Хмельницька область
25327,680709,378,4,228,155,73,680709,Хмельницька область
25328,680710,226,4,153,106,47,680710,Хмельницька область
25329,680711,209,3,132,67,65,680711,Хмельницька область
25330,680712,433,4,294,211,83,680712,Хмельницька область
25331,680713,89,1,62,42,20,680713,Хмельницька область
25332,680715,414,5,263,207,56,680715,Хмельницька область
25333,680890,340,3,200,138,62,680890,Хмельницька область
25334,680892,271,7,163,112,51,680892,Хмельницька область
25335,680893,296,1,135,95,40,680893,Хмельницька область
25336,680896,279,2,164,109,55,680896,Хмельницька область
25337,680897,147,4,81,59,22,680897,Хмельницька область
25338,680898,451,8,291,184,107,680898,Хмельницька область
25339,680899,111,0,63,47,16,680899,Хмельницька область
25340,680901,153,0,87,53,34,680901,Хмельницька область
25341,680902,592,5,327,258,69,680902,Хмельницька область
25342,680903,408,9,239,167,72,680903,Хмельницька область
25343,680904,141,3,111,89,22,680904,Хмельницька область
25344,680905,316,2,168,131,37,680905,Хмельницька область
25345,680907,678,11,440,320,120,680907,Хмельницька область
25346,680908,495,6,333,209,124,680908,Хмельницька область
25347,680909,329,0,181,133,48,680909,Хмельницька область
25348,680910,135,2,104,74,30,680910,Хмельницька область
25349,680911,340,4,216,135,81,680911,Хмельницька область
25350,680912,859,7,540,394,146,680912,Хмельницька область
25351,680913,729,8,430,311,119,680913,Хмельницька область
25352,680914,319,2,201,114,87,680914,Хмельницька область
25353,680915,293,4,201,127,74,680915,Хмельницька область
25354,680917,337,1,223,151,72,680917,Хмельницька область
25355,680918,478,5,268,206,62,680918,Хмельницька область
25356,680919,285,6,160,113,47,680919,Хмельницька область
25357,680922,212,2,141,108,33,680922,Хмельницька область
25358,680923,351,7,220,149,71,680923,Хмельницька область
25359,680924,135,0,94,59,35,680924,Хмельницька область
25360,680925,697,1,420,329,91,680925,Хмельницька область
25361,680926,151,2,89,68,21,680926,Хмельницька область
25362,680927,354,5,228,174,54,680927,Хмельницька область
25363,680928,247,4,142,101,41,680928,Хмельницька область
25364,680929,253,2,124,65,59,680929,Хмельницька область
25365,680930,267,0,171,126,45,680930,Хмельницька область
25366,680931,253,2,156,131,25,680931,Хмельницька область
25367,680932,235,2,147,113,34,680932,Хмельницька область
25368,680933,277,1,171,117,54,680933,Хмельницька область
25369,680934,223,0,133,101,32,680934,Хмельницька область
25370,680936,89,0,50,35,15,680936,Хмельницька область
25371,680937,144,1,120,83,37,680937,Хмельницька область
25372,680938,237,2,149,110,39,680938,Хмельницька область
25373,680939,90,1,65,34,31,680939,Хмельницька область
25374,680940,918,13,570,391,179,680940,Хмельницька область
25375,680941,254,8,154,111,43,680941,Хмельницька область
25376,680942,434,31,275,192,83,680942,Хмельницька область
25377,680943,427,2,273,161,112,680943,Хмельницька область
25378,680944,282,2,208,94,114,680944,Хмельницька область
25379,680946,221,7,138,85,53,680946,Хмельницька область
25380,680947,446,4,283,226,57,680947,Хмельницька область
25381,680948,347,3,263,121,142,680948,Хмельницька область
25382,680949,1220,15,723,503,220,680949,Хмельницька область
25383,680950,331,6,192,120,72,680950,Хмельницька область
25384,680952,720,11,466,381,85,680952,Хмельницька область
25385,680953,739,11,467,355,112,680953,Хмельницька область
25386,680954,199,3,124,99,25,680954,Хмельницька область
25387,680955,519,5,277,224,53,680955,Хмельницька область
25388,680956,529,6,315,239,76,680956,Хмельницька область
25389,680957,217,7,131,71,60,680957,Хмельницька область
25390,680958,166,2,107,67,40,680958,Хмельницька область
25391,680960,556,10,352,258,94,680960,Хмельницька область
25392,680961,485,2,287,191,96,680961,Хмельницька область
25393,680962,355,0,222,178,44,680962,Хмельницька область
25394,680963,132,2,82,58,24,680963,Хмельницька область
25395,680964,432,1,287,176,111,680964,Хмельницька область
25396,680965,338,0,213,139,74,680965,Хмельницька область
25397,680966,656,5,427,334,93,680966,Хмельницька область
25398,680967,172,2,138,98,40,680967,Хмельницька область
25399,680968,135,0,90,73,17,680968,Хмельницька область
25400,680969,394,1,244,138,106,680969,Хмельницька область
25401,680970,81,3,50,38,12,680970,Хмельницька область
25402,680971,393,3,220,177,43,680971,Хмельницька область
25403,680972,115,0,77,65,12,680972,Хмельницька область
25404,680973,843,5,498,378,120,680973,Хмельницька область
25405,680974,129,2,82,44,38,680974,Хмельницька область
25406,680975,55,0,40,26,14,680975,Хмельницька область
25407,680976,134,3,66,48,18,680976,Хмельницька область
25408,680977,234,1,156,114,42,680977,Хмельницька область
25409,680978,153,3,98,63,35,680978,Хмельницька область
25410,680979,303,4,187,117,70,680979,Хмельницька область
25411,680980,69,2,47,26,21,680980,Хмельницька область
25412,680981,262,3,187,135,52,680981,Хмельницька область
25413,680982,324,1,226,150,76,680982,Хмельницька область
25414,680983,248,5,155,120,35,680983,Хмельницька область
25415,680984,788,14,504,306,198,680984,Хмельницька область
25416,680985,97,9,62,40,22,680985,Хмельницька область
25417,680986,177,1,144,100,44,680986,Хмельницька область
25418,680987,538,5,351,260,91,680987,Хмельницька область
25419,680988,103,1,68,21,47,680988,Хмельницька область
25420,680989,746,4,487,387,100,680989,Хмельницька область
25421,680990,371,12,266,195,71,680990,Хмельницька область
25422,680991,49,0,32,21,11,680991,Хмельницька область
25423,680992,385,13,215,162,53,680992,Хмельницька область
25424,680993,118,0,93,60,33,680993,Хмельницька область
25425,680994,384,6,269,166,103,680994,Хмельницька область
25426,680995,42,0,26,7,19,680995,Хмельницька область
25427,680996,302,5,199,116,83,680996,Хмельницька область
25428,680997,75,0,57,29,28,680997,Хмельницька область
25429,680998,201,2,135,88,47,680998,Хмельницька область
25430,680999,157,2,82,58,24,680999,Хмельницька область
25431,681000,146,2,93,62,31,681000,Хмельницька область
25432,681001,1129,16,616,482,134,681001,Хмельницька область
25433,681002,882,16,493,389,104,681002,Хмельницька область
25434,681003,1304,14,844,653,191,681003,Хмельницька область
25435,681004,864,12,495,401,94,681004,Хмельницька область
25436,681005,308,3,208,156,52,681005,Хмельницька область
25437,681006,290,1,187,106,81,681006,Хмельницька область
25438,681007,149,0,103,84,19,681007,Хмельницька область
25439,681008,232,1,180,116,64,681008,Хмельницька область
25440,681009,247,3,164,130,34,681009,Хмельницька область
25441,681010,297,1,223,170,53,681010,Хмельницька область
25442,681011,120,1,112,97,15,681011,Хмельницька область
25443,681409,2035,25,1106,833,273,681409,Хмельницька область
25444,681410,2200,35,1325,948,377,681410,Хмельницька область
25445,681411,1446,24,778,563,215,681411,Хмельницька область
25446,681412,1690,26,1031,706,325,681412,Хмельницька область
25447,681413,1623,30,1022,747,275,681413,Хмельницька область
25448,681414,1052,14,633,479,154,681414,Хмельницька область
25449,681415,1482,31,832,643,189,681415,Хмельницька область
25450,681416,1384,18,810,608,202,681416,Хмельницька область
25451,681417,2044,31,1154,911,243,681417,Хмельницька область
25452,681418,1280,26,753,612,141,681418,Хмельницька область
25453,681420,1808,39,1041,765,276,681420,Хмельницька область
25454,681421,1569,29,890,701,189,681421,Хмельницька область
25455,681422,1994,37,1169,903,266,681422,Хмельницька область
25456,681423,2145,22,1293,1033,260,681423,Хмельницька область
25457,681424,2018,26,1190,926,264,681424,Хмельницька область
25458,681425,674,12,418,332,86,681425,Хмельницька область
25459,681426,81,0,59,41,18,681426,Хмельницька область
25460,680187,1659,24,956,774,182,680187,Хмельницька область
25461,680188,1325,21,720,550,170,680188,Хмельницька область
25462,680189,1773,29,936,754,182,680189,Хмельницька область
25463,680190,1724,29,936,772,164,680190,Хмельницька область
25464,680191,1158,11,670,566,104,680191,Хмельницька область
25465,680192,1438,26,761,607,154,680192,Хмельницька область
25466,680193,1803,31,998,797,201,680193,Хмельницька область
25467,680194,1213,19,692,511,181,680194,Хмельницька область
25468,680195,1197,10,697,598,99,680195,Хмельницька область
25469,680196,1609,15,930,656,274,680196,Хмельницька область
25470,680197,106,2,74,47,27,680197,Хмельницька область
25471,680198,644,12,399,335,64,680198,Хмельницька область
25472,680199,312,3,223,186,37,680199,Хмельницька область
25473,680200,281,5,195,135,60,680200,Хмельницька область
25474,680201,165,0,106,89,17,680201,Хмельницька область
25475,680202,90,1,80,36,44,680202,Хмельницька область
25476,680203,284,3,211,121,90,680203,Хмельницька область
25477,680204,465,5,324,232,92,680204,Хмельницька область
25478,680205,115,0,105,50,55,680205,Хмельницька область
25479,680206,1002,9,607,471,136,680206,Хмельницька область
25480,680207,397,6,248,219,29,680207,Хмельницька область
25481,680208,297,3,235,159,76,680208,Хмельницька область
25482,680209,77,3,72,33,39,680209,Хмельницька область
25483,680210,709,15,352,294,58,680210,Хмельницька область
25484,680211,212,2,158,117,41,680211,Хмельницька область
25485,680212,924,11,567,446,121,680212,Хмельницька область
25486,680213,346,3,218,162,56,680213,Хмельницька область
25487,680214,217,5,135,110,25,680214,Хмельницька область
25488,680215,1488,14,802,643,159,680215,Хмельницька область
25489,680216,789,5,520,439,81,680216,Хмельницька область
25490,680217,462,8,282,240,42,680217,Хмельницька область
25491,680218,136,0,106,91,15,680218,Хмельницька область
25492,680219,433,2,309,212,97,680219,Хмельницька область
25493,680220,481,6,326,223,103,680220,Хмельницька область
25494,680221,286,2,188,125,63,680221,Хмельницька область
25495,680222,103,4,73,52,21,680222,Хмельницька область
25496,680223,869,17,531,427,104,680223,Хмельницька область
25497,680224,1088,11,722,598,124,680224,Хмельницька область
25498,680225,548,10,310,221,89,680225,Хмельницька область
25499,680226,442,5,290,210,80,680226,Хмельницька область
25500,680228,374,0,233,141,92,680228,Хмельницька область
25501,680229,195,4,110,77,33,680229,Хмельницька область
25502,680230,160,2,115,73,42,680230,Хмельницька область
25503,680231,147,0,101,83,18,680231,Хмельницька область
25504,680232,76,0,58,47,11,680232,Хмельницька область
25505,680233,251,22,156,111,45,680233,Хмельницька область
25506,680234,56,0,40,14,26,680234,Хмельницька область
25507,680235,102,0,66,45,21,680235,Хмельницька область
25508,680236,561,5,351,264,87,680236,Хмельницька область
25509,680237,87,0,68,55,13,680237,Хмельницька область
25510,680238,465,4,315,230,85,680238,Хмельницька область
25511,680239,438,8,348,291,57,680239,Хмельницька область
25512,680240,291,2,259,173,86,680240,Хмельницька область
25513,680241,328,4,244,177,67,680241,Хмельницька область
25514,680242,394,4,242,166,76,680242,Хмельницька область
25515,680243,381,10,238,184,54,680243,Хмельницька область
25516,680244,345,1,188,112,76,680244,Хмельницька область
25517,680245,179,3,129,60,69,680245,Хмельницька область
25518,680246,167,1,85,69,16,680246,Хмельницька область
25519,680247,360,1,229,167,62,680247,Хмельницька область
25520,680248,342,2,217,130,87,680248,Хмельницька область
25521,680250,1458,6,812,732,80,680250,Хмельницька область
25522,680251,372,5,263,212,51,680251,Хмельницька область
25523,680252,104,0,84,60,24,680252,Хмельницька область
25524,680253,912,14,570,413,157,680253,Хмельницька область
25525,680254,348,4,216,148,68,680254,Хмельницька область
25526,680255,126,2,84,59,25,680255,Хмельницька область
25527,680256,183,0,135,81,54,680256,Хмельницька область
25528,680313,1586,34,853,646,207,680313,Хмельницька область
25529,680314,1895,26,1118,795,323,680314,Хмельницька область
25530,680315,1769,46,1100,805,295,680315,Хмельницька область
25531,680316,1743,34,1027,770,257,680316,Хмельницька область
25532,680317,2492,44,1550,1151,399,680317,Хмельницька область
25533,680318,2034,59,1209,917,292,680318,Хмельницька область
25534,680319,667,11,426,313,113,680319,Хмельницька область
25535,680320,614,15,357,259,98,680320,Хмельницька область
25536,680321,1907,24,1056,886,170,680321,Хмельницька область
25537,680322,792,12,449,324,125,680322,Хмельницька область
25538,680323,881,12,521,338,183,680323,Хмельницька область
25539,680324,207,3,115,81,34,680324,Хмельницька область
25540,680325,1425,15,776,621,155,680325,Хмельницька область
25541,680326,1004,16,552,388,164,680326,Хмельницька область
25542,680327,144,0,105,67,38,680327,Хмельницька область
25543,680328,403,4,274,187,87,680328,Хмельницька область
25544,680329,716,8,425,245,180,680329,Хмельницька область
25545,680330,343,3,208,172,36,680330,Хмельницька область
25546,680331,254,2,177,146,31,680331,Хмельницька область
25547,680332,548,7,327,223,104,680332,Хмельницька область
25548,680333,486,4,390,290,100,680333,Хмельницька область
25549,680334,440,7,288,168,120,680334,Хмельницька область
25550,680335,680,17,427,303,124,680335,Хмельницька область
25551,680336,303,3,167,122,45,680336,Хмельницька область
25552,680337,128,0,68,42,26,680337,Хмельницька область
25553,680338,355,0,264,204,60,680338,Хмельницька область
25554,680339,250,0,165,125,40,680339,Хмельницька область
25555,680340,95,1,65,44,21,680340,Хмельницька область
25556,680341,891,10,584,490,94,680341,Хмельницька область
25557,680342,758,12,459,352,107,680342,Хмельницька область
25558,680343,566,12,383,250,133,680343,Хмельницька область
25559,680344,614,3,427,309,118,680344,Хмельницька область
25560,680345,216,2,133,109,24,680345,Хмельницька область
25561,680346,753,5,460,358,102,680346,Хмельницька область
25562,680347,2300,47,1193,923,270,680347,Хмельницька область
25563,680348,1177,26,653,545,108,680348,Хмельницька область
25564,680349,553,8,388,288,100,680349,Хмельницька область
25565,680350,550,10,339,218,121,680350,Хмельницька область
25566,680351,107,0,96,56,40,680351,Хмельницька область
25567,680352,292,0,262,157,105,680352,Хмельницька область
25568,680353,366,2,234,137,97,680353,Хмельницька область
25569,680354,172,0,141,88,53,680354,Хмельницька область
25570,680355,318,1,194,152,42,680355,Хмельницька область
25571,680356,92,1,57,33,24,680356,Хмельницька область
25572,680357,687,6,406,309,97,680357,Хмельницька область
25573,680358,106,1,61,45,16,680358,Хмельницька область
25574,680359,102,1,80,56,24,680359,Хмельницька область
25575,680360,291,3,182,147,35,680360,Хмельницька область
25576,680361,305,0,156,109,47,680361,Хмельницька область
25577,680362,1042,14,631,498,133,680362,Хмельницька область
25578,680363,429,8,288,183,105,680363,Хмельницька область
25579,680364,132,3,80,48,32,680364,Хмельницька область
25580,680365,876,13,554,417,137,680365,Хмельницька область
25581,680366,629,5,344,264,80,680366,Хмельницька область
25582,680367,550,7,313,211,102,680367,Хмельницька область
25583,680368,404,18,164,103,61,680368,Хмельницька область
25584,680369,419,6,281,193,88,680369,Хмельницька область
25585,680370,504,4,296,236,60,680370,Хмельницька область
25586,680371,210,1,110,74,36,680371,Хмельницька область
25587,680372,120,0,85,56,29,680372,Хмельницька область
25588,680373,660,10,395,305,90,680373,Хмельницька область
25589,680374,257,1,143,94,49,680374,Хмельницька область
25590,680375,373,2,221,101,120,680375,Хмельницька область
25591,680376,414,5,279,188,91,680376,Хмельницька область
25592,680377,593,9,357,263,94,680377,Хмельницька область
25593,680378,469,5,290,200,90,680378,Хмельницька область
25594,680379,450,7,317,216,101,680379,Хмельницька область
25595,680380,803,11,487,381,106,680380,Хмельницька область
25596,680381,294,1,214,136,78,680381,Хмельницька область
25597,680382,881,10,599,416,183,680382,Хмельницька область
25598,680383,95,1,65,47,18,680383,Хмельницька область
25599,680384,568,3,365,263,102,680384,Хмельницька область
25600,680385,475,9,316,223,93,680385,Хмельницька область
25601,680386,252,7,141,108,33,680386,Хмельницька область
25602,680387,57,0,52,42,10,680387,Хмельницька область
25603,681139,1198,18,702,508,194,681139,Хмельницька область
25604,681140,780,5,472,347,125,681140,Хмельницька область
25605,681141,826,7,446,320,126,681141,Хмельницька область
25606,681142,630,5,362,288,74,681142,Хмельницька область
25607,681143,1052,15,575,455,120,681143,Хмельницька область
25608,681144,477,12,301,231,70,681144,Хмельницька область
25609,681145,827,15,544,370,174,681145,Хмельницька область
25610,681146,835,7,486,333,153,681146,Хмельницька область
25611,681147,958,18,594,467,127,681147,Хмельницька область
25612,681148,134,2,98,64,34,681148,Хмельницька область
25613,681149,587,4,390,305,85,681149,Хмельницька область
25614,681150,639,9,375,235,140,681150,Хмельницька область
25615,681151,631,8,326,228,98,681151,Хмельницька область
25616,681152,406,1,232,145,87,681152,Хмельницька область
25617,681153,124,1,81,34,47,681153,Хмельницька область
25618,681154,322,1,285,140,145,681154,Хмельницька область
25619,681155,859,20,529,422,107,681155,Хмельницька область
25620,681156,273,4,219,133,86,681156,Хмельницька область
25621,681157,503,12,310,208,102,681157,Хмельницька область
25622,681158,379,5,226,189,37,681158,Хмельницька область
25623,681159,71,0,55,50,5,681159,Хмельницька область
25624,681160,55,0,45,26,19,681160,Хмельницька область
25625,681161,412,4,291,185,106,681161,Хмельницька область
25626,681162,1055,11,783,586,197,681162,Хмельницька область
25627,681163,483,21,364,169,195,681163,Хмельницька область
25628,681164,414,2,323,178,145,681164,Хмельницька область
25629,681165,570,14,456,284,172,681165,Хмельницька область
25630,681166,465,9,371,293,78,681166,Хмельницька область
25631,681167,819,9,453,370,83,681167,Хмельницька область
25632,681168,504,3,304,206,98,681168,Хмельницька область
25633,681169,768,10,446,353,93,681169,Хмельницька область
25634,681170,448,2,296,209,87,681170,Хмельницька область
25635,681171,156,0,115,78,37,681171,Хмельницька область
25636,681172,851,10,580,414,166,681172,Хмельницька область
25637,681173,117,0,81,63,18,681173,Хмельницька область
25638,681174,1099,20,688,491,197,681174,Хмельницька область
25639,681175,1349,27,950,754,196,681175,Хмельницька область
25640,681176,99,2,59,43,16,681176,Хмельницька область
25641,681177,53,0,40,20,20,681177,Хмельницька область
25642,681178,773,9,433,310,123,681178,Хмельницька область
25643,681179,219,1,155,115,40,681179,Хмельницька область
25644,681180,172,4,130,102,28,681180,Хмельницька область
25645,681181,367,3,247,217,30,681181,Хмельницька область
25646,681182,843,9,509,332,177,681182,Хмельницька область
25647,681183,510,15,247,169,78,681183,Хмельницька область
25648,681184,154,2,94,60,34,681184,Хмельницька область
25649,681185,298,1,188,121,67,681185,Хмельницька область
25650,681186,142,0,114,61,53,681186,Хмельницька область
25651,681187,87,1,58,40,18,681187,Хмельницька область
25652,681188,448,7,274,220,54,681188,Хмельницька область
25653,681189,356,6,245,160,85,681189,Хмельницька область
25654,681190,176,6,138,63,75,681190,Хмельницька область
25655,681191,83,1,51,22,29,681191,Хмельницька область
25656,681192,511,5,298,208,90,681192,Хмельницька область
25657,681193,738,13,516,371,145,681193,Хмельницька область
25658,681194,88,2,66,28,38,681194,Хмельницька область
25659,681195,591,0,381,278,103,681195,Хмельницька область
25660,681196,89,3,67,34,33,681196,Хмельницька область
25661,681197,307,9,191,160,31,681197,Хмельницька область
25662,681198,307,0,184,155,29,681198,Хмельницька область
25663,681199,133,2,95,66,29,681199,Хмельницька область
25664,681200,150,0,97,71,26,681200,Хмельницька область
25665,681201,699,7,423,326,97,681201,Хмельницька область
25666,681202,334,7,221,174,47,681202,Хмельницька область
25667,681203,523,3,340,248,92,681203,Хмельницька область
25668,681267,398,9,272,233,39,681267,Хмельницька область
25669,681268,156,2,95,77,18,681268,Хмельницька область
25670,681269,404,11,254,189,65,681269,Хмельницька область
25671,681270,219,0,158,90,68,681270,Хмельницька область
25672,681271,140,0,104,66,38,681271,Хмельницька область
25673,681272,86,1,56,28,28,681272,Хмельницька область
25674,681273,173,1,109,86,23,681273,Хмельницька область
25675,681274,72,0,48,35,13,681274,Хмельницька область
25676,681275,379,4,278,195,83,681275,Хмельницька область
25677,681276,292,1,200,150,50,681276,Хмельницька область
25678,681277,297,2,211,122,89,681277,Хмельницька область
25679,681278,376,13,252,167,85,681278,Хмельницька область
25680,681279,120,1,74,50,24,681279,Хмельницька область
25681,681280,753,7,394,298,96,681280,Хмельницька область
25682,681281,130,0,82,42,40,681281,Хмельницька область
25683,681282,440,3,261,184,77,681282,Хмельницька область
25684,681283,206,1,138,113,25,681283,Хмельницька область
25685,681284,402,4,284,217,67,681284,Хмельницька область
25686,681285,231,3,131,101,30,681285,Хмельницька область
25687,681286,93,0,75,48,27,681286,Хмельницька область
25688,681287,313,2,216,141,75,681287,Хмельницька область
25689,681288,415,4,252,177,75,681288,Хмельницька область
25690,681289,144,3,108,71,37,681289,Хмельницька область
25691,681290,114,0,81,54,27,681290,Хмельницька область
25692,681291,87,1,64,39,25,681291,Хмельницька область
25693,681292,47,0,39,27,12,681292,Хмельницька область
25694,681293,161,1,99,64,35,681293,Хмельницька область
25695,681294,209,3,145,102,43,681294,Хмельницька область
25696,681295,209,1,120,97,23,681295,Хмельницька область
25697,681296,405,3,263,210,53,681296,Хмельницька область
25698,681297,115,1,82,66,16,681297,Хмельницька область
25699,681298,242,4,169,123,46,681298,Хмельницька область
25700,681299,183,4,139,93,46,681299,Хмельницька область
25701,681300,64,0,51,40,11,681300,Хмельницька область
25702,681301,86,1,62,49,13,681301,Хмельницька область
25703,681302,726,6,491,404,87,681302,Хмельницька область
25704,681303,153,2,111,78,33,681303,Хмельницька область
25705,681304,527,2,281,215,66,681304,Хмельницька область
25706,681305,187,2,95,68,27,681305,Хмельницька область
25707,681306,63,0,40,24,16,681306,Хмельницька область
25708,681307,417,5,282,216,66,681307,Хмельницька область
25709,681308,700,5,459,339,120,681308,Хмельницька область
25710,681309,203,3,111,79,32,681309,Хмельницька область
25711,681310,502,6,314,274,40,681310,Хмельницька область
25712,681311,1165,13,765,639,126,681311,Хмельницька область
25713,681312,1546,24,1030,778,252,681312,Хмельницька область
25714,681313,319,4,191,157,34,681313,Хмельницька область
25715,681314,468,9,265,199,66,681314,Хмельницька область
25716,681315,787,2,525,405,120,681315,Хмельницька область
25717,681316,164,5,100,73,27,681316,Хмельницька область
25718,681317,200,2,149,115,34,681317,Хмельницька область
25719,681318,36,0,21,12,9,681318,Хмельницька область
25720,681319,608,10,396,295,101,681319,Хмельницька область
25721,681320,513,6,296,235,61,681320,Хмельницька область
25722,681321,832,14,553,438,115,681321,Хмельницька область
25723,681322,534,9,327,206,121,681322,Хмельницька область
25724,681323,184,2,128,96,32,681323,Хмельницька область
25725,681324,2387,34,1507,1152,355,681324,Хмельницька область
25726,681325,1801,30,1096,811,285,681325,Хмельницька область
25727,681326,1648,29,977,746,231,681326,Хмельницька область
25728,681327,1279,16,744,548,196,681327,Хмельницька область
25729,681328,623,19,383,303,80,681328,Хмельницька область
25730,680464,1686,12,958,732,226,680464,Хмельницька область
25731,680465,411,3,275,199,76,680465,Хмельницька область
25732,680466,416,3,231,147,84,680466,Хмельницька область
25733,680467,375,7,250,185,65,680467,Хмельницька область
25734,680468,180,1,122,100,22,680468,Хмельницька область
25735,680469,101,0,90,67,23,680469,Хмельницька область
25736,680470,565,11,379,293,86,680470,Хмельницька область
25737,680471,115,3,71,61,10,680471,Хмельницька область
25738,680472,82,2,60,45,15,680472,Хмельницька область
25739,680473,1341,18,799,675,124,680473,Хмельницька область
25740,680474,294,2,225,165,60,680474,Хмельницька область
25741,680475,572,18,370,286,84,680475,Хмельницька область
25742,680476,145,2,91,72,19,680476,Хмельницька область
25743,680477,131,0,85,61,24,680477,Хмельницька область
25744,680478,90,0,46,31,15,680478,Хмельницька область
25745,680479,411,4,312,197,115,680479,Хмельницька область
25746,680480,123,0,111,61,50,680480,Хмельницька область
25747,680481,362,0,220,163,57,680481,Хмельницька область
25748,680482,1726,33,1247,901,346,680482,Хмельницька область
25749,680483,1117,14,661,500,161,680483,Хмельницька область
25750,680484,511,8,340,221,119,680484,Хмельницька область
25751,680485,598,9,419,286,133,680485,Хмельницька область
25752,680486,545,10,370,281,89,680486,Хмельницька область
25753,680487,93,2,55,50,5,680487,Хмельницька область
25754,680488,258,2,153,119,34,680488,Хмельницька область
25755,680489,234,5,136,110,26,680489,Хмельницька область
25756,680490,1630,38,907,681,226,680490,Хмельницька область
25757,680491,2008,31,1074,791,283,680491,Хмельницька область
25758,680492,524,5,295,216,79,680492,Хмельницька область
25759,680493,657,5,422,312,110,680493,Хмельницька область
25760,680494,1040,14,538,402,136,680494,Хмельницька область
25761,680495,121,1,66,42,24,680495,Хмельницька область
25762,680496,470,5,258,218,40,680496,Хмельницька область
25763,680497,128,0,88,52,36,680497,Хмельницька область
25764,680498,218,2,117,92,25,680498,Хмельницька область
25765,680499,765,7,463,356,107,680499,Хмельницька область
25766,680500,78,1,46,19,27,680500,Хмельницька область
25767,680501,472,1,311,227,84,680501,Хмельницька область
25768,680502,149,2,101,75,26,680502,Хмельницька область
25769,680503,602,6,342,244,98,680503,Хмельницька область
25770,680504,1322,20,770,644,126,680504,Хмельницька область
25771,680505,178,2,120,86,34,680505,Хмельницька область
25772,680506,248,5,155,99,56,680506,Хмельницька область
25773,680507,436,3,278,170,108,680507,Хмельницька область
25774,680508,41,0,28,23,5,680508,Хмельницька область
25775,680509,471,4,304,236,68,680509,Хмельницька область
25776,680510,164,2,114,86,28,680510,Хмельницька область
25777,680511,1779,33,1017,743,274,680511,Хмельницька область
25778,680512,356,1,242,211,31,680512,Хмельницька область
25779,680513,351,6,231,170,61,680513,Хмельницька область
25780,680514,48,0,34,16,18,680514,Хмельницька область
25781,680515,528,5,422,241,181,680515,Хмельницька область
25782,680516,1411,44,817,577,240,680516,Хмельницька область
25783,680517,173,3,112,75,37,680517,Хмельницька область
25784,680518,1079,16,607,443,164,680518,Хмельницька область
25785,680519,124,1,77,65,12,680519,Хмельницька область
25786,680520,585,8,321,230,91,680520,Хмельницька область
25787,680521,505,13,350,272,78,680521,Хмельницька область
25788,680522,828,10,509,409,100,680522,Хмельницька область
25789,680523,268,1,175,124,51,680523,Хмельницька область
25790,680524,30,0,19,15,4,680524,Хмельницька область
25791,680525,240,4,167,136,31,680525,Хмельницька область
25792,680526,393,11,222,157,65,680526,Хмельницька область
25793,680527,290,3,172,132,40,680527,Хмельницька область
25794,680528,381,6,253,193,60,680528,Хмельницька область
25795,680529,118,1,73,60,13,680529,Хмельницька область
25796,680530,1000,10,634,479,155,680530,Хмельницька область
25797,680531,706,5,383,299,84,680531,Хмельницька область
25798,680532,972,7,472,388,84,680532,Хмельницька область
25799,680533,927,12,434,330,104,680533,Хмельницька область
25800,680534,364,5,230,193,37,680534,Хмельницька область
25801,680535,778,16,429,344,85,680535,Хмельницька область
25802,680536,456,7,279,222,57,680536,Хмельницька область
25803,680537,248,7,141,89,52,680537,Хмельницька область
25804,680538,165,3,101,90,11,680538,Хмельницька область
25805,680539,506,4,311,208,103,680539,Хмельницька область
25806,680540,577,13,347,281,66,680540,Хмельницька область
25807,680541,48,0,44,27,17,680541,Хмельницька область
25808,680542,163,0,128,91,37,680542,Хмельницька область
25809,680543,169,0,119,87,32,680543,Хмельницька область
25810,680544,527,3,310,236,74,680544,Хмельницька область
25811,680545,556,10,350,286,64,680545,Хмельницька область
25812,680546,306,5,209,143,66,680546,Хмельницька область
25813,680547,650,10,372,264,108,680547,Хмельницька область
25814,680548,317,1,153,117,36,680548,Хмельницька область
25815,680549,716,7,405,303,102,680549,Хмельницька область
25816,680550,401,7,223,186,37,680550,Хмельницька область
25817,680551,2083,24,1255,916,339,680551,Хмельницька область
25818,680552,360,4,213,162,51,680552,Хмельницька область
25819,680553,1158,15,658,494,164,680553,Хмельницька область
25820,680554,125,1,77,52,25,680554,Хмельницька область
25821,680555,101,0,64,44,20,680555,Хмельницька область
25822,680556,241,2,176,127,49,680556,Хмельницька область
25823,680557,495,14,342,267,75,680557,Хмельницька область
25824,680558,74,0,52,38,14,680558,Хмельницька область
25825,680559,104,3,68,54,14,680559,Хмельницька область
25826,680560,340,5,189,152,37,680560,Хмельницька область
25827,680561,415,3,270,202,68,680561,Хмельницька область
25828,680562,509,3,272,207,65,680562,Хмельницька область
25829,680563,580,2,388,337,51,680563,Хмельницька область
25830,680564,94,0,58,53,5,680564,Хмельницька область
25831,680565,376,3,255,235,20,680565,Хмельницька область
25832,680566,279,3,198,145,53,680566,Хмельницька область
25833,680567,624,9,389,284,105,680567,Хмельницька область
25834,680568,487,11,305,231,74,680568,Хмельницька область
25835,680569,518,2,287,203,84,680569,Хмельницька область
25836,680570,375,9,182,136,46,680570,Хмельницька область
25837,680571,209,1,150,107,43,680571,Хмельницька область
25838,680572,105,2,63,47,16,680572,Хмельницька область
25839,680573,147,2,111,83,28,680573,Хмельницька область
25840,680574,313,7,194,124,70,680574,Хмельницька область
25841,680575,162,1,109,52,57,680575,Хмельницька область
25842,680576,257,3,158,99,59,680576,Хмельницька область
25843,680577,42,0,30,24,6,680577,Хмельницька область
25844,680716,1992,17,1198,868,330,680716,Хмельницька область
25845,680717,1529,11,837,634,203,680717,Хмельницька область
25846,680718,957,20,537,384,153,680718,Хмельницька область
25847,680719,733,11,383,291,92,680719,Хмельницька область
25848,680720,431,2,260,145,115,680720,Хмельницька область
25849,680721,302,19,164,87,77,680721,Хмельницька область
25850,680722,406,6,255,166,89,680722,Хмельницька область
25851,680723,147,2,98,56,42,680723,Хмельницька область
25852,680724,640,15,356,249,107,680724,Хмельницька область
25853,680725,155,0,120,76,44,680725,Хмельницька область
25854,680726,214,6,137,77,60,680726,Хмельницька область
25855,680727,227,3,156,101,55,680727,Хмельницька область
25856,680728,69,1,51,22,29,680728,Хмельницька область
25857,680729,293,9,193,154,39,680729,Хмельницька область
25858,680730,73,1,42,16,26,680730,Хмельницька область
25859,680731,929,11,522,401,121,680731,Хмельницька область
25860,680732,119,4,66,39,27,680732,Хмельницька область
25861,680733,223,1,151,107,44,680733,Хмельницька область
25862,680734,410,4,259,197,62,680734,Хмельницька область
25863,680735,480,7,313,243,70,680735,Хмельницька область
25864,680736,137,2,100,62,38,680736,Хмельницька область
25865,680737,67,1,48,28,20,680737,Хмельницька область
25866,680738,73,0,36,13,23,680738,Хмельницька область
25867,680739,443,4,278,177,101,680739,Хмельницька область
25868,680740,32,2,25,9,16,680740,Хмельницька область
25869,680741,268,1,168,131,37,680741,Хмельницька область
25870,680742,732,7,416,276,140,680742,Хмельницька область
25871,680743,363,4,257,151,106,680743,Хмельницька область
25872,680744,829,22,708,452,256,680744,Хмельницька область
25873,680745,255,3,149,120,29,680745,Хмельницька область
25874,680746,588,11,348,234,114,680746,Хмельницька область
25875,680747,226,3,159,108,51,680747,Хмельницька область
25876,680748,261,2,168,116,52,680748,Хмельницька область
25877,680749,222,0,139,100,39,680749,Хмельницька область
25878,680750,541,7,346,246,100,680750,Хмельницька область
25879,680751,144,6,102,78,24,680751,Хмельницька область
25880,680752,76,0,56,32,24,680752,Хмельницька область
25881,680753,892,14,510,369,141,680753,Хмельницька область
25882,680754,393,4,246,153,93,680754,Хмельницька область
25883,680755,121,3,80,43,37,680755,Хмельницька область
25884,680757,321,1,206,135,71,680757,Хмельницька область
25885,680758,449,3,260,201,59,680758,Хмельницька область
25886,680759,68,0,41,25,16,680759,Хмельницька область
25887,680760,191,0,116,108,8,680760,Хмельницька область
25888,680761,581,10,400,278,122,680761,Хмельницька область
25889,680762,428,8,306,221,85,680762,Хмельницька область
25890,680763,223,0,146,110,36,680763,Хмельницька область
25891,680764,548,6,301,256,45,680764,Хмельницька область
25892,680765,191,2,124,83,41,680765,Хмельницька область
25893,680766,213,1,186,86,100,680766,Хмельницька область
25894,680767,369,2,220,168,52,680767,Хмельницька область
25895,680768,168,4,114,83,31,680768,Хмельницька область
25896,680769,255,7,142,96,46,680769,Хмельницька область
25897,680770,149,0,103,61,42,680770,Хмельницька область
25898,680771,1119,30,649,488,161,680771,Хмельницька область
25899,681329,1239,26,683,536,147,681329,Хмельницька область
25900,681330,1694,24,979,700,279,681330,Хмельницька область
25901,681331,1380,21,838,605,233,681331,Хмельницька область
25902,681332,2106,32,1252,929,323,681332,Хмельницька область
25903,681333,2018,51,1142,833,309,681333,Хмельницька область
25904,681334,1718,33,994,749,245,681334,Хмельницька область
25905,681335,2070,31,1130,864,266,681335,Хмельницька область
25906,681336,1181,19,658,487,171,681336,Хмельницька область
25907,681337,2310,38,1373,1006,367,681337,Хмельницька область
25908,681338,2156,39,1266,968,298,681338,Хмельницька область
25909,681339,1205,13,656,474,182,681339,Хмельницька область
25910,681340,1846,31,1092,765,327,681340,Хмельницька область
25911,681341,1474,27,869,684,185,681341,Хмельницька область
25912,681342,2248,35,1318,1011,307,681342,Хмельницька область
25913,681343,2365,31,1489,1102,387,681343,Хмельницька область
25914,681344,1099,4,302,235,67,681344,Хмельницька область
25915,681345,1799,27,1053,764,289,681345,Хмельницька область
25916,681346,1627,22,944,678,266,681346,Хмельницька область
25917,681347,1518,22,905,658,247,681347,Хмельницька область
25918,681348,1356,18,798,522,276,681348,Хмельницька область
25919,681349,1764,36,1039,753,286,681349,Хмельницька область
25920,681350,1425,20,778,555,223,681350,Хмельницька область
25921,681351,2114,32,1143,885,258,681351,Хмельницька область
25922,681352,1414,24,851,606,245,681352,Хмельницька область
25923,681353,1952,26,1101,843,258,681353,Хмельницька область
25924,681354,1650,24,955,696,259,681354,Хмельницька область
25925,681355,1246,28,740,539,201,681355,Хмельницька область
25926,681356,1038,15,609,408,201,681356,Хмельницька область
25927,681357,1128,18,647,470,177,681357,Хмельницька область
25928,681358,1174,16,628,449,179,681358,Хмельницька область
25929,681359,1459,33,915,676,239,681359,Хмельницька область
25930,681360,1853,29,1116,792,324,681360,Хмельницька область
25931,681361,1961,39,1101,768,333,681361,Хмельницька область
25932,681362,1181,21,710,512,198,681362,Хмельницька область
25933,681363,2137,34,1251,899,352,681363,Хмельницька область
25934,681364,1517,26,927,651,276,681364,Хмельницька область
25935,681365,1024,16,516,389,127,681365,Хмельницька область
25936,681366,1590,24,959,701,258,681366,Хмельницька область
25937,681367,1389,15,761,551,210,681367,Хмельницька область
25938,681368,1431,18,848,630,218,681368,Хмельницька область
25939,681369,1664,27,907,636,271,681369,Хмельницька область
25940,681370,1776,25,1052,754,298,681370,Хмельницька область
25941,681371,1323,22,864,584,280,681371,Хмельницька область
25942,681372,56,3,49,28,21,681372,Хмельницька область
25943,681373,41,0,30,22,8,681373,Хмельницька область
25944,681374,46,4,41,13,28,681374,Хмельницька область
25945,1,369,8,361,345,16,1,Черкаська область
25946,710975,2203,53,1384,978,406,710975,Черкаська область
25947,710976,1709,35,1019,762,257,710976,Черкаська область
25948,710977,2134,34,1332,960,372,710977,Черкаська область
25949,710978,2313,54,1420,1034,386,710978,Черкаська область
25950,710979,2307,30,1462,1042,420,710979,Черкаська область
25951,710980,1218,23,751,570,181,710980,Черкаська область
25952,710981,1284,28,786,564,222,710981,Черкаська область
25953,710982,1934,38,1188,867,321,710982,Черкаська область
25954,710983,2221,40,1346,1020,326,710983,Черкаська область
25955,710984,1695,41,1104,817,287,710984,Черкаська область
25956,710985,1597,26,1044,741,303,710985,Черкаська область
25957,710986,2225,42,1275,989,286,710986,Черкаська область
25958,710987,2132,57,1212,882,330,710987,Черкаська область
25959,710988,1565,25,988,729,259,710988,Черкаська область
25960,710989,1927,45,1202,938,264,710989,Черкаська область
25961,710990,2206,44,1287,965,322,710990,Черкаська область
25962,710991,2323,47,1438,1088,350,710991,Черкаська область
25963,710992,1916,39,1110,840,270,710992,Черкаська область
25964,710993,2095,44,1249,938,311,710993,Черкаська область
25965,710994,2274,43,1336,1042,294,710994,Черкаська область
25966,710995,1802,32,1098,807,291,710995,Черкаська область
25967,710996,1363,25,839,665,174,710996,Черкаська область
25968,710997,2047,27,1036,828,208,710997,Черкаська область
25969,710998,2093,23,997,812,185,710998,Черкаська область
25970,710999,2039,47,1294,967,327,710999,Черкаська область
25971,711000,1677,19,1064,814,250,711000,Черкаська область
25972,711001,1972,45,1148,848,300,711001,Черкаська область
25973,711002,1945,46,1218,880,338,711002,Черкаська область
25974,711003,1921,32,1206,903,303,711003,Черкаська область
25975,711004,1726,40,1018,789,229,711004,Черкаська область
25976,711005,2212,34,1316,1008,308,711005,Черкаська область
25977,711006,2133,45,1292,986,306,711006,Черкаська область
25978,711007,2135,43,1295,984,311,711007,Черкаська область
25979,711008,2382,45,1370,1055,315,711008,Черкаська область
25980,711009,1265,15,733,581,152,711009,Черкаська область
25981,711010,1672,25,987,744,243,711010,Черкаська область
25982,711011,1342,17,849,659,190,711011,Черкаська область
25983,711012,2210,35,1250,998,252,711012,Черкаська область
25984,711013,847,20,503,387,116,711013,Черкаська область
25985,711014,1579,38,969,698,271,711014,Черкаська область
25986,711015,2273,38,1332,1087,245,711015,Черкаська область
25987,711016,1595,24,942,727,215,711016,Черкаська область
25988,711017,2315,50,1431,974,457,711017,Черкаська область
25989,711018,2226,41,1422,1016,406,711018,Черкаська область
25990,711019,2230,54,1370,1008,362,711019,Черкаська область
25991,711020,2193,40,1336,963,373,711020,Черкаська область
25992,711021,2374,37,1515,1121,394,711021,Черкаська область
25993,711022,2155,45,1364,1013,351,711022,Черкаська область
25994,711023,2457,49,1539,1118,421,711023,Черкаська область
25995,711024,2246,47,1434,1029,405,711024,Черкаська область
25996,711025,1956,42,1176,900,276,711025,Черкаська область
25997,711026,2402,39,1540,1082,458,711026,Черкаська область
25998,711027,31,0,29,22,7,711027,Черкаська область
25999,711028,38,1,36,31,5,711028,Черкаська область
26000,711029,632,56,574,519,55,711029,Черкаська область
26001,711039,1989,42,1097,868,229,711039,Черкаська область
26002,711040,2181,44,1302,997,305,711040,Черкаська область
26003,711041,2078,38,1240,952,288,711041,Черкаська область
26004,711042,1717,11,1045,794,251,711042,Черкаська область
26005,711044,1591,22,880,712,168,711044,Черкаська область
26006,711049,2063,41,1136,896,240,711049,Черкаська область
26007,711080,1572,19,967,751,216,711080,Черкаська область
26008,711081,1663,23,933,705,228,711081,Черкаська область
26009,711082,2154,32,1283,982,301,711082,Черкаська область
26010,711083,2218,29,1260,1025,235,711083,Черкаська область
26011,711084,1962,31,1228,945,283,711084,Черкаська область
26012,711085,1454,18,849,653,196,711085,Черкаська область
26013,711086,1207,23,715,537,178,711086,Черкаська область
26014,711087,2087,28,1144,930,214,711087,Черкаська область
26015,711088,2161,35,1224,976,248,711088,Черкаська область
26016,711089,1960,30,1187,942,245,711089,Черкаська область
26017,711090,1708,29,981,784,197,711090,Черкаська область
26018,711091,14,0,7,7,0,711091,Черкаська область
26019,711092,30,0,28,25,3,711092,Черкаська область
26020,711093,78,4,74,62,12,711093,Черкаська область
26021,711094,74,1,51,37,14,711094,Черкаська область
26022,711095,255,6,201,153,48,711095,Черкаська область
26023,711096,19,1,18,18,0,711096,Черкаська область
26024,711097,42,0,22,16,6,711097,Черкаська область
26025,711098,223,7,194,157,37,711098,Черкаська область
26026,711099,103,0,101,72,29,711099,Черкаська область
26027,711100,123,3,114,94,20,711100,Черкаська область
26028,711103,2083,38,1344,992,352,711103,Черкаська область
26029,710036,421,7,282,239,43,710036,Черкаська область
26030,710037,796,4,405,317,88,710037,Черкаська область
26031,710038,1191,14,776,643,133,710038,Черкаська область
26032,710039,87,1,59,45,14,710039,Черкаська область
26033,710040,450,4,313,231,82,710040,Черкаська область
26034,710041,982,13,572,500,72,710041,Черкаська область
26035,710042,446,10,282,223,59,710042,Черкаська область
26036,710043,190,1,148,120,28,710043,Черкаська область
26037,710044,784,8,466,364,102,710044,Черкаська область
26038,710045,643,7,358,279,79,710045,Черкаська область
26039,710046,548,8,329,242,87,710046,Черкаська область
26040,710047,159,0,136,104,32,710047,Черкаська область
26041,710048,1175,19,673,571,102,710048,Черкаська область
26042,710049,491,7,305,261,44,710049,Черкаська область
26043,710050,272,6,179,151,28,710050,Черкаська область
26044,710051,429,7,245,202,43,710051,Черкаська область
26045,710052,543,7,337,272,65,710052,Черкаська область
26046,710053,474,6,365,292,73,710053,Черкаська область
26047,710054,530,6,328,258,70,710054,Черкаська область
26048,710055,291,2,181,141,40,710055,Черкаська область
26049,710056,447,2,301,252,49,710056,Черкаська область
26050,710057,169,0,153,102,51,710057,Черкаська область
26051,710058,244,2,153,133,20,710058,Черкаська область
26052,710059,332,6,239,199,40,710059,Черкаська область
26053,710060,148,1,86,70,16,710060,Черкаська область
26054,710061,281,5,153,128,25,710061,Черкаська область
26055,710062,482,8,269,210,59,710062,Черкаська область
26056,710063,639,6,544,467,77,710063,Черкаська область
26057,710064,235,3,161,125,36,710064,Черкаська область
26058,710065,790,9,499,420,79,710065,Черкаська область
26059,710066,189,2,129,101,28,710066,Черкаська область
26060,710067,400,4,256,221,35,710067,Черкаська область
26061,710068,674,5,440,345,95,710068,Черкаська область
26062,710069,163,0,111,92,19,710069,Черкаська область
26063,710070,281,3,196,169,27,710070,Черкаська область
26064,710071,557,7,374,297,77,710071,Черкаська область
26065,710072,769,4,446,368,78,710072,Черкаська область
26066,710073,297,3,194,162,32,710073,Черкаська область
26067,710074,198,1,116,96,20,710074,Черкаська область
26068,710075,654,3,407,313,94,710075,Черкаська область
26069,710076,376,1,254,210,44,710076,Черкаська область
26070,710077,530,7,368,327,41,710077,Черкаська область
26071,710078,2112,41,1222,965,257,710078,Черкаська область
26072,710079,1671,24,955,785,170,710079,Черкаська область
26073,710080,1114,24,686,572,114,710080,Черкаська область
26074,710081,446,10,257,228,29,710081,Черкаська область
26075,710082,2128,31,1030,820,210,710082,Черкаська область
26076,710083,184,4,139,111,28,710083,Черкаська область
26077,710738,1325,12,803,672,131,710738,Черкаська область
26078,710739,481,5,280,242,38,710739,Черкаська область
26079,710740,123,0,70,63,7,710740,Черкаська область
26080,710741,698,15,429,372,57,710741,Черкаська область
26081,710742,849,11,414,316,98,710742,Черкаська область
26082,710743,151,3,91,75,16,710743,Черкаська область
26083,710744,478,4,245,208,37,710744,Черкаська область
26084,710745,438,6,259,206,53,710745,Черкаська область
26085,710746,406,2,268,245,23,710746,Черкаська область
26086,710747,955,8,522,402,120,710747,Черкаська область
26087,710748,139,0,77,50,27,710748,Черкаська область
26088,710749,679,13,406,336,70,710749,Черкаська область
26089,710750,510,4,300,244,56,710750,Черкаська область
26090,710751,1813,16,1013,876,137,710751,Черкаська область
26091,710752,711,6,382,324,58,710752,Черкаська область
26092,710753,855,9,391,322,69,710753,Черкаська область
26093,710754,502,2,308,212,96,710754,Черкаська область
26094,710755,1539,15,834,641,193,710755,Черкаська область
26095,710756,748,22,437,329,108,710756,Черкаська область
26096,710757,835,10,480,372,108,710757,Черкаська область
26097,710758,458,6,261,217,44,710758,Черкаська область
26098,710759,2291,34,1229,1045,184,710759,Черкаська область
26099,710760,2136,40,1132,916,216,710760,Черкаська область
26100,710761,1417,23,790,661,129,710761,Черкаська область
26101,710762,1477,18,711,604,107,710762,Черкаська область
26102,710763,1735,20,856,726,130,710763,Черкаська область
26103,710764,42,0,35,27,8,710764,Черкаська область
26104,710765,1229,18,733,588,145,710765,Черкаська область
26105,710766,1512,32,921,739,182,710766,Черкаська область
26106,710767,1733,26,1058,843,215,710767,Черкаська область
26107,710768,1381,21,839,680,159,710768,Черкаська область
26108,710769,749,13,469,369,100,710769,Черкаська область
26109,710770,280,3,148,127,21,710770,Черкаська область
26110,710771,1071,16,618,538,80,710771,Черкаська область
26111,710772,801,10,474,412,62,710772,Черкаська область
26112,710773,964,17,617,533,84,710773,Черкаська область
26113,710774,919,8,563,469,94,710774,Черкаська область
26114,710775,285,4,174,146,28,710775,Черкаська область
26115,710776,861,11,578,502,76,710776,Черкаська область
26116,710777,1109,15,732,640,92,710777,Черкаська область
26117,710778,487,5,269,211,58,710778,Черкаська область
26118,710779,277,2,162,141,21,710779,Черкаська область
26119,710780,246,1,144,122,22,710780,Черкаська область
26120,710781,547,5,352,286,66,710781,Черкаська область
26121,710782,188,1,128,111,17,710782,Черкаська область
26122,710783,63,1,44,33,11,710783,Черкаська область
26123,710784,136,2,108,88,20,710784,Черкаська область
26124,710785,1590,25,896,719,177,710785,Черкаська область
26125,710786,754,7,457,403,54,710786,Черкаська область
26126,710787,128,2,101,50,51,710787,Черкаська область
26127,710788,470,3,327,276,51,710788,Черкаська область
26128,710789,451,7,359,321,38,710789,Черкаська область
26129,710790,233,3,160,137,23,710790,Черкаська область
26130,710791,977,15,637,539,98,710791,Черкаська область
26131,710792,485,8,300,238,62,710792,Черкаська область
26132,710793,513,4,352,279,73,710793,Черкаська область
26133,710794,787,7,531,475,56,710794,Черкаська область
26134,710795,807,9,511,450,61,710795,Черкаська область
26135,710796,566,6,406,345,61,710796,Черкаська область
26136,710797,539,7,342,297,45,710797,Черкаська область
26137,710798,74,2,44,34,10,710798,Черкаська область
26138,710799,981,17,556,473,83,710799,Черкаська область
26139,710800,153,1,97,89,8,710800,Черкаська область
26140,710801,1023,8,648,505,143,710801,Черкаська область
26141,710802,182,0,102,70,32,710802,Черкаська область
26142,710803,167,2,112,90,22,710803,Черкаська область
26143,710804,212,0,153,131,22,710804,Черкаська область
26144,710805,560,6,346,314,32,710805,Черкаська область
26145,710806,248,1,156,125,31,710806,Черкаська область
26146,710807,736,12,469,378,91,710807,Черкаська область
26147,710808,535,13,357,293,64,710808,Черкаська область
26148,710809,230,3,172,147,25,710809,Черкаська область
26149,710810,1087,7,650,503,147,710810,Черкаська область
26150,710811,620,12,426,355,71,710811,Черкаська область
26151,710812,322,3,214,160,54,710812,Черкаська область
26152,710813,724,11,456,396,60,710813,Черкаська область
26153,710814,390,6,254,229,25,710814,Черкаська область
26154,710815,847,4,442,389,53,710815,Черкаська область
26155,710816,204,0,148,118,30,710816,Черкаська область
26156,710817,61,2,50,28,22,710817,Черкаська область
26157,710818,372,6,183,132,51,710818,Черкаська область
26158,710819,20,0,17,11,6,710819,Черкаська область
26159,711043,1385,24,841,637,204,711043,Черкаська область
26160,711045,2049,54,1083,843,240,711045,Черкаська область
26161,711046,1431,28,844,630,214,711046,Черкаська область
26162,711047,1920,34,979,758,221,711047,Черкаська область
26163,711048,2151,44,1311,1041,270,711048,Черкаська область
26164,711050,2158,40,1364,1029,335,711050,Черкаська область
26165,711051,2010,37,1171,916,255,711051,Черкаська область
26166,711052,2161,39,1235,945,290,711052,Черкаська область
26167,711053,1738,35,1076,832,244,711053,Черкаська область
26168,711054,1690,40,1037,789,248,711054,Черкаська область
26169,711055,2037,40,1279,952,327,711055,Черкаська область
26170,711056,2342,44,1497,1130,367,711056,Черкаська область
26171,711057,2184,39,1162,908,254,711057,Черкаська область
26172,711058,2223,51,1354,1026,328,711058,Черкаська область
26173,711059,2128,28,1328,1011,317,711059,Черкаська область
26174,711060,1985,32,1242,937,305,711060,Черкаська область
26175,711061,2208,46,1304,991,313,711061,Черкаська область
26176,711062,2009,38,1279,959,320,711062,Черкаська область
26177,711063,1939,34,1132,865,267,711063,Черкаська область
26178,711064,1351,16,765,577,188,711064,Черкаська область
26179,711065,2037,36,1257,960,297,711065,Черкаська область
26180,711066,2147,42,1284,971,313,711066,Черкаська область
26181,711067,952,22,660,523,137,711067,Черкаська область
26182,711074,1290,23,751,540,211,711074,Черкаська область
26183,711075,1826,33,1151,815,336,711075,Черкаська область
26184,711076,2218,48,1363,951,412,711076,Черкаська область
26185,711077,2234,46,1381,1015,366,711077,Черкаська область
26186,711078,2316,37,1353,936,417,711078,Черкаська область
26187,711079,1383,13,789,587,202,711079,Черкаська область
26188,710001,1579,17,965,749,216,710001,Черкаська область
26189,710002,1397,25,790,635,155,710002,Черкаська область
26190,710003,1387,21,794,640,154,710003,Черкаська область
26191,710004,1407,22,794,641,153,710004,Черкаська область
26192,710005,862,14,516,428,88,710005,Черкаська область
26193,710006,742,9,430,346,84,710006,Черкаська область
26194,710007,1636,18,923,777,146,710007,Черкаська область
26195,710008,1696,16,928,772,156,710008,Черкаська область
26196,710009,262,2,157,140,17,710009,Черкаська область
26197,710010,122,0,85,65,20,710010,Черкаська область
26198,710011,1509,19,830,650,180,710011,Черкаська область
26199,710012,855,10,485,404,81,710012,Черкаська область
26200,710013,811,10,524,441,83,710013,Черкаська область
26201,710014,292,2,157,115,42,710014,Черкаська область
26202,710015,1185,12,701,569,132,710015,Черкаська область
26203,710016,557,3,309,265,44,710016,Черкаська область
26204,710017,1202,12,725,619,106,710017,Черкаська область
26205,710018,710,9,418,346,72,710018,Черкаська область
26206,710019,873,8,439,347,92,710019,Черкаська область
26207,710020,528,8,359,295,64,710020,Черкаська область
26208,710021,408,11,272,236,36,710021,Черкаська область
26209,710022,880,12,489,376,113,710022,Черкаська область
26210,710023,410,6,252,202,50,710023,Черкаська область
26211,710024,386,2,246,196,50,710024,Черкаська область
26212,710025,433,2,321,277,44,710025,Черкаська область
26213,710026,282,5,161,133,28,710026,Черкаська область
26214,710027,827,12,492,392,100,710027,Черкаська область
26215,710028,1104,10,580,481,99,710028,Черкаська область
26216,710029,1006,10,516,447,69,710029,Черкаська область
26217,710030,1319,10,745,633,112,710030,Черкаська область
26218,710031,413,5,241,184,57,710031,Черкаська область
26219,710032,796,9,438,379,59,710032,Черкаська область
26220,710033,1419,17,806,616,190,710033,Черкаська область
26221,710034,483,8,354,293,61,710034,Черкаська область
26222,710035,1702,27,909,770,139,710035,Черкаська область
26223,710263,335,3,183,161,22,710263,Черкаська область
26224,710266,277,0,150,124,26,710266,Черкаська область
26225,710274,204,1,124,104,20,710274,Черкаська область
26226,710280,871,10,480,408,72,710280,Черкаська область
26227,710281,140,2,81,64,17,710281,Черкаська область
26228,710282,589,8,354,295,59,710282,Черкаська область
26229,710283,240,1,166,149,17,710283,Черкаська область
26230,710284,91,2,58,49,9,710284,Черкаська область
26231,710285,455,2,280,239,41,710285,Черкаська область
26232,710287,214,6,130,108,22,710287,Черкаська область
26233,710289,206,1,123,96,27,710289,Черкаська область
26234,710290,173,2,101,77,24,710290,Черкаська область
26235,710291,104,1,70,55,15,710291,Черкаська область
26236,710298,890,7,502,419,83,710298,Черкаська область
26237,710299,671,6,366,300,66,710299,Черкаська область
26238,710300,286,0,167,143,24,710300,Черкаська область
26239,710301,439,8,225,195,30,710301,Черкаська область
26240,710302,310,4,170,135,35,710302,Черкаська область
26241,710303,133,2,82,67,15,710303,Черкаська область
26242,710310,338,3,222,184,38,710310,Черкаська область
26243,710311,424,8,325,285,40,710311,Черкаська область
26244,710312,515,1,308,229,79,710312,Черкаська область
26245,710313,145,4,115,95,20,710313,Черкаська область
26246,710314,274,3,169,146,23,710314,Черкаська область
26247,710315,176,0,109,84,25,710315,Черкаська область
26248,710316,365,5,215,160,55,710316,Черкаська область
26249,710317,324,4,191,137,54,710317,Черкаська область
26250,710318,1444,12,824,737,87,710318,Черкаська область
26251,710319,1665,24,895,775,120,710319,Черкаська область
26252,710320,589,13,369,331,38,710320,Черкаська область
26253,710321,457,2,277,227,50,710321,Черкаська область
26254,710322,1677,20,964,826,138,710322,Черкаська область
26255,710323,1339,18,743,643,100,710323,Черкаська область
26256,710324,1161,17,651,554,97,710324,Черкаська область
26257,710325,269,3,177,138,39,710325,Черкаська область
26258,710326,367,2,244,219,25,710326,Черкаська область
26259,710327,1325,8,758,585,173,710327,Черкаська область
26260,710328,625,7,395,347,48,710328,Черкаська область
26261,710329,437,7,326,256,70,710329,Черкаська область
26262,710330,550,6,325,254,71,710330,Черкаська область
26263,710331,237,4,147,125,22,710331,Черкаська область
26264,710332,331,7,194,149,45,710332,Черкаська область
26265,710333,542,8,353,291,62,710333,Черкаська область
26266,710334,132,6,83,80,3,710334,Черкаська область
26267,710335,375,5,235,202,33,710335,Черкаська область
26268,710336,329,0,215,172,43,710336,Черкаська область
26269,710337,320,5,229,182,47,710337,Черкаська область
26270,710338,218,4,130,115,15,710338,Черкаська область
26271,710339,1153,10,576,501,75,710339,Черкаська область
26272,710340,1131,25,644,508,136,710340,Черкаська область
26273,710341,1663,32,1015,775,240,710341,Черкаська область
26274,710342,769,11,479,377,102,710342,Черкаська область
26275,710343,1557,21,940,688,252,710343,Черкаська область
26276,710344,1319,19,825,661,164,710344,Черкаська область
26277,710345,1910,29,1115,875,240,710345,Черкаська область
26278,710346,1829,22,1067,835,232,710346,Черкаська область
26279,710347,1905,50,1114,880,234,710347,Черкаська область
26280,710348,1665,20,942,752,190,710348,Черкаська область
26281,710349,1287,18,744,607,137,710349,Черкаська область
26282,710350,1216,15,779,678,101,710350,Черкаська область
26283,710351,273,0,193,167,26,710351,Черкаська область
26284,710352,951,13,443,367,76,710352,Черкаська область
26285,710353,905,12,496,400,96,710353,Черкаська область
26286,710354,541,9,310,262,48,710354,Черкаська область
26287,710355,486,10,322,258,64,710355,Черкаська область
26288,710356,316,2,214,153,61,710356,Черкаська область
26289,710357,352,8,230,181,49,710357,Черкаська область
26290,710358,348,2,264,219,45,710358,Черкаська область
26291,710359,190,3,120,103,17,710359,Черкаська область
26292,710360,377,7,242,193,49,710360,Черкаська область
26293,710361,590,5,413,326,87,710361,Черкаська область
26294,710362,494,10,327,254,73,710362,Черкаська область
26295,710363,897,14,515,408,107,710363,Черкаська область
26296,710364,528,5,306,233,73,710364,Черкаська область
26297,710365,412,6,283,217,66,710365,Черкаська область
26298,710366,118,0,91,72,19,710366,Черкаська область
26299,710367,109,3,75,49,26,710367,Черкаська область
26300,710368,803,11,492,407,85,710368,Черкаська область
26301,710369,223,1,150,101,49,710369,Черкаська область
26302,710370,367,10,269,208,61,710370,Черкаська область
26303,710371,220,2,112,87,25,710371,Черкаська область
26304,710372,100,4,65,51,14,710372,Черкаська область
26305,710373,289,6,198,168,30,710373,Черкаська область
26306,710374,97,0,57,41,16,710374,Черкаська область
26307,710375,166,2,117,92,25,710375,Черкаська область
26308,710376,250,4,162,137,25,710376,Черкаська область
26309,710377,861,27,538,424,114,710377,Черкаська область
26310,710378,619,5,429,362,67,710378,Черкаська область
26311,710379,310,3,188,144,44,710379,Черкаська область
26312,710380,419,6,277,246,31,710380,Черкаська область
26313,710381,240,3,156,109,47,710381,Черкаська область
26314,710382,96,0,66,51,15,710382,Черкаська область
26315,710383,974,10,614,470,144,710383,Черкаська область
26316,710384,1045,10,707,571,136,710384,Черкаська область
26317,710385,193,0,146,118,28,710385,Черкаська область
26318,710386,99,0,55,47,8,710386,Черкаська область
26319,710387,493,7,297,252,45,710387,Черкаська область
26320,710388,145,0,108,99,9,710388,Черкаська область
26321,710389,287,6,179,142,37,710389,Черкаська область
26322,710390,523,8,316,215,101,710390,Черкаська область
26323,710391,240,3,152,122,30,710391,Черкаська область
26324,710392,151,4,114,60,54,710392,Черкаська область
26325,710393,466,2,276,225,51,710393,Черкаська область
26326,710394,579,8,345,262,83,710394,Черкаська область
26327,710395,69,0,38,29,9,710395,Черкаська область
26328,710396,33,0,30,19,11,710396,Черкаська область
26329,710403,389,3,251,182,69,710403,Черкаська область
26330,710404,215,3,145,108,37,710404,Черкаська область
26331,710411,593,3,354,277,77,710411,Черкаська область
26332,710412,121,0,62,52,10,710412,Черкаська область
26333,710420,903,6,545,407,138,710420,Черкаська область
26334,710421,147,5,105,70,35,710421,Черкаська область
26335,710433,270,4,165,125,40,710433,Черкаська область
26336,710563,579,5,432,348,84,710563,Черкаська область
26337,710564,183,2,114,85,29,710564,Черкаська область
26338,710565,406,8,267,179,88,710565,Черкаська область
26339,710567,474,5,275,218,57,710567,Черкаська область
26340,710569,446,7,258,200,58,710569,Черкаська область
26341,710570,536,6,335,290,45,710570,Черкаська область
26342,710571,703,5,402,320,82,710571,Черкаська область
26343,710572,511,9,291,209,82,710572,Черкаська область
26344,710573,324,3,211,154,57,710573,Черкаська область
26345,710574,211,0,125,91,34,710574,Черкаська область
26346,710575,486,3,276,233,43,710575,Черкаська область
26347,710576,420,5,239,200,39,710576,Черкаська область
26348,710578,514,4,323,184,139,710578,Черкаська область
26349,710579,71,1,51,39,12,710579,Черкаська область
26350,710582,680,9,344,293,51,710582,Черкаська область
26351,710583,462,3,250,208,42,710583,Черкаська область
26352,710584,1415,17,731,598,133,710584,Черкаська область
26353,710585,178,1,105,73,32,710585,Черкаська область
26354,710587,492,4,300,254,46,710587,Черкаська область
26355,710588,71,0,52,40,12,710588,Черкаська область
26356,710589,438,4,265,219,46,710589,Черкаська область
26357,710590,412,7,250,196,54,710590,Черкаська область
26358,710593,389,9,246,201,45,710593,Черкаська область
26359,710594,74,1,34,26,8,710594,Черкаська область
26360,710595,158,0,91,78,13,710595,Черкаська область
26361,710596,847,12,513,393,120,710596,Черкаська область
26362,710597,275,5,137,82,55,710597,Черкаська область
26363,710820,1954,38,1192,1017,175,710820,Черкаська область
26364,710821,2064,20,1219,1015,204,710821,Черкаська область
26365,710822,2059,22,1134,949,185,710822,Черкаська область
26366,710823,2318,36,1251,1058,193,710823,Черкаська область
26367,710824,1937,22,1147,986,161,710824,Черкаська область
26368,710825,1583,14,940,819,121,710825,Черкаська область
26369,710826,1066,23,585,489,96,710826,Черкаська область
26370,710827,1779,21,968,843,125,710827,Черкаська область
26371,710828,201,7,126,88,38,710828,Черкаська область
26372,710829,427,5,225,169,56,710829,Черкаська область
26373,710830,509,13,287,226,61,710830,Черкаська область
26374,710831,1067,3,680,553,127,710831,Черкаська область
26375,710832,360,3,214,183,31,710832,Черкаська область
26376,710833,128,3,83,67,16,710833,Черкаська область
26377,710834,610,6,387,325,62,710834,Черкаська область
26378,710835,880,8,496,400,96,710835,Черкаська область
26379,710836,674,8,458,420,38,710836,Черкаська область
26380,710837,142,1,76,61,15,710837,Черкаська область
26381,710838,379,9,256,223,33,710838,Черкаська область
26382,710839,608,14,340,269,71,710839,Черкаська область
26383,710840,1006,10,588,476,112,710840,Черкаська область
26384,710841,1202,3,719,598,121,710841,Черкаська область
26385,710842,842,8,556,447,109,710842,Черкаська область
26386,710843,811,9,454,356,98,710843,Черкаська область
26387,710844,898,3,598,463,135,710844,Черкаська область
26388,710845,898,13,513,431,82,710845,Черкаська область
26389,710846,155,1,97,64,33,710846,Черкаська область
26390,710847,760,8,493,395,98,710847,Черкаська область
26391,710848,835,6,496,375,121,710848,Черкаська область
26392,710849,920,14,487,386,101,710849,Черкаська область
26393,710850,389,6,274,224,50,710850,Черкаська область
26394,710851,313,1,212,147,65,710851,Черкаська область
26395,710852,183,3,103,82,21,710852,Черкаська область
26396,710853,1304,15,744,608,136,710853,Черкаська область
26397,710854,469,4,349,299,50,710854,Черкаська область
26398,710855,359,1,236,184,52,710855,Черкаська область
26399,710856,411,4,255,214,41,710856,Черкаська область
26400,710857,626,2,370,311,59,710857,Черкаська область
26401,710858,551,9,327,221,106,710858,Черкаська область
26402,710859,561,5,351,291,60,710859,Черкаська область
26403,710860,305,5,179,140,39,710860,Черкаська область
26404,710861,56,3,47,40,7,710861,Черкаська область
26405,711102,647,6,382,337,45,711102,Черкаська область
26406,710174,560,6,366,311,55,710174,Черкаська область
26407,710175,237,17,161,144,17,710175,Черкаська область
26408,710176,337,1,224,173,51,710176,Черкаська область
26409,710177,610,4,360,315,45,710177,Черкаська область
26410,710178,318,4,209,195,14,710178,Черкаська область
26411,710180,910,8,564,424,140,710180,Черкаська область
26412,710181,738,9,468,359,109,710181,Черкаська область
26413,710182,1680,43,999,857,142,710182,Черкаська область
26414,710183,1262,21,777,631,146,710183,Черкаська область
26415,710184,1364,17,769,664,105,710184,Черкаська область
26416,710185,1436,18,806,684,122,710185,Черкаська область
26417,710186,779,6,443,353,90,710186,Черкаська область
26418,710187,698,2,500,449,51,710187,Черкаська область
26419,710188,73,1,53,44,9,710188,Черкаська область
26420,710189,916,10,577,406,171,710189,Черкаська область
26421,710190,279,4,214,142,72,710190,Черкаська область
26422,710191,869,13,591,518,73,710191,Черкаська область
26423,710192,64,1,44,42,2,710192,Черкаська область
26424,710193,1592,22,988,769,219,710193,Черкаська область
26425,710194,809,6,518,434,84,710194,Черкаська область
26426,710196,578,10,363,292,71,710196,Черкаська область
26427,710197,194,4,131,121,10,710197,Черкаська область
26428,710198,505,5,333,294,39,710198,Черкаська область
26429,710199,323,0,279,262,17,710199,Черкаська область
26430,710200,343,5,298,226,72,710200,Черкаська область
26431,710201,68,0,57,43,14,710201,Черкаська область
26432,710202,417,7,259,209,50,710202,Черкаська область
26433,710203,175,3,104,70,34,710203,Черкаська область
26434,710204,860,8,567,436,131,710204,Черкаська область
26435,710205,288,5,190,149,41,710205,Черкаська область
26436,710206,413,8,243,189,54,710206,Черкаська область
26437,710207,828,18,535,426,109,710207,Черкаська область
26438,710208,144,2,111,93,18,710208,Черкаська область
26439,710209,167,1,100,82,18,710209,Черкаська область
26440,710210,431,4,278,190,88,710210,Черкаська область
26441,710211,707,10,399,332,67,710211,Черкаська область
26442,710212,1870,28,1158,942,216,710212,Черкаська область
26443,710213,411,6,237,214,23,710213,Черкаська область
26444,710214,178,3,98,77,21,710214,Черкаська область
26445,710215,394,18,232,178,54,710215,Черкаська область
26446,710216,449,8,300,241,59,710216,Черкаська область
26447,710217,1456,16,744,639,105,710217,Черкаська область
26448,710218,1230,8,654,600,54,710218,Черкаська область
26449,710219,116,2,74,63,11,710219,Черкаська область
26450,710220,588,8,416,318,98,710220,Черкаська область
26451,710221,363,3,197,154,43,710221,Черкаська область
26452,710222,426,5,270,199,71,710222,Черкаська область
26453,710223,378,5,254,210,44,710223,Черкаська область
26454,710224,176,3,128,114,14,710224,Черкаська область
26455,710225,457,5,279,229,50,710225,Черкаська область
26456,710226,1152,15,636,502,134,710226,Черкаська область
26457,710227,1352,19,810,651,159,710227,Черкаська область
26458,710228,419,2,256,193,63,710228,Черкаська область
26459,710229,150,1,84,71,13,710229,Черкаська область
26460,710264,680,7,396,302,94,710264,Черкаська область
26461,710265,156,1,96,82,14,710265,Черкаська область
26462,710267,202,7,112,82,30,710267,Черкаська область
26463,710268,479,4,294,231,63,710268,Черкаська область
26464,710269,841,21,509,442,67,710269,Черкаська область
26465,710270,253,3,142,112,30,710270,Черкаська область
26466,710271,189,0,106,97,9,710271,Черкаська область
26467,710272,298,1,197,140,57,710272,Черкаська область
26468,710273,236,2,173,132,41,710273,Черкаська область
26469,710275,161,0,93,68,25,710275,Черкаська область
26470,710276,1032,10,615,550,65,710276,Черкаська область
26471,710277,562,8,267,232,35,710277,Черкаська область
26472,710278,706,3,381,313,68,710278,Черкаська область
26473,710279,132,1,65,56,9,710279,Черкаська область
26474,710286,202,2,121,92,29,710286,Черкаська область
26475,710288,333,6,200,143,57,710288,Черкаська область
26476,710292,201,0,113,106,7,710292,Черкаська область
26477,710293,82,2,52,39,13,710293,Черкаська область
26478,710294,97,0,61,54,7,710294,Черкаська область
26479,710295,251,6,156,120,36,710295,Черкаська область
26480,710296,515,3,318,263,55,710296,Черкаська область
26481,710297,205,3,98,82,16,710297,Черкаська область
26482,710304,222,4,118,103,15,710304,Черкаська область
26483,710305,391,5,215,182,33,710305,Черкаська область
26484,710306,245,2,169,139,30,710306,Черкаська область
26485,710307,277,2,157,121,36,710307,Черкаська область
26486,710308,98,1,59,43,16,710308,Черкаська область
26487,710309,392,0,222,189,33,710309,Черкаська область
26488,710691,1323,13,734,650,84,710691,Черкаська область
26489,710696,1472,14,965,836,129,710696,Черкаська область
26490,710697,686,12,422,322,100,710697,Черкаська область
26491,710700,1291,20,880,679,201,710700,Черкаська область
26492,710701,1333,16,815,596,219,710701,Черкаська область
26493,710706,628,9,408,352,56,710706,Черкаська область
26494,710709,1883,23,1080,914,166,710709,Черкаська область
26495,710710,1750,19,866,733,133,710710,Черкаська область
26496,710711,1833,20,1043,890,153,710711,Черкаська область
26497,710712,2361,34,1470,1175,295,710712,Черкаська область
26498,710713,2354,39,1323,1045,278,710713,Черкаська область
26499,710716,2043,21,1203,956,247,710716,Черкаська область
26500,710717,177,1,116,88,28,710717,Черкаська область
26501,710718,616,10,373,310,63,710718,Черкаська область
26502,710719,488,4,298,249,49,710719,Черкаська область
26503,710722,949,7,551,446,105,710722,Черкаська область
26504,710723,418,5,249,209,40,710723,Черкаська область
26505,710724,425,2,265,220,45,710724,Черкаська область
26506,710725,270,7,173,141,32,710725,Черкаська область
26507,710735,1255,9,775,669,106,710735,Черкаська область
26508,710736,1325,10,672,562,110,710736,Черкаська область
26509,710876,1348,18,735,623,112,710876,Черкаська область
26510,710877,2043,18,1221,1041,180,710877,Черкаська область
26511,710878,2094,24,1272,1074,198,710878,Черкаська область
26512,710879,112,0,51,44,7,710879,Черкаська область
26513,710880,2343,30,1236,1030,206,710880,Черкаська область
26514,710881,1697,24,994,827,167,710881,Черкаська область
26515,710882,2307,39,1331,1086,245,710882,Черкаська область
26516,710883,1699,22,1093,873,220,710883,Черкаська область
26517,710884,1635,31,959,834,125,710884,Черкаська область
26518,710885,2154,36,1330,1105,225,710885,Черкаська область
26519,710886,1875,29,1134,946,188,710886,Черкаська область
26520,710887,2109,27,1271,1030,241,710887,Черкаська область
26521,710888,1872,49,1127,842,285,710888,Черкаська область
26522,710889,1766,34,1105,848,257,710889,Черкаська область
26523,710890,2092,34,1216,1002,214,710890,Черкаська область
26524,710892,2291,43,1388,1134,254,710892,Черкаська область
26525,710893,1763,30,1084,847,237,710893,Черкаська область
26526,710894,1767,22,951,785,166,710894,Черкаська область
26527,710895,2305,28,1337,1031,306,710895,Черкаська область
26528,710896,1608,17,913,758,155,710896,Черкаська область
26529,710898,1668,19,937,737,200,710898,Черкаська область
26530,710899,1986,22,1042,823,219,710899,Черкаська область
26531,710900,1897,25,993,792,201,710900,Черкаська область
26532,710901,28,0,22,17,5,710901,Черкаська область
26533,711030,1882,37,1061,812,249,711030,Черкаська область
26534,711031,2009,32,1167,884,283,711031,Черкаська область
26535,711032,1946,40,1137,876,261,711032,Черкаська область
26536,711033,1050,24,650,472,178,711033,Черкаська область
26537,711034,1526,17,876,640,236,711034,Черкаська область
26538,711035,805,11,487,380,107,711035,Черкаська область
26539,711037,1148,27,734,541,193,711037,Черкаська область
26540,711038,1332,27,831,611,220,711038,Черкаська область
26541,711068,2095,38,1252,932,320,711068,Черкаська область
26542,711069,1941,36,1139,907,232,711069,Черкаська область
26543,711070,2111,27,1288,942,346,711070,Черкаська область
26544,711071,1423,25,877,653,224,711071,Черкаська область
26545,711072,2312,51,1431,982,449,711072,Черкаська область
26546,711073,2388,34,1483,1087,396,711073,Черкаська область
26547,710230,724,6,388,314,74,710230,Черкаська область
26548,710231,1500,19,813,647,166,710231,Черкаська область
26549,710232,1531,26,899,737,162,710232,Черкаська область
26550,710233,1191,16,656,533,123,710233,Черкаська область
26551,710234,1188,15,675,510,165,710234,Черкаська область
26552,710235,1103,9,680,565,115,710235,Черкаська область
26553,710236,779,11,483,371,112,710236,Черкаська область
26554,710237,1307,21,725,582,143,710237,Черкаська область
26555,710238,1345,21,744,610,134,710238,Черкаська область
26556,710239,570,4,287,203,84,710239,Черкаська область
26557,710240,399,4,256,197,59,710240,Черкаська область
26558,710241,698,10,370,295,75,710241,Черкаська область
26559,710242,772,5,447,314,133,710242,Черкаська область
26560,710243,297,0,211,166,45,710243,Черкаська область
26561,710244,278,2,146,124,22,710244,Черкаська область
26562,710245,433,2,264,226,38,710245,Черкаська область
26563,710246,1059,18,580,483,97,710246,Черкаська область
26564,710247,140,0,77,57,20,710247,Черкаська область
26565,710248,394,5,224,184,40,710248,Черкаська область
26566,710249,166,3,87,66,21,710249,Черкаська область
26567,710250,133,2,71,54,17,710250,Черкаська область
26568,710251,407,3,216,140,76,710251,Черкаська область
26569,710252,1460,11,804,685,119,710252,Черкаська область
26570,710253,241,2,139,92,47,710253,Черкаська область
26571,710254,54,0,36,32,4,710254,Черкаська область
26572,710255,811,3,533,431,102,710255,Черкаська область
26573,710256,108,0,78,64,14,710256,Черкаська область
26574,710257,735,2,481,429,52,710257,Черкаська область
26575,710258,387,0,224,180,44,710258,Черкаська область
26576,710259,536,11,296,263,33,710259,Черкаська область
26577,710260,1013,4,546,451,95,710260,Черкаська область
26578,710261,551,6,362,311,51,710261,Черкаська область
26579,710262,831,11,494,422,72,710262,Черкаська область
26580,710510,1490,18,785,670,115,710510,Черкаська область
26581,710511,1383,17,796,661,135,710511,Черкаська область
26582,710512,591,6,305,259,46,710512,Черкаська область
26583,710513,436,8,264,236,28,710513,Черкаська область
26584,710514,1741,30,945,820,125,710514,Черкаська область
26585,710515,1491,13,804,597,207,710515,Черкаська область
26586,710516,356,1,248,209,39,710516,Черкаська область
26587,710517,72,3,42,34,8,710517,Черкаська область
26588,710518,225,4,140,114,26,710518,Черкаська область
26589,710519,458,5,238,186,52,710519,Черкаська область
26590,710520,492,8,300,244,56,710520,Черкаська область
26591,710521,2056,12,1155,980,175,710521,Черкаська область
26592,710522,1043,11,596,498,98,710522,Черкаська область
26593,710523,1241,15,743,560,183,710523,Черкаська область
26594,710524,496,5,269,204,65,710524,Черкаська область
26595,710525,902,10,554,460,94,710525,Черкаська область
26596,710526,201,1,149,126,23,710526,Черкаська область
26597,710527,460,5,244,199,45,710527,Черкаська область
26598,710528,665,7,385,319,66,710528,Черкаська область
26599,710529,429,7,253,195,58,710529,Черкаська область
26600,710530,885,18,631,498,133,710530,Черкаська область
26601,710531,605,20,359,298,61,710531,Черкаська область
26602,710532,642,4,322,263,59,710532,Черкаська область
26603,710533,338,1,195,138,57,710533,Черкаська область
26604,710534,198,0,137,114,23,710534,Черкаська область
26605,710535,604,11,335,272,63,710535,Черкаська область
26606,710536,399,7,240,194,46,710536,Черкаська область
26607,710537,176,2,138,125,13,710537,Черкаська область
26608,710538,693,8,404,307,97,710538,Черкаська область
26609,710539,64,0,46,39,7,710539,Черкаська область
26610,710540,1590,12,905,698,207,710540,Черкаська область
26611,710541,345,3,226,187,39,710541,Черкаська область
26612,710542,383,4,231,179,52,710542,Черкаська область
26613,710543,472,4,339,292,47,710543,Черкаська область
26614,710544,901,18,542,429,113,710544,Черкаська область
26615,710545,626,5,330,270,60,710545,Черкаська область
26616,710546,541,5,322,283,39,710546,Черкаська область
26617,710547,723,6,388,296,92,710547,Черкаська область
26618,710690,664,9,351,269,82,710690,Черкаська область
26619,710692,1381,13,683,571,112,710692,Черкаська область
26620,710693,1861,28,961,811,150,710693,Черкаська область
26621,710694,1854,17,930,803,127,710694,Черкаська область
26622,710695,1512,17,728,630,98,710695,Черкаська область
26623,710698,1854,21,1098,852,246,710698,Черкаська область
26624,710699,683,11,396,322,74,710699,Черкаська область
26625,710702,1657,12,989,782,207,710702,Черкаська область
26626,710703,1488,31,828,713,115,710703,Черкаська область
26627,710704,539,6,297,234,63,710704,Черкаська область
26628,710705,166,4,89,58,31,710705,Черкаська область
26629,710707,1325,14,798,645,153,710707,Черкаська область
26630,710708,1964,38,1184,914,270,710708,Черкаська область
26631,710714,1187,22,659,513,146,710714,Черкаська область
26632,710715,1231,19,632,546,86,710715,Черкаська область
26633,710720,2075,42,1130,937,193,710720,Черкаська область
26634,710721,497,4,252,195,57,710721,Черкаська область
26635,710726,1536,19,780,650,130,710726,Черкаська область
26636,710727,883,9,517,435,82,710727,Черкаська область
26637,710728,2019,39,1148,945,203,710728,Черкаська область
26638,710729,1870,30,1012,803,209,710729,Черкаська область
26639,710730,2195,32,1286,1022,264,710730,Черкаська область
26640,710731,1861,27,1059,873,186,710731,Черкаська область
26641,710732,2179,31,1326,1096,230,710732,Черкаська область
26642,710733,1601,19,1005,819,186,710733,Черкаська область
26643,710734,720,9,471,396,75,710734,Черкаська область
26644,710737,24,0,24,21,3,710737,Черкаська область
26645,710902,1400,24,812,668,144,710902,Черкаська область
26646,710903,1270,31,759,629,130,710903,Черкаська область
26647,710904,1766,26,1075,870,205,710904,Черкаська область
26648,710905,1993,41,1233,1016,217,710905,Черкаська область
26649,710906,1538,20,945,790,155,710906,Черкаська область
26650,710907,1944,41,1214,969,245,710907,Черкаська область
26651,710908,1081,16,682,545,137,710908,Черкаська область
26652,710909,879,9,524,419,105,710909,Черкаська область
26653,710910,1419,19,822,665,157,710910,Черкаська область
26654,710911,1556,30,968,768,200,710911,Черкаська область
26655,710912,1751,32,985,826,159,710912,Черкаська область
26656,710913,1498,26,891,711,180,710913,Черкаська область
26657,710914,2007,22,1126,932,194,710914,Черкаська область
26658,710915,1228,21,725,587,138,710915,Черкаська область
26659,710916,1117,17,538,455,83,710916,Черкаська область
26660,710917,1085,24,633,528,105,710917,Черкаська область
26661,710918,1984,23,1073,842,231,710918,Черкаська область
26662,710919,1811,21,1100,896,204,710919,Черкаська область
26663,710920,2045,47,1210,978,232,710920,Черкаська область
26664,710921,1517,23,843,680,163,710921,Черкаська область
26665,710922,1173,23,711,571,140,710922,Черкаська область
26666,710923,1527,21,962,773,189,710923,Черкаська область
26667,710924,973,16,574,472,102,710924,Черкаська область
26668,710925,1795,27,1023,843,180,710925,Черкаська область
26669,710926,1556,25,958,776,182,710926,Черкаська область
26670,710927,1698,31,958,794,164,710927,Черкаська область
26671,710928,2032,34,1137,933,204,710928,Черкаська область
26672,710929,2023,36,1199,991,208,710929,Черкаська область
26673,710930,1304,12,698,601,97,710930,Черкаська область
26674,710931,1634,21,977,847,130,710931,Черкаська область
26675,710932,1361,26,758,628,130,710932,Черкаська область
26676,710933,1468,19,796,667,129,710933,Черкаська область
26677,710934,744,16,503,411,92,710934,Черкаська область
26678,710935,403,24,243,186,57,710935,Черкаська область
26679,710936,49,0,41,30,11,710936,Черкаська область
26680,710937,32,1,28,23,5,710937,Черкаська область
26681,710938,14,0,12,10,2,710938,Черкаська область
26682,710084,2339,39,1399,1092,307,710084,Черкаська область
26683,710085,2004,38,1031,799,232,710085,Черкаська область
26684,710086,2332,35,1345,1026,319,710086,Черкаська область
26685,710087,2370,29,1332,1053,279,710087,Черкаська область
26686,710088,1157,15,671,551,120,710088,Черкаська область
26687,710089,1636,13,834,671,163,710089,Черкаська область
26688,710090,606,12,493,434,59,710090,Черкаська область
26689,710091,297,5,194,127,67,710091,Черкаська область
26690,710092,1485,84,841,597,244,710092,Черкаська область
26691,710093,224,1,156,108,48,710093,Черкаська область
26692,710094,731,7,425,340,85,710094,Черкаська область
26693,710095,542,4,332,244,88,710095,Черкаська область
26694,710096,384,6,278,169,109,710096,Черкаська область
26695,710097,431,5,296,217,79,710097,Черкаська область
26696,710098,511,6,375,296,79,710098,Черкаська область
26697,710099,400,7,240,194,46,710099,Черкаська область
26698,710100,101,0,67,44,23,710100,Черкаська область
26699,710101,127,5,97,83,14,710101,Черкаська область
26700,710102,436,8,267,203,64,710102,Черкаська область
26701,710103,640,5,437,361,76,710103,Черкаська область
26702,710104,553,9,355,282,73,710104,Черкаська область
26703,710105,153,1,116,61,55,710105,Черкаська область
26704,710106,782,14,479,367,112,710106,Черкаська область
26705,710107,456,8,302,234,68,710107,Черкаська область
26706,710108,525,8,325,257,68,710108,Черкаська область
26707,710109,627,11,392,315,77,710109,Черкаська область
26708,710110,527,5,344,239,105,710110,Черкаська область
26709,710111,527,2,369,302,67,710111,Черкаська область
26710,710112,735,12,424,310,114,710112,Черкаська область
26711,710113,360,6,256,164,92,710113,Черкаська область
26712,710114,1461,18,902,719,183,710114,Черкаська область
26713,710115,914,7,561,422,139,710115,Черкаська область
26714,710116,687,3,468,373,95,710116,Черкаська область
26715,710117,837,9,507,400,107,710117,Черкаська область
26716,710118,867,6,463,320,143,710118,Черкаська область
26717,710119,433,5,250,153,97,710119,Черкаська область
26718,710120,502,12,284,217,67,710120,Черкаська область
26719,710121,951,15,456,335,121,710121,Черкаська область
26720,710122,364,7,225,189,36,710122,Черкаська область
26721,710123,70,0,58,48,10,710123,Черкаська область
26722,710124,1838,20,1021,858,163,710124,Черкаська область
26723,710125,1268,12,681,578,103,710125,Черкаська область
26724,710126,979,15,554,410,144,710126,Черкаська область
26725,710127,1351,16,798,633,165,710127,Черкаська область
26726,710128,2063,27,1204,1000,204,710128,Черкаська область
26727,710129,1874,22,1093,910,183,710129,Черкаська область
26728,710130,2143,34,1276,1070,206,710130,Черкаська область
26729,710131,1485,18,887,735,152,710131,Черкаська область
26730,710132,1639,22,911,744,167,710132,Черкаська область
26731,710133,255,6,149,126,23,710133,Черкаська область
26732,710134,499,4,271,243,28,710134,Черкаська область
26733,710135,171,3,130,100,30,710135,Черкаська область
26734,710137,198,2,139,101,38,710137,Черкаська область
26735,710138,204,6,129,110,19,710138,Черкаська область
26736,710139,516,9,369,288,81,710139,Черкаська область
26737,710140,847,7,520,451,69,710140,Черкаська область
26738,710141,314,3,197,176,21,710141,Черкаська область
26739,710142,750,6,472,401,71,710142,Черкаська область
26740,710143,489,8,318,278,40,710143,Черкаська область
26741,710144,598,1,367,327,40,710144,Черкаська область
26742,710145,364,1,209,168,41,710145,Черкаська область
26743,710146,1060,16,614,518,96,710146,Черкаська область
26744,710147,332,4,236,194,42,710147,Черкаська область
26745,710148,1048,20,762,657,105,710148,Черкаська область
26746,710149,194,4,114,99,15,710149,Черкаська область
26747,710150,120,3,65,53,12,710150,Черкаська область
26748,710151,605,8,383,299,84,710151,Черкаська область
26749,710152,705,15,419,324,95,710152,Черкаська область
26750,710153,81,0,50,27,23,710153,Черкаська область
26751,710154,558,7,343,296,47,710154,Черкаська область
26752,710155,164,3,99,88,11,710155,Черкаська область
26753,710156,926,14,636,548,88,710156,Черкаська область
26754,710157,438,1,248,208,40,710157,Черкаська область
26755,710158,335,1,192,144,48,710158,Черкаська область
26756,710159,562,10,342,269,73,710159,Черкаська область
26757,710160,670,1,399,341,58,710160,Черкаська область
26758,710161,1016,15,570,522,48,710161,Черкаська область
26759,710162,1307,12,790,670,120,710162,Черкаська область
26760,710163,627,6,367,294,73,710163,Черкаська область
26761,710164,418,0,266,238,28,710164,Черкаська область
26762,710165,164,0,114,99,15,710165,Черкаська область
26763,710166,147,0,107,84,23,710166,Черкаська область
26764,710167,644,10,397,306,91,710167,Черкаська область
26765,710168,471,4,265,243,22,710168,Черкаська область
26766,710169,1060,15,681,496,185,710169,Черкаська область
26767,710170,603,12,334,267,67,710170,Черкаська область
26768,710171,1208,15,749,662,87,710171,Черкаська область
26769,710172,1046,8,608,520,88,710172,Черкаська область
26770,710173,50,0,50,35,15,710173,Черкаська область
26771,710397,2108,48,1136,879,257,710397,Черкаська область
26772,710398,2114,32,1188,916,272,710398,Черкаська область
26773,710399,2118,25,1209,912,297,710399,Черкаська область
26774,710400,524,2,336,251,85,710400,Черкаська область
26775,710401,63,0,51,33,18,710401,Черкаська область
26776,710402,450,4,354,269,85,710402,Черкаська область
26777,710405,1176,23,619,458,161,710405,Черкаська область
26778,710406,754,10,461,351,110,710406,Черкаська область
26779,710407,465,6,236,162,74,710407,Черкаська область
26780,710408,287,4,199,157,42,710408,Черкаська область
26781,710409,147,1,103,65,38,710409,Черкаська область
26782,710410,310,6,194,154,40,710410,Черкаська область
26783,710413,576,10,369,223,146,710413,Черкаська область
26784,710414,297,0,190,165,25,710414,Черкаська область
26785,710415,280,4,176,144,32,710415,Черкаська область
26786,710416,156,1,106,73,33,710416,Черкаська область
26787,710417,156,1,90,56,34,710417,Черкаська область
26788,710418,276,6,191,145,46,710418,Черкаська область
26789,710419,29,0,19,14,5,710419,Черкаська область
26790,710422,356,5,224,176,48,710422,Черкаська область
26791,710423,247,2,159,129,30,710423,Черкаська область
26792,710424,235,2,155,111,44,710424,Черкаська область
26793,710425,416,7,285,198,87,710425,Черкаська область
26794,710426,128,3,83,61,22,710426,Черкаська область
26795,710427,188,2,124,91,33,710427,Черкаська область
26796,710428,350,2,238,150,88,710428,Черкаська область
26797,710429,468,12,279,179,100,710429,Черкаська область
26798,710430,75,0,54,30,24,710430,Черкаська область
26799,710431,432,10,318,247,71,710431,Черкаська область
26800,710432,64,2,44,34,10,710432,Черкаська область
26801,710434,449,6,301,257,44,710434,Черкаська область
26802,710435,384,6,246,174,72,710435,Черкаська область
26803,710436,1414,18,771,576,195,710436,Черкаська область
26804,710437,1972,25,1183,932,251,710437,Черкаська область
26805,710438,1488,16,839,667,172,710438,Черкаська область
26806,710439,1936,37,1118,883,235,710439,Черкаська область
26807,710440,860,24,526,414,112,710440,Черкаська область
26808,710441,330,5,200,173,27,710441,Черкаська область
26809,710442,418,5,245,172,73,710442,Черкаська область
26810,710443,356,5,229,167,62,710443,Черкаська область
26811,710444,844,7,571,423,148,710444,Черкаська область
26812,710445,1199,9,721,560,161,710445,Черкаська область
26813,710446,610,9,400,333,67,710446,Черкаська область
26814,710447,1023,18,576,494,82,710447,Черкаська область
26815,710448,1041,12,616,524,92,710448,Черкаська область
26816,710449,156,3,102,73,29,710449,Черкаська область
26817,710450,319,0,186,138,48,710450,Черкаська область
26818,710451,642,7,441,382,59,710451,Черкаська область
26819,710452,475,9,299,249,50,710452,Черкаська область
26820,710453,470,7,250,173,77,710453,Черкаська область
26821,710454,256,4,175,112,63,710454,Черкаська область
26822,710455,1210,10,716,576,140,710455,Черкаська область
26823,710456,557,12,364,251,113,710456,Черкаська область
26824,710457,275,18,167,144,23,710457,Черкаська область
26825,710458,677,0,439,331,108,710458,Черкаська область
26826,710459,479,5,297,247,50,710459,Черкаська область
26827,710460,940,18,562,467,95,710460,Черкаська область
26828,710461,784,11,518,410,108,710461,Черкаська область
26829,710462,372,2,212,135,77,710462,Черкаська область
26830,710463,276,12,173,136,37,710463,Черкаська область
26831,710464,122,2,87,58,29,710464,Черкаська область
26832,710465,588,5,344,288,56,710465,Черкаська область
26833,710466,44,0,31,26,5,710466,Черкаська область
26834,710548,625,6,301,246,55,710548,Черкаська область
26835,710549,475,5,263,216,47,710549,Черкаська область
26836,710550,1149,26,712,570,142,710550,Черкаська область
26837,710551,1174,19,666,519,147,710551,Черкаська область
26838,710552,802,16,467,353,114,710552,Черкаська область
26839,710553,713,9,410,320,90,710553,Черкаська область
26840,710554,810,12,455,369,86,710554,Черкаська область
26841,710555,756,13,428,352,76,710555,Черкаська область
26842,710556,679,13,391,289,102,710556,Черкаська область
26843,710557,542,9,300,208,92,710557,Черкаська область
26844,710558,486,2,315,258,57,710558,Черкаська область
26845,710559,1266,15,758,590,168,710559,Черкаська область
26846,710560,659,8,368,309,59,710560,Черкаська область
26847,710561,474,2,267,201,66,710561,Черкаська область
26848,710562,1224,23,691,589,102,710562,Черкаська область
26849,710568,742,3,422,295,127,710568,Черкаська область
26850,710580,346,2,209,173,36,710580,Черкаська область
26851,710586,1364,18,758,611,147,710586,Черкаська область
26852,710591,475,2,256,196,60,710591,Черкаська область
26853,710592,590,8,334,260,74,710592,Черкаська область
26854,710862,1150,4,643,567,76,710862,Черкаська область
26855,710863,1127,12,654,536,118,710863,Черкаська область
26856,710864,1248,41,628,533,95,710864,Черкаська область
26857,710865,920,20,504,446,58,710865,Черкаська область
26858,710866,1775,24,1016,884,132,710866,Черкаська область
26859,710867,969,10,547,469,78,710867,Черкаська область
26860,710868,267,4,125,113,12,710868,Черкаська область
26861,710869,1012,14,594,512,82,710869,Черкаська область
26862,710870,1360,13,691,582,109,710870,Черкаська область
26863,710871,969,16,497,434,63,710871,Черкаська область
26864,710872,1288,11,663,583,80,710872,Черкаська область
26865,710873,226,2,139,124,15,710873,Черкаська область
26866,710874,563,5,296,265,31,710874,Черкаська область
26867,710875,19,0,19,17,2,710875,Черкаська область
26868,710467,1880,40,1039,807,232,710467,Черкаська область
26869,710468,1933,11,1095,851,244,710468,Черкаська область
26870,710469,2044,23,1129,880,249,710469,Черкаська область
26871,710470,1634,18,960,700,260,710470,Черкаська область
26872,710471,1270,12,702,560,142,710471,Черкаська область
26873,710472,1436,2,1040,886,154,710472,Черкаська область
26874,710473,1270,19,741,593,148,710473,Черкаська область
26875,710474,156,2,126,87,39,710474,Черкаська область
26876,710475,1524,26,862,721,141,710475,Черкаська область
26877,710476,1181,22,641,500,141,710476,Черкаська область
26878,710477,689,7,453,355,98,710477,Черкаська область
26879,710478,289,4,175,133,42,710478,Черкаська область
26880,710479,173,2,107,89,18,710479,Черкаська область
26881,710480,410,6,295,195,100,710480,Черкаська область
26882,710481,260,7,148,105,43,710481,Черкаська область
26883,710482,288,5,137,117,20,710482,Черкаська область
26884,710483,246,4,146,119,27,710483,Черкаська область
26885,710484,883,7,643,590,53,710484,Черкаська область
26886,710485,694,6,447,338,109,710485,Черкаська область
26887,710486,100,1,68,55,13,710486,Черкаська область
26888,710487,436,3,270,214,56,710487,Черкаська область
26889,710488,446,6,260,191,69,710488,Черкаська область
26890,710489,696,2,387,297,90,710489,Черкаська область
26891,710490,503,8,346,273,73,710490,Черкаська область
26892,710491,327,1,256,201,55,710491,Черкаська область
26893,710492,496,10,282,202,80,710492,Черкаська область
26894,710493,62,0,50,36,14,710493,Черкаська область
26895,710494,297,0,182,131,51,710494,Черкаська область
26896,710495,427,3,234,193,41,710495,Черкаська область
26897,710496,566,3,400,321,79,710496,Черкаська область
26898,710497,36,1,18,16,2,710497,Черкаська область
26899,710498,440,3,242,169,73,710498,Черкаська область
26900,710499,873,7,491,396,95,710499,Черкаська область
26901,710500,254,3,151,109,42,710500,Черкаська область
26902,710501,265,3,169,113,56,710501,Черкаська область
26903,710502,357,2,248,220,28,710502,Черкаська область
26904,710503,332,6,185,136,49,710503,Черкаська область
26905,710504,631,5,338,244,94,710504,Черкаська область
26906,710505,221,1,140,93,47,710505,Черкаська область
26907,710506,520,0,397,296,101,710506,Черкаська область
26908,710507,96,0,66,64,2,710507,Черкаська область
26909,710508,472,9,302,239,63,710508,Черкаська область
26910,710509,66,1,61,46,15,710509,Черкаська область
26911,710566,678,13,377,325,52,710566,Черкаська область
26912,710581,737,8,413,309,104,710581,Черкаська область
26913,710598,356,5,204,182,22,710598,Черкаська область
26914,710599,383,8,218,173,45,710599,Черкаська область
26915,710600,1623,18,843,681,162,710600,Черкаська область
26916,710601,577,12,379,268,111,710601,Черкаська область
26917,710602,183,5,126,97,29,710602,Черкаська область
26918,710603,119,1,86,46,40,710603,Черкаська область
26919,710604,557,5,324,265,59,710604,Черкаська область
26920,710605,1118,18,718,558,160,710605,Черкаська область
26921,710606,740,8,418,324,94,710606,Черкаська область
26922,710607,550,16,331,256,75,710607,Черкаська область
26923,710608,852,13,525,355,170,710608,Черкаська область
26924,710609,1634,21,1016,835,181,710609,Черкаська область
26925,710610,625,6,414,347,67,710610,Черкаська область
26926,710611,360,4,247,180,67,710611,Черкаська область
26927,710612,739,13,481,374,107,710612,Черкаська область
26928,710613,177,8,125,112,13,710613,Черкаська область
26929,710614,1105,9,558,389,169,710614,Черкаська область
26930,710615,357,5,223,179,44,710615,Черкаська область
26931,710616,115,0,85,56,29,710616,Черкаська область
26932,710617,148,0,82,71,11,710617,Черкаська область
26933,710618,650,11,399,270,129,710618,Черкаська область
26934,710619,1098,15,646,507,139,710619,Черкаська область
26935,710620,603,12,419,334,85,710620,Черкаська область
26936,710621,614,9,461,351,110,710621,Черкаська область
26937,710622,1682,31,920,644,276,710622,Черкаська область
26938,710623,314,6,180,152,28,710623,Черкаська область
26939,710624,747,7,483,374,109,710624,Черкаська область
26940,710625,252,6,185,135,50,710625,Черкаська область
26941,710626,1219,18,832,606,226,710626,Черкаська область
26942,710627,581,4,348,259,89,710627,Черкаська область
26943,710628,1053,17,645,499,146,710628,Черкаська область
26944,710629,242,2,139,124,15,710629,Черкаська область
26945,710630,459,1,292,240,52,710630,Черкаська область
26946,710631,240,2,127,91,36,710631,Черкаська область
26947,710632,110,2,66,47,19,710632,Черкаська область
26948,710633,584,7,388,326,62,710633,Черкаська область
26949,710634,300,3,192,125,67,710634,Черкаська область
26950,710635,1326,29,765,586,179,710635,Черкаська область
26951,710636,1460,20,906,712,194,710636,Черкаська область
26952,710637,448,5,277,199,78,710637,Черкаська область
26953,710638,198,2,133,131,2,710638,Черкаська область
26954,710639,599,2,348,268,80,710639,Черкаська область
26955,710640,1225,17,701,572,129,710640,Черкаська область
26956,710641,257,0,152,123,29,710641,Черкаська область
26957,710642,852,7,493,415,78,710642,Черкаська область
26958,710643,143,3,75,50,25,710643,Черкаська область
26959,710644,598,7,405,299,106,710644,Черкаська область
26960,710645,677,11,365,239,126,710645,Черкаська область
26961,710646,423,3,275,219,56,710646,Черкаська область
26962,710647,356,3,216,157,59,710647,Черкаська область
26963,710648,520,7,292,236,56,710648,Черкаська область
26964,710649,372,6,238,184,54,710649,Черкаська область
26965,710650,657,12,432,311,121,710650,Черкаська область
26966,710651,591,4,340,281,59,710651,Черкаська область
26967,710652,840,29,801,714,87,710652,Черкаська область
26968,710653,2382,30,1476,1156,320,710653,Черкаська область
26969,710654,2260,33,1172,942,230,710654,Черкаська область
26970,710655,2017,34,1110,893,217,710655,Черкаська область
26971,710656,2133,31,1219,998,221,710656,Черкаська область
26972,710657,1193,15,675,535,140,710657,Черкаська область
26973,710658,816,10,403,326,77,710658,Черкаська область
26974,710659,979,11,535,431,104,710659,Черкаська область
26975,710660,202,3,152,114,38,710660,Черкаська область
26976,710661,95,0,67,55,12,710661,Черкаська область
26977,710662,978,8,490,343,147,710662,Черкаська область
26978,710663,851,15,451,312,139,710663,Черкаська область
26979,710664,257,0,170,109,61,710664,Черкаська область
26980,710665,80,1,44,30,14,710665,Черкаська область
26981,710666,391,3,270,219,51,710666,Черкаська область
26982,710667,147,1,100,58,42,710667,Черкаська область
26983,710668,722,8,392,300,92,710668,Черкаська область
26984,710669,858,14,517,427,90,710669,Черкаська область
26985,710670,484,6,293,239,54,710670,Черкаська область
26986,710671,415,4,290,221,69,710671,Черкаська область
26987,710672,184,1,124,101,23,710672,Черкаська область
26988,710673,240,1,157,132,25,710673,Черкаська область
26989,710674,469,4,380,325,55,710674,Черкаська область
26990,710675,672,5,471,400,71,710675,Черкаська область
26991,710676,353,3,204,161,43,710676,Черкаська область
26992,710677,995,9,549,429,120,710677,Черкаська область
26993,710678,273,3,163,113,50,710678,Черкаська область
26994,710679,563,16,400,329,71,710679,Черкаська область
26995,710680,566,6,346,231,115,710680,Черкаська область
26996,710681,336,2,252,218,34,710681,Черкаська область
26997,710682,463,8,317,235,82,710682,Черкаська область
26998,710683,70,0,51,37,14,710683,Черкаська область
26999,710684,1321,21,683,565,118,710684,Черкаська область
27000,710685,674,7,389,336,53,710685,Черкаська область
27001,710686,631,6,365,284,81,710686,Черкаська область
27002,710687,186,35,80,49,31,710687,Черкаська область
27003,710688,519,2,315,250,65,710688,Черкаська область
27004,710689,590,5,332,280,52,710689,Черкаська область
27005,710940,1488,26,919,686,233,710940,Черкаська область
27006,710941,1548,29,938,714,224,710941,Черкаська область
27007,710942,1463,25,865,601,264,710942,Черкаська область
27008,710943,2206,33,1344,1038,306,710943,Черкаська область
27009,710944,2110,42,1292,1030,262,710944,Черкаська область
27010,710945,2210,38,1386,1077,309,710945,Черкаська область
27011,710946,2082,39,1255,963,292,710946,Черкаська область
27012,710947,1854,37,1105,892,213,710947,Черкаська область
27013,710948,1526,26,911,720,191,710948,Черкаська область
27014,710949,1536,27,873,648,225,710949,Черкаська область
27015,710950,1863,46,1136,866,270,710950,Черкаська область
27016,710951,1567,31,851,668,183,710951,Черкаська область
27017,710952,1459,37,844,647,197,710952,Черкаська область
27018,710953,1419,26,861,687,174,710953,Черкаська область
27019,710954,1672,23,1048,739,309,710954,Черкаська область
27020,710955,1743,27,1139,840,299,710955,Черкаська область
27021,710956,1767,30,1093,853,240,710956,Черкаська область
27022,710957,2000,51,1212,920,292,710957,Черкаська область
27023,710958,1582,30,966,707,259,710958,Черкаська область
27024,710959,2147,48,1224,966,258,710959,Черкаська область
27025,710960,1495,19,935,737,198,710960,Черкаська область
27026,710961,1829,35,1078,835,243,710961,Черкаська область
27027,710962,2204,26,1276,1014,262,710962,Черкаська область
27028,710963,1974,31,1138,872,266,710963,Черкаська область
27029,710964,1709,29,1032,783,249,710964,Черкаська область
27030,710965,1932,35,1018,789,229,710965,Черкаська область
27031,710966,1956,46,1177,926,251,710966,Черкаська область
27032,710967,1953,31,1152,862,290,710967,Черкаська область
27033,710968,2167,35,1330,1023,307,710968,Черкаська область
27034,710969,1441,23,772,607,165,710969,Черкаська область
27035,710970,1642,24,884,659,225,710970,Черкаська область
27036,710971,1945,21,1130,891,239,710971,Черкаська область
27037,710972,1632,33,956,738,218,710972,Черкаська область
27038,710973,62,3,56,41,15,710973,Черкаська область
27039,710974,120,1,113,105,8,710974,Черкаська область
27040,711101,46,0,40,37,3,711101,Черкаська область
27041,1,226,5,220,143,77,1,Чернівецька область
27042,730446,1766,21,1005,736,269,730446,Чернівецька область
27043,730447,2225,32,1224,911,313,730447,Чернівецька область
27044,730448,2398,26,887,666,221,730448,Чернівецька область
27045,730449,1999,38,1068,816,252,730449,Чернівецька область
27046,730450,1995,39,1079,760,319,730450,Чернівецька область
27047,730451,806,19,478,314,164,730451,Чернівецька область
27048,730452,866,16,509,363,146,730452,Чернівецька область
27049,730453,899,26,538,378,160,730453,Чернівецька область
27050,730454,1057,19,622,429,193,730454,Чернівецька область
27051,730455,1035,17,590,425,165,730455,Чернівецька область
27052,730456,1654,33,955,635,320,730456,Чернівецька область
27053,730457,2022,39,1171,818,353,730457,Чернівецька область
27054,730458,1465,20,846,625,221,730458,Чернівецька область
27055,730459,1969,29,1149,808,341,730459,Чернівецька область
27056,730460,2245,53,1417,1079,338,730460,Чернівецька область
27057,730461,2235,25,1319,904,415,730461,Чернівецька область
27058,730462,1720,21,920,657,263,730462,Чернівецька область
27059,730463,2395,39,1428,1032,396,730463,Чернівецька область
27060,730464,1163,20,680,452,228,730464,Чернівецька область
27061,730465,2407,27,1258,945,313,730465,Чернівецька область
27062,730466,1914,25,1046,746,300,730466,Чернівецька область
27063,730467,2086,24,1245,859,386,730467,Чернівецька область
27064,730468,2103,31,1212,850,362,730468,Чернівецька область
27065,730469,2155,21,1119,787,332,730469,Чернівецька область
27066,730470,2031,29,1147,837,310,730470,Чернівецька область
27067,730471,2217,39,1293,883,410,730471,Чернівецька область
27068,730472,2283,28,1369,967,402,730472,Чернівецька область
27069,730473,1148,11,618,495,123,730473,Чернівецька область
27070,730474,2152,25,1202,886,316,730474,Чернівецька область
27071,730475,29,0,22,20,2,730475,Чернівецька область
27072,730476,82,1,70,55,15,730476,Чернівецька область
27073,730477,60,1,57,48,9,730477,Чернівецька область
27074,730478,21,1,18,9,9,730478,Чернівецька область
27075,730479,76,4,64,46,18,730479,Чернівецька область
27076,730480,2145,14,1105,740,365,730480,Чернівецька область
27077,730487,2292,21,1142,886,256,730487,Чернівецька область
27078,730488,2450,34,1351,971,380,730488,Чернівецька область
27079,730489,2074,37,1093,701,392,730489,Чернівецька область
27080,730490,2414,37,1333,882,451,730490,Чернівецька область
27081,730491,133,11,106,52,54,730491,Чернівецька область
27082,730492,19,0,17,11,6,730492,Чернівецька область
27083,730493,1488,23,878,570,308,730493,Чернівецька область
27084,730494,1816,31,997,733,264,730494,Чернівецька область
27085,730495,1413,23,805,584,221,730495,Чернівецька область
27086,730496,2041,33,1137,781,356,730496,Чернівецька область
27087,730497,1747,32,1023,680,343,730497,Чернівецька область
27088,730498,1564,17,830,609,221,730498,Чернівецька область
27089,730499,977,11,570,411,159,730499,Чернівецька область
27090,730500,1988,39,1206,827,379,730500,Чернівецька область
27091,730501,2213,29,1200,886,314,730501,Чернівецька область
27092,730502,2028,43,1190,845,345,730502,Чернівецька область
27093,730503,2236,43,1277,876,401,730503,Чернівецька область
27094,730504,2344,50,1386,987,399,730504,Чернівецька область
27095,730505,2246,32,1024,744,280,730505,Чернівецька область
27096,730506,2285,43,1062,775,287,730506,Чернівецька область
27097,730507,1318,12,686,476,210,730507,Чернівецька область
27098,730508,2105,35,1202,918,284,730508,Чернівецька область
27099,730509,2160,46,1306,932,374,730509,Чернівецька область
27100,730510,2086,27,1083,775,308,730510,Чернівецька область
27101,730511,2112,49,1221,865,356,730511,Чернівецька область
27102,730512,1845,25,1066,735,331,730512,Чернівецька область
27103,730513,1824,29,948,654,294,730513,Чернівецька область
27104,730514,1962,45,1204,814,390,730514,Чернівецька область
27105,730515,1907,41,1088,734,354,730515,Чернівецька область
27106,730516,2249,32,1293,924,369,730516,Чернівецька область
27107,730517,2160,39,1248,869,379,730517,Чернівецька область
27108,730518,2215,34,1332,963,369,730518,Чернівецька область
27109,730519,2214,52,1324,879,445,730519,Чернівецька область
27110,730520,2092,39,1228,833,395,730520,Чернівецька область
27111,730521,1817,42,1008,708,300,730521,Чернівецька область
27112,730522,1770,39,1071,738,333,730522,Чернівецька область
27113,730523,2215,34,1242,831,411,730523,Чернівецька область
27114,730524,981,23,570,399,171,730524,Чернівецька область
27115,730525,887,13,552,343,209,730525,Чернівецька область
27116,730526,2143,46,1284,913,371,730526,Чернівецька область
27117,730527,2137,34,1184,864,320,730527,Чернівецька область
27118,730528,2062,31,1244,887,357,730528,Чернівецька область
27119,730529,1320,18,761,520,241,730529,Чернівецька область
27120,730530,2170,39,1278,877,401,730530,Чернівецька область
27121,730531,2334,49,1399,951,448,730531,Чернівецька область
27122,730532,2171,34,1278,879,399,730532,Чернівецька область
27123,730533,2314,42,1346,961,385,730533,Чернівецька область
27124,730534,2138,29,1255,900,355,730534,Чернівецька область
27125,730535,1985,19,1013,749,264,730535,Чернівецька область
27126,730536,1330,21,697,501,196,730536,Чернівецька область
27127,730537,1212,14,622,457,165,730537,Чернівецька область
27128,730538,2195,27,1199,826,373,730538,Чернівецька область
27129,730539,1535,25,824,611,213,730539,Чернівецька область
27130,730540,1426,23,807,638,169,730540,Чернівецька область
27131,730541,900,14,381,313,68,730541,Чернівецька область
27132,730542,2290,34,1321,959,362,730542,Чернівецька область
27133,730543,2001,34,1121,832,289,730543,Чернівецька область
27134,730544,1708,12,792,642,150,730544,Чернівецька область
27135,730545,1697,36,937,651,286,730545,Чернівецька область
27136,730546,37,2,32,23,9,730546,Чернівецька область
27137,730547,40,0,35,28,7,730547,Чернівецька область
27138,730548,21,1,19,13,6,730548,Чернівецька область
27139,730549,18,0,16,10,6,730549,Чернівецька область
27140,730550,38,1,18,14,4,730550,Чернівецька область
27141,730553,20,0,19,11,8,730553,Чернівецька область
27142,730554,23,0,19,15,4,730554,Чернівецька область
27143,730555,2,0,2,2,0,730555,Чернівецька область
27144,730556,50,5,42,36,6,730556,Чернівецька область
27145,730557,1311,14,722,493,229,730557,Чернівецька область
27146,730558,1432,31,822,539,283,730558,Чернівецька область
27147,730560,2253,26,1310,975,335,730560,Чернівецька область
27148,730564,2228,40,1302,874,428,730564,Чернівецька область
27149,1,24,0,24,6,18,1,Чернівецька область
27150,730001,1056,18,543,398,145,730001,Чернівецька область
27151,730002,1201,13,697,490,207,730002,Чернівецька область
27152,730003,1074,17,592,442,150,730003,Чернівецька область
27153,730004,1078,10,572,421,151,730004,Чернівецька область
27154,730005,1414,12,745,564,181,730005,Чернівецька область
27155,730006,1502,20,755,601,154,730006,Чернівецька область
27156,730007,307,0,146,127,19,730007,Чернівецька область
27157,730008,2417,48,1197,915,282,730008,Чернівецька область
27158,730009,2197,26,1023,742,281,730009,Чернівецька область
27159,730010,1502,16,702,554,148,730010,Чернівецька область
27160,730011,1102,9,491,413,78,730011,Чернівецька область
27161,730012,929,13,529,426,103,730012,Чернівецька область
27162,730013,1519,13,753,551,202,730013,Чернівецька область
27163,730014,1541,16,754,560,194,730014,Чернівецька область
27164,730015,456,5,255,135,120,730015,Чернівецька область
27165,730016,1068,17,580,432,148,730016,Чернівецька область
27166,730017,490,0,303,266,37,730017,Чернівецька область
27167,730018,581,5,340,273,67,730018,Чернівецька область
27168,730019,897,18,534,400,134,730019,Чернівецька область
27169,730020,1559,20,816,658,158,730020,Чернівецька область
27170,730021,2388,36,1312,1014,298,730021,Чернівецька область
27171,730022,1196,13,697,576,121,730022,Чернівецька область
27172,730023,169,4,99,70,29,730023,Чернівецька область
27173,730024,1506,6,768,542,226,730024,Чернівецька область
27174,730025,475,4,263,192,71,730025,Чернівецька область
27175,730026,519,9,241,157,84,730026,Чернівецька область
27176,730027,1684,15,883,609,274,730027,Чернівецька область
27177,730028,664,6,378,244,134,730028,Чернівецька область
27178,730029,669,15,353,289,64,730029,Чернівецька область
27179,730030,1265,21,664,548,116,730030,Чернівецька область
27180,730031,474,5,217,163,54,730031,Чернівецька область
27181,730032,545,7,285,201,84,730032,Чернівецька область
27182,730033,1937,12,996,772,224,730033,Чернівецька область
27183,730034,958,9,522,423,99,730034,Чернівецька область
27184,730035,492,2,261,207,54,730035,Чернівецька область
27185,730036,1719,25,1035,779,256,730036,Чернівецька область
27186,730037,444,6,274,197,77,730037,Чернівецька область
27187,730038,148,4,82,57,25,730038,Чернівецька область
27188,730039,687,8,365,303,62,730039,Чернівецька область
27189,730040,934,6,477,380,97,730040,Чернівецька область
27190,730041,2285,36,1175,978,197,730041,Чернівецька область
27191,730185,2216,30,1228,820,408,730185,Чернівецька область
27192,730186,1328,22,716,472,244,730186,Чернівецька область
27193,730187,1942,33,1089,756,333,730187,Чернівецька область
27194,730188,2104,25,1274,865,409,730188,Чернівецька область
27195,730189,1563,22,900,539,361,730189,Чернівецька область
27196,730190,1857,17,966,684,282,730190,Чернівецька область
27197,730191,751,7,433,319,114,730191,Чернівецька область
27198,730192,705,7,490,358,132,730192,Чернівецька область
27199,730193,269,4,194,152,42,730193,Чернівецька область
27200,730194,643,8,365,261,104,730194,Чернівецька область
27201,730195,511,6,317,219,98,730195,Чернівецька область
27202,730196,1148,11,581,352,229,730196,Чернівецька область
27203,730197,1494,21,887,648,239,730197,Чернівецька область
27204,730198,244,4,166,139,27,730198,Чернівецька область
27205,730199,632,11,371,274,97,730199,Чернівецька область
27206,730200,477,9,296,229,67,730200,Чернівецька область
27207,730201,181,3,76,60,16,730201,Чернівецька область
27208,730202,469,8,277,169,108,730202,Чернівецька область
27209,730203,1173,25,651,510,141,730203,Чернівецька область
27210,730204,863,6,501,399,102,730204,Чернівецька область
27211,730205,331,1,153,132,21,730205,Чернівецька область
27212,730206,1210,24,618,511,107,730206,Чернівецька область
27213,730207,152,0,103,81,22,730207,Чернівецька область
27214,730208,809,10,419,296,123,730208,Чернівецька область
27215,730209,1844,37,941,579,362,730209,Чернівецька область
27216,730210,400,5,200,147,53,730210,Чернівецька область
27217,730211,999,18,694,529,165,730211,Чернівецька область
27218,730212,240,4,132,100,32,730212,Чернівецька область
27219,730213,1004,9,554,400,154,730213,Чернівецька область
27220,730214,2008,28,1035,649,386,730214,Чернівецька область
27221,730215,1216,12,640,482,158,730215,Чернівецька область
27222,730216,774,11,449,328,121,730216,Чернівецька область
27223,730217,1246,14,622,458,164,730217,Чернівецька область
27224,730218,892,13,519,377,142,730218,Чернівецька область
27225,730219,2053,28,1156,794,362,730219,Чернівецька область
27226,730220,1788,15,945,679,266,730220,Чернівецька область
27227,730221,1174,14,634,444,190,730221,Чернівецька область
27228,730222,857,8,488,386,102,730222,Чернівецька область
27229,730223,1338,10,723,520,203,730223,Чернівецька область
27230,730224,1733,17,1055,858,197,730224,Чернівецька область
27231,730225,1551,23,923,621,302,730225,Чернівецька область
27232,730226,1551,20,946,639,307,730226,Чернівецька область
27233,730227,212,0,153,87,66,730227,Чернівецька область
27234,730228,799,2,509,332,177,730228,Чернівецька область
27235,730229,1532,17,816,566,250,730229,Чернівецька область
27236,730230,1334,22,767,505,262,730230,Чернівецька область
27237,730231,462,6,246,160,86,730231,Чернівецька область
27238,730232,2375,20,1356,862,494,730232,Чернівецька область
27239,730233,1206,23,760,574,186,730233,Чернівецька область
27240,730234,865,14,424,295,129,730234,Чернівецька область
27241,730235,89,2,75,51,24,730235,Чернівецька область
27242,730279,2157,30,1160,985,175,730279,Чернівецька область
27243,730280,976,11,518,457,61,730280,Чернівецька область
27244,730281,442,8,283,264,19,730281,Чернівецька область
27245,730282,321,0,297,217,80,730282,Чернівецька область
27246,730283,1065,7,634,559,75,730283,Чернівецька область
27247,730284,392,5,230,197,33,730284,Чернівецька область
27248,730285,1249,10,696,612,84,730285,Чернівецька область
27249,730286,377,3,207,168,39,730286,Чернівецька область
27250,730287,1224,17,680,578,102,730287,Чернівецька область
27251,730288,327,4,158,132,26,730288,Чернівецька область
27252,730289,500,6,269,225,44,730289,Чернівецька область
27253,730290,504,10,294,271,23,730290,Чернівецька область
27254,730291,522,6,288,252,36,730291,Чернівецька область
27255,730292,324,2,149,124,25,730292,Чернівецька область
27256,730293,760,17,457,367,90,730293,Чернівецька область
27257,730294,661,10,386,317,69,730294,Чернівецька область
27258,730295,160,1,80,72,8,730295,Чернівецька область
27259,730296,1500,20,840,612,228,730296,Чернівецька область
27260,730297,1245,18,648,488,160,730297,Чернівецька область
27261,730298,295,1,144,118,26,730298,Чернівецька область
27262,730299,942,13,511,454,57,730299,Чернівецька область
27263,730300,269,1,211,185,26,730300,Чернівецька область
27264,730301,293,3,160,137,23,730301,Чернівецька область
27265,730302,779,6,441,367,74,730302,Чернівецька область
27266,730303,590,7,325,275,50,730303,Чернівецька область
27267,730304,258,4,152,128,24,730304,Чернівецька область
27268,730305,75,1,37,29,8,730305,Чернівецька область
27269,730306,697,13,449,394,55,730306,Чернівецька область
27270,730307,77,2,53,44,9,730307,Чернівецька область
27271,730338,2308,33,1221,956,265,730338,Чернівецька область
27272,730339,2172,23,1227,919,308,730339,Чернівецька область
27273,730340,1518,27,716,569,147,730340,Чернівецька область
27274,730341,1717,25,839,691,148,730341,Чернівецька область
27275,730342,2108,25,1019,822,197,730342,Чернівецька область
27276,730343,1637,20,686,616,70,730343,Чернівецька область
27277,730344,2448,39,879,826,53,730344,Чернівецька область
27278,730345,2455,43,807,749,58,730345,Чернівецька область
27279,730346,2428,46,857,831,26,730346,Чернівецька область
27280,730347,2265,33,1163,839,324,730347,Чернівецька область
27281,730348,242,0,129,87,42,730348,Чернівецька область
27282,730349,509,8,263,187,76,730349,Чернівецька область
27283,730350,1333,8,659,528,131,730350,Чернівецька область
27284,730351,1038,17,495,461,34,730351,Чернівецька область
27285,730355,1672,11,755,720,35,730355,Чернівецька область
27286,730356,1282,18,524,470,54,730356,Чернівецька область
27287,730357,1320,7,574,456,118,730357,Чернівецька область
27288,730358,1073,2,353,309,44,730358,Чернівецька область
27289,730359,1225,9,556,476,80,730359,Чернівецька область
27290,730360,2412,21,795,747,48,730360,Чернівецька область
27291,730361,1750,18,560,490,70,730361,Чернівецька область
27292,730364,883,7,443,370,73,730364,Чернівецька область
27293,730365,816,5,441,275,166,730365,Чернівецька область
27294,730366,484,1,239,153,86,730366,Чернівецька область
27295,730368,630,5,333,266,67,730368,Чернівецька область
27296,730369,708,10,399,290,109,730369,Чернівецька область
27297,730370,561,4,277,218,59,730370,Чернівецька область
27298,730371,2429,20,1008,956,52,730371,Чернівецька область
27299,730372,646,7,249,217,32,730372,Чернівецька область
27300,730373,1066,10,616,448,168,730373,Чернівецька область
27301,730374,576,9,336,287,49,730374,Чернівецька область
27302,730375,2065,30,1098,881,217,730375,Чернівецька область
27303,730378,697,12,392,321,71,730378,Чернівецька область
27304,730381,673,1,334,275,59,730381,Чернівецька область
27305,730382,413,5,197,160,37,730382,Чернівецька область
27306,730383,631,5,302,223,79,730383,Чернівецька область
27307,730384,1651,12,770,576,194,730384,Чернівецька область
27308,730385,705,6,356,276,80,730385,Чернівецька область
27309,730386,561,3,327,222,105,730386,Чернівецька область
27310,730387,602,6,316,271,45,730387,Чернівецька область
27311,730390,1035,7,545,483,62,730390,Чернівецька область
27312,730391,2495,28,952,837,115,730391,Чернівецька область
27313,730392,1596,20,597,563,34,730392,Чернівецька область
27314,730393,129,1,104,78,26,730393,Чернівецька область
27315,730394,50,1,26,23,3,730394,Чернівецька область
27316,1,24,1,11,6,5,1,Чернівецька область
27317,730042,1724,14,794,713,81,730042,Чернівецька область
27318,730043,1457,22,777,738,39,730043,Чернівецька область
27319,730044,536,5,256,232,24,730044,Чернівецька область
27320,730045,695,6,361,347,14,730045,Чернівецька область
27321,730046,994,9,540,492,48,730046,Чернівецька область
27322,730047,446,8,224,201,23,730047,Чернівецька область
27323,730048,1278,9,680,650,30,730048,Чернівецька область
27324,730049,670,4,366,357,9,730049,Чернівецька область
27325,730050,931,7,483,440,43,730050,Чернівецька область
27326,730051,426,1,248,208,40,730051,Чернівецька область
27327,730052,593,7,301,281,20,730052,Чернівецька область
27328,730053,560,13,304,269,35,730053,Чернівецька область
27329,730054,612,2,328,301,27,730054,Чернівецька область
27330,730055,728,10,342,325,17,730055,Чернівецька область
27331,730056,471,4,237,223,14,730056,Чернівецька область
27332,730057,1613,22,801,753,48,730057,Чернівецька область
27333,730058,1490,18,707,670,37,730058,Чернівецька область
27334,730059,1646,25,742,684,58,730059,Чернівецька область
27335,730060,1608,20,1050,975,75,730060,Чернівецька область
27336,730061,2232,27,912,842,70,730061,Чернівецька область
27337,730062,895,8,410,380,30,730062,Чернівецька область
27338,730063,1561,14,749,724,25,730063,Чернівецька область
27339,730064,802,21,462,441,21,730064,Чернівецька область
27340,730065,392,7,258,192,66,730065,Чернівецька область
27341,730066,367,3,198,182,16,730066,Чернівецька область
27342,730067,1857,40,926,671,255,730067,Чернівецька область
27343,730068,1869,16,873,680,193,730068,Чернівецька область
27344,730069,1639,26,898,668,230,730069,Чернівецька область
27345,730070,1564,11,792,548,244,730070,Чернівецька область
27346,730071,1048,19,381,307,74,730071,Чернівецька область
27347,730072,1444,18,679,560,119,730072,Чернівецька область
27348,730073,1472,20,667,624,43,730073,Чернівецька область
27349,730074,2443,50,1153,1103,50,730074,Чернівецька область
27350,730075,913,14,498,480,18,730075,Чернівецька область
27351,730076,1750,15,932,891,41,730076,Чернівецька область
27352,730077,2274,27,1177,896,281,730077,Чернівецька область
27353,730078,2449,57,1085,845,240,730078,Чернівецька область
27354,730079,1566,25,812,777,35,730079,Чернівецька область
27355,730080,2531,14,1221,985,236,730080,Чернівецька область
27356,730081,1258,14,542,463,79,730081,Чернівецька область
27357,730082,1990,18,865,818,47,730082,Чернівецька область
27358,730083,1064,19,582,477,105,730083,Чернівецька область
27359,730084,309,4,127,102,25,730084,Чернівецька область
27360,730085,499,6,281,172,109,730085,Чернівецька область
27361,730086,455,5,248,155,93,730086,Чернівецька область
27362,730087,1712,25,815,709,106,730087,Чернівецька область
27363,730088,1238,23,604,529,75,730088,Чернівецька область
27364,730089,1823,24,825,775,50,730089,Чернівецька область
27365,730090,402,7,211,161,50,730090,Чернівецька область
27366,730091,670,12,394,353,41,730091,Чернівецька область
27367,730092,316,6,204,173,31,730092,Чернівецька область
27368,730093,1076,5,507,456,51,730093,Чернівецька область
27369,730094,1082,16,468,396,72,730094,Чернівецька область
27370,730095,1495,11,833,592,241,730095,Чернівецька область
27371,730096,84,1,52,40,12,730096,Чернівецька область
27372,730097,928,17,584,424,160,730097,Чернівецька область
27373,730098,1326,11,669,635,34,730098,Чернівецька область
27374,730099,438,8,272,210,62,730099,Чернівецька область
27375,730100,533,6,298,286,12,730100,Чернівецька область
27376,730101,262,7,174,156,18,730101,Чернівецька область
27377,730102,777,6,395,336,59,730102,Чернівецька область
27378,730103,984,7,461,400,61,730103,Чернівецька область
27379,730104,2163,32,1196,1060,136,730104,Чернівецька область
27380,730105,681,14,361,279,82,730105,Чернівецька область
27381,730106,1313,17,660,559,101,730106,Чернівецька область
27382,730107,358,6,222,205,17,730107,Чернівецька область
27383,730108,2123,34,1116,846,270,730108,Чернівецька область
27384,730109,1737,25,849,671,178,730109,Чернівецька область
27385,730110,1524,20,848,629,219,730110,Чернівецька область
27386,730111,221,7,143,96,47,730111,Чернівецька область
27387,730236,2418,37,1198,983,215,730236,Чернівецька область
27388,730237,1821,18,897,732,165,730237,Чернівецька область
27389,730238,1936,32,866,755,111,730238,Чернівецька область
27390,730239,1005,12,563,480,83,730239,Чернівецька область
27391,730240,533,8,221,169,52,730240,Чернівецька область
27392,730241,1926,25,819,756,63,730241,Чернівецька область
27393,730242,1718,28,799,786,13,730242,Чернівецька область
27394,730243,2145,26,977,921,56,730243,Чернівецька область
27395,730244,2376,44,1070,975,95,730244,Чернівецька область
27396,730245,656,8,301,258,43,730245,Чернівецька область
27397,730246,1759,14,783,748,35,730246,Чернівецька область
27398,730247,506,5,224,154,70,730247,Чернівецька область
27399,730248,1488,22,709,594,115,730248,Чернівецька область
27400,730249,1497,27,661,630,31,730249,Чернівецька область
27401,730250,2185,38,950,820,130,730250,Чернівецька область
27402,730251,2203,22,1233,1198,35,730251,Чернівецька область
27403,730252,1806,23,842,792,50,730252,Чернівецька область
27404,730253,1027,14,418,379,39,730253,Чернівецька область
27405,730254,1908,14,834,749,85,730254,Чернівецька область
27406,730255,837,6,389,361,28,730255,Чернівецька область
27407,730256,2401,51,1057,986,71,730256,Чернівецька область
27408,730257,1736,28,831,786,45,730257,Чернівецька область
27409,730258,884,17,584,530,54,730258,Чернівецька область
27410,730259,1644,21,966,743,223,730259,Чернівецька область
27411,730260,1933,19,981,942,39,730260,Чернівецька область
27412,730261,782,13,507,415,92,730261,Чернівецька область
27413,730262,233,5,158,127,31,730262,Чернівецька область
27414,730263,1846,15,966,760,206,730263,Чернівецька область
27415,730264,1900,19,840,773,67,730264,Чернівецька область
27416,730265,1000,14,441,365,76,730265,Чернівецька область
27417,730266,1350,15,708,649,59,730266,Чернівецька область
27418,730267,1246,17,698,638,60,730267,Чернівецька область
27419,730268,1895,42,745,706,39,730268,Чернівецька область
27420,730269,2078,29,827,791,36,730269,Чернівецька область
27421,730270,1743,14,1078,683,395,730270,Чернівецька область
27422,730271,1523,14,794,533,261,730271,Чернівецька область
27423,730272,643,9,320,287,33,730272,Чернівецька область
27424,730273,1681,10,672,657,15,730273,Чернівецька область
27425,730274,1783,39,780,613,167,730274,Чернівецька область
27426,730275,540,8,257,209,48,730275,Чернівецька область
27427,730276,1114,10,531,487,44,730276,Чернівецька область
27428,730277,1199,20,770,724,46,730277,Чернівецька область
27429,730278,1392,21,668,512,156,730278,Чернівецька область
27430,730352,2055,37,1000,732,268,730352,Чернівецька область
27431,730353,1864,33,966,704,262,730353,Чернівецька область
27432,730354,1415,15,703,515,188,730354,Чернівецька область
27433,730362,1362,9,680,543,137,730362,Чернівецька область
27434,730363,1283,4,694,490,204,730363,Чернівецька область
27435,730367,1803,30,1024,760,264,730367,Чернівецька область
27436,730376,1519,22,647,613,34,730376,Чернівецька область
27437,730377,1065,17,458,424,34,730377,Чернівецька область
27438,730379,1232,14,618,438,180,730379,Чернівецька область
27439,730380,184,0,120,102,18,730380,Чернівецька область
27440,730388,1421,29,733,596,137,730388,Чернівецька область
27441,730389,1257,14,659,514,145,730389,Чернівецька область
27442,730481,2447,26,1252,870,382,730481,Чернівецька область
27443,730482,1478,16,785,547,238,730482,Чернівецька область
27444,730483,2074,41,1187,813,374,730483,Чернівецька область
27445,730484,1654,16,838,588,250,730484,Чернівецька область
27446,730485,1554,17,829,611,218,730485,Чернівецька область
27447,730486,2432,24,1276,908,368,730486,Чернівецька область
27448,730562,1366,17,797,558,239,730562,Чернівецька область
27449,730563,1241,15,674,623,51,730563,Чернівецька область
27450,730112,2064,44,1072,739,333,730112,Чернівецька область
27451,730113,2275,40,1174,771,403,730113,Чернівецька область
27452,730114,2078,38,1000,693,307,730114,Чернівецька область
27453,730115,1934,25,975,695,280,730115,Чернівецька область
27454,730116,592,6,296,189,107,730116,Чернівецька область
27455,730117,1208,11,579,439,140,730117,Чернівецька область
27456,730118,741,14,346,212,134,730118,Чернівецька область
27457,730119,313,4,184,119,65,730119,Чернівецька область
27458,730120,904,10,515,388,127,730120,Чернівецька область
27459,730121,993,8,588,357,231,730121,Чернівецька область
27460,730122,414,12,275,197,78,730122,Чернівецька область
27461,730123,1487,8,859,587,272,730123,Чернівецька область
27462,730124,1256,17,617,451,166,730124,Чернівецька область
27463,730125,250,2,158,130,28,730125,Чернівецька область
27464,730126,1073,10,609,366,243,730126,Чернівецька область
27465,730127,2233,24,1225,913,312,730127,Чернівецька область
27466,730128,767,8,433,325,108,730128,Чернівецька область
27467,730129,1069,19,568,406,162,730129,Чернівецька область
27468,730130,1158,14,684,410,274,730130,Чернівецька область
27469,730131,692,2,431,249,182,730131,Чернівецька область
27470,730132,920,5,382,246,136,730132,Чернівецька область
27471,730133,1239,17,637,415,222,730133,Чернівецька область
27472,730134,1211,13,614,391,223,730134,Чернівецька область
27473,730135,423,10,216,160,56,730135,Чернівецька область
27474,730136,1000,11,545,404,141,730136,Чернівецька область
27475,730137,199,6,106,70,36,730137,Чернівецька область
27476,730138,198,4,115,84,31,730138,Чернівецька область
27477,730139,396,2,247,143,104,730139,Чернівецька область
27478,730140,1260,20,719,459,260,730140,Чернівецька область
27479,730141,586,11,256,183,73,730141,Чернівецька область
27480,730142,1336,19,685,465,220,730142,Чернівецька область
27481,730143,2133,24,1179,988,191,730143,Чернівецька область
27482,730144,252,0,148,79,69,730144,Чернівецька область
27483,730145,1398,15,736,475,261,730145,Чернівецька область
27484,730146,666,8,435,264,171,730146,Чернівецька область
27485,730147,357,1,209,138,71,730147,Чернівецька область
27486,730148,992,15,573,366,207,730148,Чернівецька область
27487,730149,1271,15,705,446,259,730149,Чернівецька область
27488,730150,1468,17,820,664,156,730150,Чернівецька область
27489,730151,1923,24,991,746,245,730151,Чернівецька область
27490,730152,1956,19,931,726,205,730152,Чернівецька область
27491,730153,1055,17,533,435,98,730153,Чернівецька область
27492,730154,522,11,266,234,32,730154,Чернівецька область
27493,730155,1432,12,762,551,211,730155,Чернівецька область
27494,730156,724,8,381,287,94,730156,Чернівецька область
27495,730157,234,0,130,102,28,730157,Чернівецька область
27496,730158,1045,13,636,518,118,730158,Чернівецька область
27497,730159,597,7,318,240,78,730159,Чернівецька область
27498,730160,922,7,461,388,73,730160,Чернівецька область
27499,730161,761,8,393,331,62,730161,Чернівецька область
27500,730162,413,1,245,185,60,730162,Чернівецька область
27501,730163,814,8,447,323,124,730163,Чернівецька область
27502,730164,832,9,509,382,127,730164,Чернівецька область
27503,730165,1226,17,629,485,144,730165,Чернівецька область
27504,730166,2154,19,1050,915,135,730166,Чернівецька область
27505,730167,613,7,378,222,156,730167,Чернівецька область
27506,730168,369,4,231,148,83,730168,Чернівецька область
27507,730170,142,0,107,94,13,730170,Чернівецька область
27508,730171,1581,13,719,594,125,730171,Чернівецька область
27509,730172,867,7,495,431,64,730172,Чернівецька область
27510,730175,982,10,619,523,96,730175,Чернівецька область
27511,730176,317,8,184,130,54,730176,Чернівецька область
27512,730177,1459,12,683,562,121,730177,Чернівецька область
27513,730178,1536,13,612,517,95,730178,Чернівецька область
27514,730179,569,12,299,225,74,730179,Чернівецька область
27515,730181,270,2,173,146,27,730181,Чернівецька область
27516,730182,1488,13,595,514,81,730182,Чернівецька область
27517,730183,1352,12,700,583,117,730183,Чернівецька область
27518,730184,270,2,216,162,54,730184,Чернівецька область
27519,730308,1976,24,1161,982,179,730308,Чернівецька область
27520,730309,1856,24,917,795,122,730309,Чернівецька область
27521,730311,1002,4,507,460,47,730311,Чернівецька область
27522,730312,2157,21,1308,1186,122,730312,Чернівецька область
27523,730313,453,10,261,223,38,730313,Чернівецька область
27524,730314,1114,14,653,549,104,730314,Чернівецька область
27525,730315,1275,19,629,552,77,730315,Чернівецька область
27526,730316,1321,20,603,541,62,730316,Чернівецька область
27527,730317,142,1,80,75,5,730317,Чернівецька область
27528,730318,837,9,510,433,77,730318,Чернівецька область
27529,730319,544,3,285,253,32,730319,Чернівецька область
27530,730320,1145,11,593,508,85,730320,Чернівецька область
27531,730321,1309,25,932,913,19,730321,Чернівецька область
27532,730322,1672,27,877,733,144,730322,Чернівецька область
27533,730324,722,7,432,361,71,730324,Чернівецька область
27534,730326,433,5,286,228,58,730326,Чернівецька область
27535,730327,1641,19,842,716,126,730327,Чернівецька область
27536,730328,764,6,382,306,76,730328,Чернівецька область
27537,730329,281,0,149,134,15,730329,Чернівецька область
27538,730330,799,11,413,336,77,730330,Чернівецька область
27539,730331,1912,31,1033,916,117,730331,Чернівецька область
27540,730332,1744,17,883,772,111,730332,Чернівецька область
27541,730333,1074,10,624,540,84,730333,Чернівецька область
27542,730334,1068,10,586,446,140,730334,Чернівецька область
27543,730336,1283,11,605,543,62,730336,Чернівецька область
27544,730337,248,20,226,179,47,730337,Чернівецька область
27545,730395,2314,28,1155,948,207,730395,Чернівецька область
27546,730396,1922,39,1009,750,259,730396,Чернівецька область
27547,730397,2062,28,1071,827,244,730397,Чернівецька область
27548,730398,1532,22,785,618,167,730398,Чернівецька область
27549,730399,661,7,412,333,79,730399,Чернівецька область
27550,730400,483,3,277,249,28,730400,Чернівецька область
27551,730401,690,16,502,413,89,730401,Чернівецька область
27552,730402,90,0,54,34,20,730402,Чернівецька область
27553,730403,1295,15,658,578,80,730403,Чернівецька область
27554,730405,444,2,245,179,66,730405,Чернівецька область
27555,730406,299,3,166,138,28,730406,Чернівецька область
27556,730408,1564,24,1007,879,128,730408,Чернівецька область
27557,730409,704,10,395,286,109,730409,Чернівецька область
27558,730410,1073,10,544,464,80,730410,Чернівецька область
27559,730411,1156,14,669,555,114,730411,Чернівецька область
27560,730412,1019,16,589,523,66,730412,Чернівецька область
27561,730413,288,0,162,113,49,730413,Чернівецька область
27562,730414,1036,22,487,404,83,730414,Чернівецька область
27563,730415,959,13,514,455,59,730415,Чернівецька область
27564,730416,1492,14,725,598,127,730416,Чернівецька область
27565,730417,1572,13,676,566,110,730417,Чернівецька область
27566,730418,1530,7,662,560,102,730418,Чернівецька область
27567,730419,1744,17,787,725,62,730419,Чернівецька область
27568,730420,2066,22,1111,1023,88,730420,Чернівецька область
27569,730421,105,0,81,61,20,730421,Чернівецька область
27570,730422,1154,19,660,503,157,730422,Чернівецька область
27571,730423,727,7,524,420,104,730423,Чернівецька область
27572,730424,1615,12,721,608,113,730424,Чернівецька область
27573,730425,353,2,214,197,17,730425,Чернівецька область
27574,730426,2350,35,1114,880,234,730426,Чернівецька область
27575,730427,428,4,245,220,25,730427,Чернівецька область
27576,730428,647,18,450,400,50,730428,Чернівецька область
27577,730429,1655,17,733,628,105,730429,Чернівецька область
27578,730431,576,4,329,259,70,730431,Чернівецька область
27579,730432,752,7,416,340,76,730432,Чернівецька область
27580,730433,1132,8,525,416,109,730433,Чернівецька область
27581,730434,1231,11,526,449,77,730434,Чернівецька область
27582,730435,274,1,173,151,22,730435,Чернівецька область
27583,730436,634,13,350,301,49,730436,Чернівецька область
27584,730437,1109,19,580,437,143,730437,Чернівецька область
27585,730438,981,9,500,421,79,730438,Чернівецька область
27586,730439,2161,28,1210,1066,144,730439,Чернівецька область
27587,730440,1242,2,658,538,120,730440,Чернівецька область
27588,730441,737,17,425,371,54,730441,Чернівецька область
27589,730442,2026,24,1042,828,214,730442,Чернівецька область
27590,730443,1948,25,1037,793,244,730443,Чернівецька область
27591,730444,1944,30,1084,810,274,730444,Чернівецька область
27592,730445,2283,32,1255,975,280,730445,Чернівецька область
27593,730559,48,0,42,40,2,730559,Чернівецька область
27594,740983,1575,30,954,737,217,740983,Чернігівська область
27595,740984,1429,32,899,682,217,740984,Чернігівська область
27596,740985,1669,43,1105,827,278,740985,Чернігівська область
27597,740986,1457,28,955,701,254,740986,Чернігівська область
27598,740987,1424,29,1035,831,204,740987,Чернігівська область
27599,740988,1449,30,943,731,212,740988,Чернігівська область
27600,740989,1575,37,1023,762,261,740989,Чернігівська область
27601,740990,2059,30,1418,1118,300,740990,Чернігівська область
27602,740991,1711,37,1089,864,225,740991,Чернігівська область
27603,740993,1707,23,1141,862,279,740993,Чернігівська область
27604,740994,1732,37,1146,856,290,740994,Чернігівська область
27605,740995,2347,56,1512,1163,349,740995,Чернігівська область
27606,740996,1769,44,1105,831,274,740996,Чернігівська область
27607,740997,2400,27,1387,1102,285,740997,Чернігівська область
27608,740998,2025,48,1370,1060,310,740998,Чернігівська область
27609,740999,2117,40,1337,1017,320,740999,Чернігівська область
27610,741000,1127,17,703,579,124,741000,Чернігівська область
27611,741001,1670,31,1054,841,213,741001,Чернігівська область
27612,741002,2012,34,1294,1026,268,741002,Чернігівська область
27613,741004,2141,41,1383,1120,263,741004,Чернігівська область
27614,741005,2196,33,1432,1136,296,741005,Чернігівська область
27615,741006,1868,28,1248,1027,221,741006,Чернігівська область
27616,741007,2239,56,1468,1196,272,741007,Чернігівська область
27617,741008,1909,30,1287,1056,231,741008,Чернігівська область
27618,741009,2046,32,1403,1104,299,741009,Чернігівська область
27619,741010,1964,29,1324,1032,292,741010,Чернігівська область
27620,741011,2138,36,1417,1102,315,741011,Чернігівська область
27621,741012,2251,47,1508,1244,264,741012,Чернігівська область
27622,741013,1774,18,1173,912,261,741013,Чернігівська область
27623,741015,2397,52,1597,1139,458,741015,Чернігівська область
27624,741016,1932,31,1206,924,282,741016,Чернігівська область
27625,741017,1912,31,1226,942,284,741017,Чернігівська область
27626,741019,1462,16,934,790,144,741019,Чернігівська область
27627,741020,1563,17,991,770,221,741020,Чернігівська область
27628,741021,2054,47,1352,1053,299,741021,Чернігівська область
27629,741022,2076,32,1337,1062,275,741022,Чернігівська область
27630,741023,2146,39,1449,1139,310,741023,Чернігівська область
27631,741025,2191,47,1412,1138,274,741025,Чернігівська область
27632,741026,1348,16,882,726,156,741026,Чернігівська область
27633,741027,2178,46,1393,1076,317,741027,Чернігівська область
27634,741028,2106,34,1387,1127,260,741028,Чернігівська область
27635,741029,2190,38,1423,1133,290,741029,Чернігівська область
27636,741030,1859,25,1259,992,267,741030,Чернігівська область
27637,741031,2047,33,1334,1052,282,741031,Чернігівська область
27638,741032,2264,32,1518,1245,273,741032,Чернігівська область
27639,741033,1770,30,1183,855,328,741033,Чернігівська область
27640,741034,1836,26,1214,951,263,741034,Чернігівська область
27641,741035,2051,37,1325,1020,305,741035,Чернігівська область
27642,741036,1672,36,1087,831,256,741036,Чернігівська область
27643,741037,2305,56,1479,1156,323,741037,Чернігівська область
27644,741038,2312,44,1440,1142,298,741038,Чернігівська область
27645,741039,2190,36,1396,1096,300,741039,Чернігівська область
27646,741040,2091,31,1313,1059,254,741040,Чернігівська область
27647,741041,1906,34,1178,940,238,741041,Чернігівська область
27648,741042,2184,33,1437,1189,248,741042,Чернігівська область
27649,741043,2124,46,1329,1019,310,741043,Чернігівська область
27650,741044,2377,34,1587,1222,365,741044,Чернігівська область
27651,741045,2223,39,1402,1061,341,741045,Чернігівська область
27652,741046,2275,44,1422,1206,216,741046,Чернігівська область
27653,741047,2244,46,1488,1194,294,741047,Чернігівська область
27654,741048,1929,27,1200,957,243,741048,Чернігівська область
27655,741050,35,0,32,26,6,741050,Чернігівська область
27656,741051,48,0,46,35,11,741051,Чернігівська область
27657,741052,22,0,22,17,5,741052,Чернігівська область
27658,741053,246,7,205,167,38,741053,Чернігівська область
27659,741054,45,0,44,33,11,741054,Чернігівська область
27660,741055,66,2,61,54,7,741055,Чернігівська область
27661,741056,225,7,213,180,33,741056,Чернігівська область
27662,741057,10,1,8,6,2,741057,Чернігівська область
27663,741058,88,2,79,75,4,741058,Чернігівська область
27664,741059,18,0,18,15,3,741059,Чернігівська область
27665,741060,79,2,74,61,13,741060,Чернігівська область
27666,741096,1442,20,885,687,198,741096,Чернігівська область
27667,741097,2116,33,1341,1045,296,741097,Чернігівська область
27668,741098,1862,26,1172,931,241,741098,Чернігівська область
27669,741099,2077,44,1322,1066,256,741099,Чернігівська область
27670,1,389,21,366,349,17,1,Чернігівська область
27671,740641,1065,6,615,573,42,740641,Чернігівська область
27672,740642,1059,4,567,533,34,740642,Чернігівська область
27673,740643,137,2,89,79,10,740643,Чернігівська область
27674,740644,1299,11,720,569,151,740644,Чернігівська область
27675,740645,1693,10,913,775,138,740645,Чернігівська область
27676,740646,416,2,214,173,41,740646,Чернігівська область
27677,740647,151,0,94,72,22,740647,Чернігівська область
27678,740648,1876,18,1098,828,270,740648,Чернігівська область
27679,740649,1903,26,1077,849,228,740649,Чернігівська область
27680,740650,1823,17,965,760,205,740650,Чернігівська область
27681,740651,412,3,253,192,61,740651,Чернігівська область
27682,740652,185,3,124,94,30,740652,Чернігівська область
27683,740653,78,0,48,37,11,740653,Чернігівська область
27684,740654,565,4,296,261,35,740654,Чернігівська область
27685,740655,328,4,207,168,39,740655,Чернігівська область
27686,740656,350,6,215,147,68,740656,Чернігівська область
27687,740657,178,1,105,71,34,740657,Чернігівська область
27688,740658,364,10,216,176,40,740658,Чернігівська область
27689,740659,318,8,176,143,33,740659,Чернігівська область
27690,740661,196,3,116,95,21,740661,Чернігівська область
27691,740662,153,1,94,57,37,740662,Чернігівська область
27692,740663,70,1,54,36,18,740663,Чернігівська область
27693,740664,334,1,199,139,60,740664,Чернігівська область
27694,740665,341,5,230,159,71,740665,Чернігівська область
27695,740666,280,3,142,115,27,740666,Чернігівська область
27696,740667,124,2,76,65,11,740667,Чернігівська область
27697,740668,124,0,90,70,20,740668,Чернігівська область
27698,740669,171,2,140,114,26,740669,Чернігівська область
27699,740670,225,1,126,106,20,740670,Чернігівська область
27700,740671,333,0,218,155,63,740671,Чернігівська область
27701,740672,194,2,160,135,25,740672,Чернігівська область
27702,740673,155,3,106,66,40,740673,Чернігівська область
27703,740674,372,2,171,128,43,740674,Чернігівська область
27704,740675,166,2,122,91,31,740675,Чернігівська область
27705,740676,506,3,305,254,51,740676,Чернігівська область
27706,740678,197,1,119,84,35,740678,Чернігівська область
27707,740679,497,2,302,261,41,740679,Чернігівська область
27708,740681,612,4,350,280,70,740681,Чернігівська область
27709,740682,227,1,151,134,17,740682,Чернігівська область
27710,740683,133,0,90,63,27,740683,Чернігівська область
27711,740684,304,3,205,157,48,740684,Чернігівська область
27712,740685,357,2,248,198,50,740685,Чернігівська область
27713,740686,101,0,61,52,9,740686,Чернігівська область
27714,740688,178,2,106,77,29,740688,Чернігівська область
27715,740689,284,2,188,156,32,740689,Чернігівська область
27716,740690,118,1,80,66,14,740690,Чернігівська область
27717,740691,215,2,149,125,24,740691,Чернігівська область
27718,740692,269,2,177,147,30,740692,Чернігівська область
27719,740693,174,0,115,90,25,740693,Чернігівська область
27720,740694,41,0,30,28,2,740694,Чернігівська область
27721,740811,560,4,311,193,118,740811,Чернігівська область
27722,740812,969,11,555,429,126,740812,Чернігівська область
27723,740813,287,1,184,133,51,740813,Чернігівська область
27724,740814,256,1,177,142,35,740814,Чернігівська область
27725,740815,390,9,249,186,63,740815,Чернігівська область
27726,740816,600,7,390,320,70,740816,Чернігівська область
27727,740817,99,0,77,57,20,740817,Чернігівська область
27728,740818,603,6,348,273,75,740818,Чернігівська область
27729,740819,114,3,62,46,16,740819,Чернігівська область
27730,740820,984,12,542,428,114,740820,Чернігівська область
27731,740821,1088,21,643,447,196,740821,Чернігівська область
27732,740822,999,14,560,413,147,740822,Чернігівська область
27733,740823,424,6,239,188,51,740823,Чернігівська область
27734,740824,199,1,135,113,22,740824,Чернігівська область
27735,740825,459,5,276,192,84,740825,Чернігівська область
27736,740826,178,3,100,73,27,740826,Чернігівська область
27737,740827,220,4,119,92,27,740827,Чернігівська область
27738,740828,449,2,215,178,37,740828,Чернігівська область
27739,740829,1262,10,757,613,144,740829,Чернігівська область
27740,740830,1107,17,673,561,112,740830,Чернігівська область
27741,740831,319,3,212,170,42,740831,Чернігівська область
27742,740832,592,14,286,202,84,740832,Чернігівська область
27743,740833,883,9,523,301,222,740833,Чернігівська область
27744,740834,133,3,86,30,56,740834,Чернігівська область
27745,740835,2255,36,1347,1090,257,740835,Чернігівська область
27746,740836,487,12,323,263,60,740836,Чернігівська область
27747,740837,1012,15,535,440,95,740837,Чернігівська область
27748,740838,828,10,507,391,116,740838,Чернігівська область
27749,740839,516,3,320,234,86,740839,Чернігівська область
27750,740840,119,1,68,45,23,740840,Чернігівська область
27751,740841,75,2,58,44,14,740841,Чернігівська область
27752,740842,421,5,250,205,45,740842,Чернігівська область
27753,740843,460,5,289,200,89,740843,Чернігівська область
27754,740844,223,4,154,123,31,740844,Чернігівська область
27755,740845,223,5,129,100,29,740845,Чернігівська область
27756,740846,331,8,192,145,47,740846,Чернігівська область
27757,740847,2285,36,1345,1125,220,740847,Чернігівська область
27758,740848,364,7,239,163,76,740848,Чернігівська область
27759,740849,487,8,267,200,67,740849,Чернігівська область
27760,740850,1351,20,800,600,200,740850,Чернігівська область
27761,740851,275,2,178,143,35,740851,Чернігівська область
27762,740852,732,8,450,321,129,740852,Чернігівська область
27763,740853,787,10,457,348,109,740853,Чернігівська область
27764,740854,713,4,477,352,125,740854,Чернігівська область
27765,740855,141,0,79,72,7,740855,Чернігівська область
27766,740856,298,6,194,131,63,740856,Чернігівська область
27767,740857,100,0,51,40,11,740857,Чернігівська область
27768,740858,411,1,237,203,34,740858,Чернігівська область
27769,740859,314,3,164,123,41,740859,Чернігівська область
27770,740860,1025,14,658,506,152,740860,Чернігівська область
27771,740861,802,12,556,452,104,740861,Чернігівська область
27772,740862,351,7,242,173,69,740862,Чернігівська область
27773,740863,543,7,359,286,73,740863,Чернігівська область
27774,740864,136,3,70,51,19,740864,Чернігівська область
27775,740865,807,15,488,393,95,740865,Чернігівська область
27776,740866,959,22,535,428,107,740866,Чернігівська область
27777,740867,389,5,193,148,45,740867,Чернігівська область
27778,740868,203,1,152,104,48,740868,Чернігівська область
27779,740869,190,1,116,82,34,740869,Чернігівська область
27780,740870,464,1,267,224,43,740870,Чернігівська область
27781,740871,409,1,272,192,80,740871,Чернігівська область
27782,740872,491,7,332,261,71,740872,Чернігівська область
27783,740873,100,0,63,46,17,740873,Чернігівська область
27784,740874,2255,37,1413,1127,286,740874,Чернігівська область
27785,740875,305,3,195,150,45,740875,Чернігівська область
27786,740876,235,6,142,121,21,740876,Чернігівська область
27787,740877,159,3,96,76,20,740877,Чернігівська область
27788,740878,553,13,400,341,59,740878,Чернігівська область
27789,740879,644,5,445,390,55,740879,Чернігівська область
27790,740880,776,5,435,348,87,740880,Чернігівська область
27791,740881,210,4,135,102,33,740881,Чернігівська область
27792,740882,512,4,328,262,66,740882,Чернігівська область
27793,740883,475,3,337,253,84,740883,Чернігівська область
27794,740884,249,2,149,112,37,740884,Чернігівська область
27795,740885,280,2,171,135,36,740885,Чернігівська область
27796,740886,267,4,148,117,31,740886,Чернігівська область
27797,740887,459,6,341,213,128,740887,Чернігівська область
27798,740888,337,4,205,164,41,740888,Чернігівська область
27799,740889,116,0,77,65,12,740889,Чернігівська область
27800,740890,279,10,219,160,59,740890,Чернігівська область
27801,741061,1932,35,1175,910,265,741061,Чернігівська область
27802,741062,1381,26,879,692,187,741062,Чернігівська область
27803,741063,1495,16,843,717,126,741063,Чернігівська область
27804,741064,2016,35,1219,981,238,741064,Чернігівська область
27805,741065,1640,37,886,740,146,741065,Чернігівська область
27806,741066,2050,22,1295,1057,238,741066,Чернігівська область
27807,741067,2284,43,1403,1118,285,741067,Чернігівська область
27808,741068,2166,33,1342,1127,215,741068,Чернігівська область
27809,741069,2239,33,1326,1099,227,741069,Чернігівська область
27810,741070,2083,30,1280,1014,266,741070,Чернігівська область
27811,741071,2234,41,1423,1099,324,741071,Чернігівська область
27812,741072,1737,42,1095,849,246,741072,Чернігівська область
27813,741073,2012,26,1266,1024,242,741073,Чернігівська область
27814,741074,2089,40,1358,1051,307,741074,Чернігівська область
27815,741075,1547,18,985,777,208,741075,Чернігівська область
27816,741076,1793,26,1025,826,199,741076,Чернігівська область
27817,741077,2152,42,1354,1065,289,741077,Чернігівська область
27818,741078,1933,26,1252,952,300,741078,Чернігівська область
27819,741079,930,16,696,541,155,741079,Чернігівська область
27820,741080,2218,34,1395,1104,291,741080,Чернігівська область
27821,741081,1617,21,1033,818,215,741081,Чернігівська область
27822,741082,2171,41,1455,1101,354,741082,Чернігівська область
27823,741083,2017,40,1349,1036,313,741083,Чернігівська область
27824,741084,2165,47,1395,1089,306,741084,Чернігівська область
27825,741085,1400,22,874,672,202,741085,Чернігівська область
27826,741087,405,14,383,171,212,741087,Чернігівська область
27827,741088,2323,33,1552,1237,315,741088,Чернігівська область
27828,741089,1835,33,1187,966,221,741089,Чернігівська область
27829,741090,2448,39,1539,1262,277,741090,Чернігівська область
27830,741091,1986,25,1311,1064,247,741091,Чернігівська область
27831,741092,2231,40,1447,1169,278,741092,Чернігівська область
27832,741093,1996,34,1247,994,253,741093,Чернігівська область
27833,741094,2205,29,1352,1100,252,741094,Чернігівська область
27834,741095,2045,29,1368,1126,242,741095,Чернігівська область
27835,741100,2334,33,1436,1131,305,741100,Чернігівська область
27836,741101,2348,41,1579,1262,317,741101,Чернігівська область
27837,741102,2304,47,1448,1161,287,741102,Чернігівська область
27838,741103,1013,24,696,564,132,741103,Чернігівська область
27839,741104,2324,39,1522,1198,324,741104,Чернігівська область
27840,741105,10,1,8,6,2,741105,Чернігівська область
27841,741106,73,1,47,40,7,741106,Чернігівська область
27842,741108,136,2,131,125,6,741108,Чернігівська область
27843,1,15,0,14,14,0,1,Чернігівська область
27844,740153,2048,22,1200,992,208,740153,Чернігівська область
27845,740154,1919,25,1167,980,187,740154,Чернігівська область
27846,740155,1990,21,1156,986,170,740155,Чернігівська область
27847,740156,2084,27,1225,1028,197,740156,Чернігівська область
27848,740157,1899,26,1073,905,168,740157,Чернігівська область
27849,740158,795,5,394,341,53,740158,Чернігівська область
27850,740159,102,1,60,50,10,740159,Чернігівська область
27851,740160,211,2,146,114,32,740160,Чернігівська область
27852,740161,164,0,101,86,15,740161,Чернігівська область
27853,740162,371,1,259,198,61,740162,Чернігівська область
27854,740163,171,0,100,79,21,740163,Чернігівська область
27855,740164,114,0,58,43,15,740164,Чернігівська область
27856,740165,224,2,134,108,26,740165,Чернігівська область
27857,740166,312,1,210,165,45,740166,Чернігівська область
27858,740167,430,3,284,198,86,740167,Чернігівська область
27859,740168,663,6,297,247,50,740168,Чернігівська область
27860,740169,266,1,160,114,46,740169,Чернігівська область
27861,740170,148,4,103,76,27,740170,Чернігівська область
27862,740171,355,1,242,213,29,740171,Чернігівська область
27863,740172,258,2,130,109,21,740172,Чернігівська область
27864,740173,246,3,143,115,28,740173,Чернігівська область
27865,740174,405,7,223,167,56,740174,Чернігівська область
27866,740175,330,8,208,149,59,740175,Чернігівська область
27867,740176,153,2,78,72,6,740176,Чернігівська область
27868,740177,292,2,196,177,19,740177,Чернігівська область
27869,740178,304,5,186,159,27,740178,Чернігівська область
27870,740179,534,4,313,239,74,740179,Чернігівська область
27871,740180,178,0,104,75,29,740180,Чернігівська область
27872,740181,187,2,136,98,38,740181,Чернігівська область
27873,740182,346,2,199,177,22,740182,Чернігівська область
27874,740183,312,2,211,189,22,740183,Чернігівська область
27875,740184,243,2,124,98,26,740184,Чернігівська область
27876,740186,191,1,114,94,20,740186,Чернігівська область
27877,740187,129,1,80,71,9,740187,Чернігівська область
27878,740188,386,1,311,271,40,740188,Чернігівська область
27879,740189,427,5,260,220,40,740189,Чернігівська область
27880,740190,252,2,155,134,21,740190,Чернігівська область
27881,740191,1371,14,742,623,119,740191,Чернігівська область
27882,740192,329,4,179,142,37,740192,Чернігівська область
27883,740193,259,5,157,110,47,740193,Чернігівська область
27884,740194,449,6,279,232,47,740194,Чернігівська область
27885,740195,226,3,137,121,16,740195,Чернігівська область
27886,740196,27,1,24,18,6,740196,Чернігівська область
27887,740326,1944,23,1050,857,193,740326,Чернігівська область
27888,740327,2139,29,1215,1008,207,740327,Чернігівська область
27889,740328,985,9,531,431,100,740328,Чернігівська область
27890,740329,754,5,398,328,70,740329,Чернігівська область
27891,740330,1133,16,629,530,99,740330,Чернігівська область
27892,740332,191,2,112,76,36,740332,Чернігівська область
27893,740333,452,4,299,229,70,740333,Чернігівська область
27894,740334,110,2,72,55,17,740334,Чернігівська область
27895,740335,363,2,216,170,46,740335,Чернігівська область
27896,740336,442,3,262,216,46,740336,Чернігівська область
27897,740337,301,5,187,158,29,740337,Чернігівська область
27898,740339,866,12,494,388,106,740339,Чернігівська область
27899,740340,545,4,315,232,83,740340,Чернігівська область
27900,740341,287,4,180,127,53,740341,Чернігівська область
27901,740342,518,9,300,265,35,740342,Чернігівська область
27902,740343,341,9,223,183,40,740343,Чернігівська область
27903,740344,370,4,224,180,44,740344,Чернігівська область
27904,740345,224,5,154,113,41,740345,Чернігівська область
27905,740346,1008,10,595,444,151,740346,Чернігівська область
27906,740347,504,2,284,233,51,740347,Чернігівська область
27907,740348,525,3,315,257,58,740348,Чернігівська область
27908,740349,418,4,264,210,54,740349,Чернігівська область
27909,740351,444,9,256,209,47,740351,Чернігівська область
27910,740352,193,2,124,101,23,740352,Чернігівська область
27911,740353,85,2,56,35,21,740353,Чернігівська область
27912,740354,726,7,513,432,81,740354,Чернігівська область
27913,740355,157,4,104,46,58,740355,Чернігівська область
27914,740356,121,4,102,45,57,740356,Чернігівська область
27915,740357,420,7,268,196,72,740357,Чернігівська область
27916,740358,369,7,229,180,49,740358,Чернігівська область
27917,740359,487,11,317,247,70,740359,Чернігівська область
27918,740360,896,9,489,412,77,740360,Чернігівська область
27919,740361,18,0,18,11,7,740361,Чернігівська область
27920,740362,1274,20,821,684,137,740362,Чернігівська область
27921,740363,1284,24,820,658,162,740363,Чернігівська область
27922,740364,1548,17,943,824,119,740364,Чернігівська область
27923,740365,2349,30,1420,1244,176,740365,Чернігівська область
27924,740367,1468,20,897,777,120,740367,Чернігівська область
27925,740368,2297,24,1363,1205,158,740368,Чернігівська область
27926,740369,990,9,561,441,120,740369,Чернігівська область
27927,740370,1047,12,608,492,116,740370,Чернігівська область
27928,740371,378,0,243,208,35,740371,Чернігівська область
27929,740372,309,4,186,145,41,740372,Чернігівська область
27930,740373,278,1,145,113,32,740373,Чернігівська область
27931,740374,229,3,139,101,38,740374,Чернігівська область
27932,740375,256,5,147,108,39,740375,Чернігівська область
27933,740376,824,14,333,259,74,740376,Чернігівська область
27934,740377,1069,12,586,490,96,740377,Чернігівська область
27935,740378,390,4,220,177,43,740378,Чернігівська область
27936,740379,135,0,92,69,23,740379,Чернігівська область
27937,740380,566,8,357,281,76,740380,Чернігівська область
27938,740381,498,5,267,233,34,740381,Чернігівська область
27939,740382,539,2,341,281,60,740382,Чернігівська область
27940,740383,353,2,218,197,21,740383,Чернігівська область
27941,740384,196,3,113,78,35,740384,Чернігівська область
27942,740385,409,4,204,172,32,740385,Чернігівська область
27943,740386,337,4,190,136,54,740386,Чернігівська область
27944,740387,682,7,413,321,92,740387,Чернігівська область
27945,740388,258,5,141,118,23,740388,Чернігівська область
27946,740389,221,0,144,119,25,740389,Чернігівська область
27947,740390,150,2,86,77,9,740390,Чернігівська область
27948,740391,244,7,175,132,43,740391,Чернігівська область
27949,740392,42,0,38,35,3,740392,Чернігівська область
27950,740502,57,0,36,21,15,740502,Чернігівська область
27951,740503,520,4,349,272,77,740503,Чернігівська область
27952,740504,420,7,340,317,23,740504,Чернігівська область
27953,740505,424,2,329,267,62,740505,Чернігівська область
27954,740506,315,4,202,180,22,740506,Чернігівська область
27955,740507,159,1,85,67,18,740507,Чернігівська область
27956,740508,400,4,239,212,27,740508,Чернігівська область
27957,740509,305,1,187,150,37,740509,Чернігівська область
27958,740510,900,12,468,440,28,740510,Чернігівська область
27959,740511,350,3,207,165,42,740511,Чернігівська область
27960,740512,107,0,64,43,21,740512,Чернігівська область
27961,740513,264,2,159,127,32,740513,Чернігівська область
27962,740515,267,7,188,150,38,740515,Чернігівська область
27963,740516,213,2,151,136,15,740516,Чернігівська область
27964,740517,90,0,79,64,15,740517,Чернігівська область
27965,740518,68,1,49,31,18,740518,Чернігівська область
27966,740519,151,0,81,64,17,740519,Чернігівська область
27967,740520,208,5,127,106,21,740520,Чернігівська область
27968,740521,223,3,139,112,27,740521,Чернігівська область
27969,740522,192,0,114,100,14,740522,Чернігівська область
27970,740523,222,1,143,109,34,740523,Чернігівська область
27971,740524,73,1,58,47,11,740524,Чернігівська область
27972,740525,220,1,151,137,14,740525,Чернігівська область
27973,740526,189,4,131,106,25,740526,Чернігівська область
27974,740527,281,1,174,145,29,740527,Чернігівська область
27975,740528,187,3,137,115,22,740528,Чернігівська область
27976,740529,168,4,98,72,26,740529,Чернігівська область
27977,740530,153,1,89,77,12,740530,Чернігівська область
27978,740531,194,2,132,108,24,740531,Чернігівська область
27979,740532,189,0,115,95,20,740532,Чернігівська область
27980,740533,220,3,151,123,28,740533,Чернігівська область
27981,740534,599,7,359,311,48,740534,Чернігівська область
27982,740535,78,0,33,24,9,740535,Чернігівська область
27983,740536,417,6,279,255,24,740536,Чернігівська область
27984,740537,243,1,153,101,52,740537,Чернігівська область
27985,740538,322,5,203,139,64,740538,Чернігівська область
27986,740539,263,2,201,166,35,740539,Чернігівська область
27987,740540,345,0,233,188,45,740540,Чернігівська область
27988,740541,74,0,51,48,3,740541,Чернігівська область
27989,740542,363,2,231,214,17,740542,Чернігівська область
27990,740543,2302,32,1388,1196,192,740543,Чернігівська область
27991,740544,2238,26,1339,1191,148,740544,Чернігівська область
27992,740545,1884,36,1098,963,135,740545,Чернігівська область
27993,740546,2209,21,1192,1061,131,740546,Чернігівська область
27994,740547,1483,22,892,800,92,740547,Чернігівська область
27995,740548,26,0,26,24,2,740548,Чернігівська область
27996,740549,103,4,98,95,3,740549,Чернігівська область
27997,740695,2103,23,1240,1067,173,740695,Чернігівська область
27998,740696,1276,11,738,640,98,740696,Чернігівська область
27999,740697,2183,16,1208,1033,175,740697,Чернігівська область
28000,740698,835,8,452,397,55,740698,Чернігівська область
28001,740699,553,1,290,256,34,740699,Чернігівська область
28002,740700,118,0,42,33,9,740700,Чернігівська область
28003,740701,146,2,83,64,19,740701,Чернігівська область
28004,740702,146,2,80,51,29,740702,Чернігівська область
28005,740703,203,1,112,98,14,740703,Чернігівська область
28006,740704,721,7,420,367,53,740704,Чернігівська область
28007,740705,347,4,219,194,25,740705,Чернігівська область
28008,740706,100,1,74,50,24,740706,Чернігівська область
28009,740707,202,2,123,106,17,740707,Чернігівська область
28010,740708,512,7,287,247,40,740708,Чернігівська область
28011,740709,126,3,81,73,8,740709,Чернігівська область
28012,740710,447,4,296,263,33,740710,Чернігівська область
28013,740711,478,3,325,298,27,740711,Чернігівська область
28014,740712,196,2,124,113,11,740712,Чернігівська область
28015,740713,155,2,91,70,21,740713,Чернігівська область
28016,740714,143,2,84,70,14,740714,Чернігівська область
28017,740715,271,2,158,132,26,740715,Чернігівська область
28018,740716,487,2,312,258,54,740716,Чернігівська область
28019,740717,128,0,84,57,27,740717,Чернігівська область
28020,740718,106,2,72,53,19,740718,Чернігівська область
28021,740719,334,1,187,148,39,740719,Чернігівська область
28022,740720,89,0,54,41,13,740720,Чернігівська область
28023,740721,284,2,172,162,10,740721,Чернігівська область
28024,740722,222,1,110,100,10,740722,Чернігівська область
28025,740723,215,0,117,102,15,740723,Чернігівська область
28026,740724,122,0,67,58,9,740724,Чернігівська область
28027,740725,277,3,152,132,20,740725,Чернігівська область
28028,740726,22,1,19,13,6,740726,Чернігівська область
28029,740727,1853,24,1112,910,202,740727,Чернігівська область
28030,740728,1846,27,1085,920,165,740728,Чернігівська область
28031,740729,1701,16,1015,876,139,740729,Чернігівська область
28032,740730,154,1,114,97,17,740730,Чернігівська область
28033,740731,979,8,520,441,79,740731,Чернігівська область
28034,740732,199,1,134,120,14,740732,Чернігівська область
28035,740733,386,5,252,206,46,740733,Чернігівська область
28036,740734,115,1,74,66,8,740734,Чернігівська область
28037,740735,270,2,155,136,19,740735,Чернігівська область
28038,740736,126,2,72,57,15,740736,Чернігівська область
28039,740737,440,5,312,252,60,740737,Чернігівська область
28040,740738,416,7,235,176,59,740738,Чернігівська область
28041,740739,581,5,354,301,53,740739,Чернігівська область
28042,740740,79,2,63,50,13,740740,Чернігівська область
28043,740741,325,6,218,178,40,740741,Чернігівська область
28044,740742,120,0,89,65,24,740742,Чернігівська область
28045,740743,311,4,209,180,29,740743,Чернігівська область
28046,740744,183,1,121,103,18,740744,Чернігівська область
28047,740745,149,3,85,76,9,740745,Чернігівська область
28048,740746,458,9,296,223,73,740746,Чернігівська область
28049,740747,547,7,370,278,92,740747,Чернігівська область
28050,740748,313,1,204,151,53,740748,Чернігівська область
28051,740749,101,1,59,38,21,740749,Чернігівська область
28052,740750,193,0,125,81,44,740750,Чернігівська область
28053,740751,250,6,161,144,17,740751,Чернігівська область
28054,740752,165,4,106,76,30,740752,Чернігівська область
28055,740753,349,12,199,177,22,740753,Чернігівська область
28056,740754,145,0,116,101,15,740754,Чернігівська область
28057,740755,368,3,230,194,36,740755,Чернігівська область
28058,740756,46,0,38,34,4,740756,Чернігівська область
28059,740757,649,7,414,359,55,740757,Чернігівська область
28060,740758,544,6,399,329,70,740758,Чернігівська область
28061,740759,42,1,38,33,5,740759,Чернігівська область
28062,740891,1533,14,855,713,142,740891,Чернігівська область
28063,740892,1440,20,776,647,129,740892,Чернігівська область
28064,740893,1790,29,1054,836,218,740893,Чернігівська область
28065,740894,2161,17,1262,1084,178,740894,Чернігівська область
28066,740895,2199,25,1285,1073,212,740895,Чернігівська область
28067,740896,624,5,348,275,73,740896,Чернігівська область
28068,740897,382,2,211,162,49,740897,Чернігівська область
28069,740898,127,2,87,73,14,740898,Чернігівська область
28070,740899,190,2,115,89,26,740899,Чернігівська область
28071,740900,213,1,139,93,46,740900,Чернігівська область
28072,740901,340,0,204,177,27,740901,Чернігівська область
28073,740902,159,2,107,51,56,740902,Чернігівська область
28074,740903,121,1,63,46,17,740903,Чернігівська область
28075,740904,896,11,491,424,67,740904,Чернігівська область
28076,740905,640,9,344,281,63,740905,Чернігівська область
28077,740906,163,4,94,75,19,740906,Чернігівська область
28078,740907,116,0,73,52,21,740907,Чернігівська область
28079,740908,298,8,185,138,47,740908,Чернігівська область
28080,740909,707,13,358,307,51,740909,Чернігівська область
28081,740910,542,6,319,262,57,740910,Чернігівська область
28082,740911,438,3,261,207,54,740911,Чернігівська область
28083,740912,551,0,312,233,79,740912,Чернігівська область
28084,740913,171,1,82,67,15,740913,Чернігівська область
28085,740914,233,0,122,100,22,740914,Чернігівська область
28086,740915,290,3,166,139,27,740915,Чернігівська область
28087,740916,427,0,208,177,31,740916,Чернігівська область
28088,740917,309,3,128,112,16,740917,Чернігівська область
28089,740918,465,9,352,292,60,740918,Чернігівська область
28090,740919,638,13,361,273,88,740919,Чернігівська область
28091,740920,362,2,171,143,28,740920,Чернігівська область
28092,740921,127,6,81,60,21,740921,Чернігівська область
28093,740922,26,0,25,18,7,740922,Чернігівська область
28094,740001,2051,31,1232,1063,169,740001,Чернігівська область
28095,740002,1077,17,560,462,98,740002,Чернігівська область
28096,740003,848,7,462,414,48,740003,Чернігівська область
28097,740004,1933,32,1156,956,200,740004,Чернігівська область
28098,740005,2139,27,1271,1078,193,740005,Чернігівська область
28099,740006,382,4,209,180,29,740006,Чернігівська область
28100,740007,1521,23,920,780,140,740007,Чернігівська область
28101,740008,1072,15,594,497,97,740008,Чернігівська область
28102,740009,1309,13,723,594,129,740009,Чернігівська область
28103,740010,2292,30,1389,1166,223,740010,Чернігівська область
28104,740011,1036,13,639,493,146,740011,Чернігівська область
28105,740012,894,16,483,368,115,740012,Чернігівська область
28106,740013,872,5,486,363,123,740013,Чернігівська область
28107,740014,696,3,362,287,75,740014,Чернігівська область
28108,740015,148,0,106,62,44,740015,Чернігівська область
28109,740016,835,6,506,424,82,740016,Чернігівська область
28110,740017,414,2,239,201,38,740017,Чернігівська область
28111,740018,741,10,456,367,89,740018,Чернігівська область
28112,740019,191,0,143,95,48,740019,Чернігівська область
28113,740020,243,5,150,98,52,740020,Чернігівська область
28114,740021,459,5,323,270,53,740021,Чернігівська область
28115,740022,479,6,343,244,99,740022,Чернігівська область
28116,740023,620,3,368,271,97,740023,Чернігівська область
28117,740024,183,1,155,97,58,740024,Чернігівська область
28118,740025,692,13,491,400,91,740025,Чернігівська область
28119,740026,186,3,140,123,17,740026,Чернігівська область
28120,740027,457,1,271,232,39,740027,Чернігівська область
28121,740028,708,8,427,337,90,740028,Чернігівська область
28122,740029,630,9,346,253,93,740029,Чернігівська область
28123,740030,856,12,479,382,97,740030,Чернігівська область
28124,740031,1072,8,666,547,119,740031,Чернігівська область
28125,740032,791,16,447,367,80,740032,Чернігівська область
28126,740033,306,3,164,149,15,740033,Чернігівська область
28127,740034,646,7,418,326,92,740034,Чернігівська область
28128,740035,615,10,382,317,65,740035,Чернігівська область
28129,740036,136,2,92,70,22,740036,Чернігівська область
28130,740037,359,3,213,172,41,740037,Чернігівська область
28131,740038,591,4,397,312,85,740038,Чернігівська область
28132,740039,234,3,143,112,31,740039,Чернігівська область
28133,740040,376,5,224,160,64,740040,Чернігівська область
28134,740041,195,3,128,83,45,740041,Чернігівська область
28135,740042,616,9,415,323,92,740042,Чернігівська область
28136,740043,1206,6,662,543,119,740043,Чернігівська область
28137,740044,627,8,381,268,113,740044,Чернігівська область
28138,740045,909,9,509,428,81,740045,Чернігівська область
28139,740046,49,3,36,29,7,740046,Чернігівська область
28140,740089,2176,35,1268,1007,261,740089,Чернігівська область
28141,740090,2283,27,1306,1069,237,740090,Чернігівська область
28142,740091,1977,35,1048,876,172,740091,Чернігівська область
28143,740093,2196,20,1246,1026,220,740093,Чернігівська область
28144,740094,367,2,206,151,55,740094,Чернігівська область
28145,740095,906,13,426,352,74,740095,Чернігівська область
28146,740096,582,4,365,289,76,740096,Чернігівська область
28147,740097,533,3,343,278,65,740097,Чернігівська область
28148,740098,844,12,447,307,140,740098,Чернігівська область
28149,740099,932,8,587,474,113,740099,Чернігівська область
28150,740100,298,3,188,139,49,740100,Чернігівська область
28151,740101,125,1,66,53,13,740101,Чернігівська область
28152,740102,621,3,341,297,44,740102,Чернігівська область
28153,740103,77,0,62,48,14,740103,Чернігівська область
28154,740104,992,11,536,400,136,740104,Чернігівська область
28155,740105,497,10,310,246,64,740105,Чернігівська область
28156,740106,367,3,220,153,67,740106,Чернігівська область
28157,740107,432,4,225,196,29,740107,Чернігівська область
28158,740108,497,5,249,200,49,740108,Чернігівська область
28159,740109,551,9,333,257,76,740109,Чернігівська область
28160,740110,219,2,160,116,44,740110,Чернігівська область
28161,740111,459,4,304,251,53,740111,Чернігівська область
28162,740112,770,13,496,337,159,740112,Чернігівська область
28163,740113,343,4,204,142,62,740113,Чернігівська область
28164,740114,260,4,155,116,39,740114,Чернігівська область
28165,740115,226,4,140,114,26,740115,Чернігівська область
28166,740116,238,4,171,137,34,740116,Чернігівська область
28167,740117,786,9,409,303,106,740117,Чернігівська область
28168,740118,350,2,218,172,46,740118,Чернігівська область
28169,740119,121,0,80,52,28,740119,Чернігівська область
28170,740120,455,9,269,227,42,740120,Чернігівська область
28171,740121,49,1,25,17,8,740121,Чернігівська область
28172,740122,494,7,304,231,73,740122,Чернігівська область
28173,740123,163,3,98,77,21,740123,Чернігівська область
28174,740124,283,0,201,141,60,740124,Чернігівська область
28175,740125,222,0,147,97,50,740125,Чернігівська область
28176,740126,313,3,267,216,51,740126,Чернігівська область
28177,740127,339,3,227,176,51,740127,Чернігівська область
28178,740128,273,1,180,130,50,740128,Чернігівська область
28179,740129,669,11,364,229,135,740129,Чернігівська область
28180,740130,829,7,473,373,100,740130,Чернігівська область
28181,740131,708,7,420,292,128,740131,Чернігівська область
28182,740132,253,3,177,134,43,740132,Чернігівська область
28183,740133,36,0,31,21,10,740133,Чернігівська область
28184,740197,1636,24,937,800,137,740197,Чернігівська область
28185,740198,2055,39,1089,881,208,740198,Чернігівська область
28186,740199,1358,11,714,593,121,740199,Чернігівська область
28187,740200,2041,29,1107,893,214,740200,Чернігівська область
28188,740201,1806,19,1081,839,242,740201,Чернігівська область
28189,740204,1784,8,943,740,203,740204,Чернігівська область
28190,740208,447,9,255,204,51,740208,Чернігівська область
28191,740209,373,2,200,156,44,740209,Чернігівська область
28192,740215,596,5,366,296,70,740215,Чернігівська область
28193,740218,639,4,304,204,100,740218,Чернігівська область
28194,740221,536,2,309,233,76,740221,Чернігівська область
28195,740225,299,5,193,123,70,740225,Чернігівська область
28196,740228,270,4,168,126,42,740228,Чернігівська область
28197,740231,551,8,301,233,68,740231,Чернігівська область
28198,740232,117,1,65,49,16,740232,Чернігівська область
28199,740235,633,3,386,301,85,740235,Чернігівська область
28200,740236,161,2,101,62,39,740236,Чернігівська область
28201,740239,684,9,402,309,93,740239,Чернігівська область
28202,740240,50,2,48,38,10,740240,Чернігівська область
28203,740393,2214,23,1323,1041,282,740393,Чернігівська область
28204,740394,2162,18,1337,1017,320,740394,Чернігівська область
28205,740395,315,3,217,166,51,740395,Чернігівська область
28206,740396,363,8,252,203,49,740396,Чернігівська область
28207,740397,772,10,471,352,119,740397,Чернігівська область
28208,740398,360,8,239,157,82,740398,Чернігівська область
28209,740399,631,6,458,365,93,740399,Чернігівська область
28210,740400,874,17,545,400,145,740400,Чернігівська область
28211,740401,333,3,174,121,53,740401,Чернігівська область
28212,740402,497,4,228,167,61,740402,Чернігівська область
28213,740403,610,11,450,287,163,740403,Чернігівська область
28214,740404,726,10,476,356,120,740404,Чернігівська область
28215,740405,443,5,265,184,81,740405,Чернігівська область
28216,740406,781,10,632,443,189,740406,Чернігівська область
28217,740407,622,4,417,332,85,740407,Чернігівська область
28218,740408,941,6,663,475,188,740408,Чернігівська область
28219,740409,707,3,463,342,121,740409,Чернігівська область
28220,740410,367,3,220,170,50,740410,Чернігівська область
28221,740411,22,0,16,12,4,740411,Чернігівська область
28222,740412,1932,23,1120,923,197,740412,Чернігівська область
28223,740413,2199,36,1364,1112,252,740413,Чернігівська область
28224,740414,2118,37,1326,1032,294,740414,Чернігівська область
28225,740415,1780,25,1037,845,192,740415,Чернігівська область
28226,740416,1193,18,709,608,101,740416,Чернігівська область
28227,740417,1304,10,744,588,156,740417,Чернігівська область
28228,740418,1155,10,624,507,117,740418,Чернігівська область
28229,740419,1075,15,566,468,98,740419,Чернігівська область
28230,740420,848,7,496,384,112,740420,Чернігівська область
28231,740421,835,8,476,394,82,740421,Чернігівська область
28232,740422,64,2,48,37,11,740422,Чернігівська область
28233,740423,241,3,154,118,36,740423,Чернігівська область
28234,740424,521,11,345,236,109,740424,Чернігівська область
28235,740425,621,7,413,309,104,740425,Чернігівська область
28236,740426,545,7,328,268,60,740426,Чернігівська область
28237,740427,538,3,359,300,59,740427,Чернігівська область
28238,740428,219,3,159,121,38,740428,Чернігівська область
28239,740429,526,10,304,228,76,740429,Чернігівська область
28240,740430,354,6,247,189,58,740430,Чернігівська область
28241,740431,577,11,316,248,68,740431,Чернігівська область
28242,740432,676,14,385,295,90,740432,Чернігівська область
28243,740433,835,6,439,344,95,740433,Чернігівська область
28244,740434,700,15,440,339,101,740434,Чернігівська область
28245,740435,107,0,79,54,25,740435,Чернігівська область
28246,740436,458,6,251,187,64,740436,Чернігівська область
28247,740437,148,3,83,61,22,740437,Чернігівська область
28248,740438,47,2,23,17,6,740438,Чернігівська область
28249,740439,378,10,225,167,58,740439,Чернігівська область
28250,740440,103,1,77,54,23,740440,Чернігівська область
28251,740441,197,2,141,95,46,740441,Чернігівська область
28252,740442,758,8,410,309,101,740442,Чернігівська область
28253,740443,361,7,211,168,43,740443,Чернігівська область
28254,740444,564,8,270,214,56,740444,Чернігівська область
28255,740445,108,1,64,50,14,740445,Чернігівська область
28256,740446,370,4,229,169,60,740446,Чернігівська область
28257,740447,506,9,308,221,87,740447,Чернігівська область
28258,740448,597,16,328,248,80,740448,Чернігівська область
28259,740449,319,6,166,121,45,740449,Чернігівська область
28260,740450,1275,7,647,526,121,740450,Чернігівська область
28261,740451,422,6,284,215,69,740451,Чернігівська область
28262,740452,844,11,514,419,95,740452,Чернігівська область
28263,740453,263,2,170,116,54,740453,Чернігівська область
28264,740454,51,0,43,37,6,740454,Чернігівська область
28265,740455,220,10,207,198,9,740455,Чернігівська область
28266,740783,361,5,248,189,59,740783,Чернігівська область
28267,740784,271,6,197,159,38,740784,Чернігівська область
28268,740785,279,2,177,133,44,740785,Чернігівська область
28269,740786,666,6,410,332,78,740786,Чернігівська область
28270,740787,575,4,329,247,82,740787,Чернігівська область
28271,740788,481,2,283,224,59,740788,Чернігівська область
28272,740789,219,3,143,100,43,740789,Чернігівська область
28273,740790,183,1,106,76,30,740790,Чернігівська область
28274,740791,141,1,102,77,25,740791,Чернігівська область
28275,740792,138,6,79,61,18,740792,Чернігівська область
28276,740793,78,1,54,23,31,740793,Чернігівська область
28277,740794,86,0,68,60,8,740794,Чернігівська область
28278,740795,191,1,150,121,29,740795,Чернігівська область
28279,740796,482,3,328,259,69,740796,Чернігівська область
28280,740797,121,0,77,55,22,740797,Чернігівська область
28281,740798,67,0,46,29,17,740798,Чернігівська область
28282,740799,320,1,172,126,46,740799,Чернігівська область
28283,740800,92,0,64,51,13,740800,Чернігівська область
28284,740801,346,4,234,188,46,740801,Чернігівська область
28285,740802,155,0,111,72,39,740802,Чернігівська область
28286,740803,408,3,312,270,42,740803,Чернігівська область
28287,740804,147,0,96,83,13,740804,Чернігівська область
28288,740805,180,7,121,94,27,740805,Чернігівська область
28289,740806,1537,24,890,700,190,740806,Чернігівська область
28290,740807,661,6,396,307,89,740807,Чернігівська область
28291,740808,938,12,551,488,63,740808,Чернігівська область
28292,740809,782,7,439,372,67,740809,Чернігівська область
28293,740810,22,0,22,18,4,740810,Чернігівська область
28294,740134,2182,34,1407,1138,269,740134,Чернігівська область
28295,740135,2395,40,1522,1173,349,740135,Чернігівська область
28296,740136,2069,39,1275,981,294,740136,Чернігівська область
28297,740137,377,4,260,184,76,740137,Чернігівська область
28298,740138,190,1,142,102,40,740138,Чернігівська область
28299,740139,157,6,126,86,40,740139,Чернігівська область
28300,740140,670,5,493,432,61,740140,Чернігівська область
28301,740141,228,5,150,117,33,740141,Чернігівська область
28302,740142,2124,25,1281,1065,216,740142,Чернігівська область
28303,740143,97,1,71,48,23,740143,Чернігівська область
28304,740144,267,3,173,139,34,740144,Чернігівська область
28305,740145,236,2,138,91,47,740145,Чернігівська область
28306,740146,273,1,190,162,28,740146,Чернігівська область
28307,740147,116,3,80,62,18,740147,Чернігівська область
28308,740148,278,5,201,154,47,740148,Чернігівська область
28309,740149,886,6,577,497,80,740149,Чернігівська область
28310,740150,406,1,266,223,43,740150,Чернігівська область
28311,740151,365,5,236,178,58,740151,Чернігівська область
28312,740152,29,0,25,20,5,740152,Чернігівська область
28313,740202,766,9,438,376,62,740202,Чернігівська область
28314,740203,87,1,57,48,9,740203,Чернігівська область
28315,740205,280,5,177,112,65,740205,Чернігівська область
28316,740206,108,2,76,46,30,740206,Чернігівська область
28317,740207,432,4,278,209,69,740207,Чернігівська область
28318,740210,231,0,108,78,30,740210,Чернігівська область
28319,740212,486,7,241,169,72,740212,Чернігівська область
28320,740213,590,6,350,313,37,740213,Чернігівська область
28321,740214,213,2,134,107,27,740214,Чернігівська область
28322,740216,617,7,341,256,85,740216,Чернігівська область
28323,740217,389,9,216,154,62,740217,Чернігівська область
28324,740219,697,5,342,249,93,740219,Чернігівська область
28325,740220,620,8,329,271,58,740220,Чернігівська область
28326,740222,424,4,250,170,80,740222,Чернігівська область
28327,740223,89,3,67,42,25,740223,Чернігівська область
28328,740224,81,0,64,56,8,740224,Чернігівська область
28329,740226,579,1,301,215,86,740226,Чернігівська область
28330,740227,425,3,270,175,95,740227,Чернігівська область
28331,740229,346,2,228,159,69,740229,Чернігівська область
28332,740230,168,0,126,100,26,740230,Чернігівська область
28333,740233,306,3,142,99,43,740233,Чернігівська область
28334,740234,128,1,94,54,40,740234,Чернігівська область
28335,740237,313,1,173,120,53,740237,Чернігівська область
28336,740238,116,1,59,36,23,740238,Чернігівська область
28337,740457,1627,18,1032,873,159,740457,Чернігівська область
28338,740458,1513,12,840,716,124,740458,Чернігівська область
28339,740459,1011,13,493,396,97,740459,Чернігівська область
28340,740460,158,2,114,75,39,740460,Чернігівська область
28341,740461,107,6,77,54,23,740461,Чернігівська область
28342,740462,243,7,164,129,35,740462,Чернігівська область
28343,740463,515,5,399,281,118,740463,Чернігівська область
28344,740464,408,4,326,229,97,740464,Чернігівська область
28345,740465,1032,11,566,474,92,740465,Чернігівська область
28346,740466,849,7,496,376,120,740466,Чернігівська область
28347,740467,843,5,454,408,46,740467,Чернігівська область
28348,740468,334,1,222,169,53,740468,Чернігівська область
28349,740469,231,1,149,116,33,740469,Чернігівська область
28350,740470,192,0,122,73,49,740470,Чернігівська область
28351,740471,286,1,237,189,48,740471,Чернігівська область
28352,740472,468,2,356,263,93,740472,Чернігівська область
28353,740473,532,3,318,262,56,740473,Чернігівська область
28354,740474,978,17,551,462,89,740474,Чернігівська область
28355,740475,469,4,283,241,42,740475,Чернігівська область
28356,740476,538,6,332,247,85,740476,Чернігівська область
28357,740477,246,2,174,121,53,740477,Чернігівська область
28358,740478,191,2,136,99,37,740478,Чернігівська область
28359,740479,321,4,195,132,63,740479,Чернігівська область
28360,740480,222,3,113,83,30,740480,Чернігівська область
28361,740481,922,15,584,420,164,740481,Чернігівська область
28362,740482,559,3,312,242,70,740482,Чернігівська область
28363,740483,515,6,282,234,48,740483,Чернігівська область
28364,740484,660,12,384,309,75,740484,Чернігівська область
28365,740485,285,2,193,167,26,740485,Чернігівська область
28366,740486,338,4,196,152,44,740486,Чернігівська область
28367,740487,543,7,290,213,77,740487,Чернігівська область
28368,740488,425,3,215,165,50,740488,Чернігівська область
28369,740489,247,2,159,116,43,740489,Чернігівська область
28370,740490,457,5,284,214,70,740490,Чернігівська область
28371,740491,433,3,250,204,46,740491,Чернігівська область
28372,740492,181,3,146,83,63,740492,Чернігівська область
28373,740493,411,4,303,159,144,740493,Чернігівська область
28374,740494,957,13,528,409,119,740494,Чернігівська область
28375,740495,700,10,393,301,92,740495,Чернігівська область
28376,740496,240,2,134,110,24,740496,Чернігівська область
28377,740497,192,1,112,83,29,740497,Чернігівська область
28378,740498,496,7,251,188,63,740498,Чернігівська область
28379,740499,428,3,284,233,51,740499,Чернігівська область
28380,740500,239,1,169,137,32,740500,Чернігівська область
28381,740501,26,1,22,16,6,740501,Чернігівська область
28382,740550,2192,31,1169,910,259,740550,Чернігівська область
28383,740551,2125,28,1178,854,324,740551,Чернігівська область
28384,740552,2333,34,1063,826,237,740552,Чернігівська область
28385,740553,2090,24,1035,869,166,740553,Чернігівська область
28386,740554,1869,20,827,683,144,740554,Чернігівська область
28387,740555,1398,7,610,522,88,740555,Чернігівська область
28388,740556,205,1,143,113,30,740556,Чернігівська область
28389,740557,340,3,211,149,62,740557,Чернігівська область
28390,740558,269,3,185,112,73,740558,Чернігівська область
28391,740559,311,3,216,158,58,740559,Чернігівська область
28392,740560,411,3,345,267,78,740560,Чернігівська область
28393,740561,231,2,176,119,57,740561,Чернігівська область
28394,740562,414,5,239,162,77,740562,Чернігівська область
28395,740563,599,10,414,284,130,740563,Чернігівська область
28396,740564,650,9,464,252,212,740564,Чернігівська область
28397,740565,249,4,180,121,59,740565,Чернігівська область
28398,740566,1506,22,879,687,192,740566,Чернігівська область
28399,740567,618,12,419,313,106,740567,Чернігівська область
28400,740568,481,2,351,235,116,740568,Чернігівська область
28401,740569,507,4,311,203,108,740569,Чернігівська область
28402,740570,149,4,109,90,19,740570,Чернігівська область
28403,740571,591,17,413,318,95,740571,Чернігівська область
28404,740572,72,3,47,37,10,740572,Чернігівська область
28405,740573,276,2,174,130,44,740573,Чернігівська область
28406,740574,193,0,129,98,31,740574,Чернігівська область
28407,740575,490,5,349,188,161,740575,Чернігівська область
28408,740576,1840,25,916,770,146,740576,Чернігівська область
28409,740577,769,6,359,289,70,740577,Чернігівська область
28410,740578,540,12,277,227,50,740578,Чернігівська область
28411,740579,754,7,324,252,72,740579,Чернігівська область
28412,740580,64,0,49,41,8,740580,Чернігівська область
28413,740760,1500,22,814,644,170,740760,Чернігівська область
28414,740761,1230,22,710,590,120,740761,Чернігівська область
28415,740762,108,2,76,58,18,740762,Чернігівська область
28416,740763,50,0,32,20,12,740763,Чернігівська область
28417,740764,310,6,179,147,32,740764,Чернігівська область
28418,740765,711,10,472,391,81,740765,Чернігівська область
28419,740766,146,5,92,73,19,740766,Чернігівська область
28420,740767,375,0,241,212,29,740767,Чернігівська область
28421,740768,326,3,217,180,37,740768,Чернігівська область
28422,740769,534,10,334,237,97,740769,Чернігівська область
28423,740770,764,2,452,346,106,740770,Чернігівська область
28424,740771,297,7,197,163,34,740771,Чернігівська область
28425,740772,193,1,149,104,45,740772,Чернігівська область
28426,740773,325,4,240,169,71,740773,Чернігівська область
28427,740774,97,1,81,63,18,740774,Чернігівська область
28428,740775,254,2,148,127,21,740775,Чернігівська область
28429,740776,308,2,224,191,33,740776,Чернігівська область
28430,740777,45,1,33,25,8,740777,Чернігівська область
28431,740778,277,5,174,145,29,740778,Чернігівська область
28432,740779,209,2,141,99,42,740779,Чернігівська область
28433,740780,242,2,163,128,35,740780,Чернігівська область
28434,740781,288,3,207,168,39,740781,Чернігівська область
28435,740782,21,0,20,16,4,740782,Чернігівська область
28436,740923,2263,25,1290,1018,272,740923,Чернігівська область
28437,740924,2195,42,1281,1020,261,740924,Чернігівська область
28438,740925,2344,33,1386,1156,230,740925,Чернігівська область
28439,740926,2254,46,1439,1122,317,740926,Чернігівська область
28440,740927,2212,40,1240,1014,226,740927,Чернігівська область
28441,740928,2322,32,1359,1135,224,740928,Чернігівська область
28442,740929,2136,30,1249,1040,209,740929,Чернігівська область
28443,740930,2101,43,1262,993,269,740930,Чернігівська область
28444,740931,2256,43,1379,1090,289,740931,Чернігівська область
28445,740932,2185,35,1283,1036,247,740932,Чернігівська область
28446,740933,2340,35,1327,1091,236,740933,Чернігівська область
28447,740934,1666,25,907,764,143,740934,Чернігівська область
28448,740935,2148,26,1244,1001,243,740935,Чернігівська область
28449,740936,2342,37,1373,1123,250,740936,Чернігівська область
28450,740937,2218,33,1229,1013,216,740937,Чернігівська область
28451,740938,2353,33,1362,1102,260,740938,Чернігівська область
28452,740939,2344,43,1391,1101,290,740939,Чернігівська область
28453,740940,2343,50,1411,1161,250,740940,Чернігівська область
28454,740941,1832,18,1081,897,184,740941,Чернігівська область
28455,740942,1590,32,901,682,219,740942,Чернігівська область
28456,740943,1914,13,1081,897,184,740943,Чернігівська область
28457,740944,2214,25,1239,1033,206,740944,Чернігівська область
28458,740945,2367,38,1373,1111,262,740945,Чернігівська область
28459,740946,2339,46,1326,1109,217,740946,Чернігівська область
28460,740947,2131,37,1286,1013,273,740947,Чернігівська область
28461,740948,37,0,30,25,5,740948,Чернігівська область
28462,740047,2237,42,1292,980,312,740047,Чернігівська область
28463,740048,1306,18,742,575,167,740048,Чернігівська область
28464,740049,1900,28,1048,842,206,740049,Чернігівська область
28465,740050,1323,16,705,574,131,740050,Чернігівська область
28466,740051,1782,7,997,829,168,740051,Чернігівська область
28467,740052,454,5,307,226,81,740052,Чернігівська область
28468,740053,218,2,122,104,18,740053,Чернігівська область
28469,740054,486,7,373,324,49,740054,Чернігівська область
28470,740055,235,2,177,153,24,740055,Чернігівська область
28471,740056,592,6,367,289,78,740056,Чернігівська область
28472,740057,205,1,149,104,45,740057,Чернігівська область
28473,740058,324,0,208,111,97,740058,Чернігівська область
28474,740059,590,2,415,312,103,740059,Чернігівська область
28475,740060,95,2,57,36,21,740060,Чернігівська область
28476,740061,252,1,198,174,24,740061,Чернігівська область
28477,740062,1432,19,807,704,103,740062,Чернігівська область
28478,740063,580,8,319,240,79,740063,Чернігівська область
28479,740064,700,7,368,309,59,740064,Чернігівська область
28480,740065,537,6,444,365,79,740065,Чернігівська область
28481,740066,941,10,512,392,120,740066,Чернігівська область
28482,740068,1119,15,609,456,153,740068,Чернігівська область
28483,740070,881,5,466,361,105,740070,Чернігівська область
28484,740071,1268,15,754,576,178,740071,Чернігівська область
28485,740072,453,1,309,242,67,740072,Чернігівська область
28486,740073,506,4,356,295,61,740073,Чернігівська область
28487,740074,388,6,259,194,65,740074,Чернігівська область
28488,740075,166,0,141,114,27,740075,Чернігівська область
28489,740076,156,0,120,103,17,740076,Чернігівська область
28490,740077,564,5,432,360,72,740077,Чернігівська область
28491,740078,407,9,292,210,82,740078,Чернігівська область
28492,740079,788,7,477,391,86,740079,Чернігівська область
28493,740080,302,0,211,161,50,740080,Чернігівська область
28494,740081,215,0,134,105,29,740081,Чернігівська область
28495,740082,94,0,80,59,21,740082,Чернігівська область
28496,740084,532,9,318,253,65,740084,Чернігівська область
28497,740085,170,2,106,86,20,740085,Чернігівська область
28498,740086,380,4,246,186,60,740086,Чернігівська область
28499,740087,568,11,320,251,69,740087,Чернігівська область
28500,740088,18,0,18,12,6,740088,Чернігівська область
28501,740241,996,15,781,608,173,740241,Чернігівська область
28502,740242,186,0,134,111,23,740242,Чернігівська область
28503,740243,191,2,181,57,124,740243,Чернігівська область
28504,740244,434,17,330,244,86,740244,Чернігівська область
28505,740245,132,1,76,61,15,740245,Чернігівська область
28506,740246,188,3,135,103,32,740246,Чернігівська область
28507,740247,41,0,30,22,8,740247,Чернігівська область
28508,740248,356,5,186,137,49,740248,Чернігівська область
28509,740249,371,3,223,187,36,740249,Чернігівська область
28510,740250,258,3,184,112,72,740250,Чернігівська область
28511,740251,357,2,255,209,46,740251,Чернігівська область
28512,740252,149,1,96,78,18,740252,Чернігівська область
28513,740253,288,1,215,162,53,740253,Чернігівська область
28514,740254,408,5,250,150,100,740254,Чернігівська область
28515,740255,589,2,325,274,51,740255,Чернігівська область
28516,740256,417,3,293,213,80,740256,Чернігівська область
28517,740257,549,6,371,267,104,740257,Чернігівська область
28518,740258,246,5,144,87,57,740258,Чернігівська область
28519,740259,204,3,127,87,40,740259,Чернігівська область
28520,740260,440,2,248,199,49,740260,Чернігівська область
28521,740261,311,1,210,163,47,740261,Чернігівська область
28522,740262,64,0,51,31,20,740262,Чернігівська область
28523,740263,252,7,169,135,34,740263,Чернігівська область
28524,740264,315,2,226,172,54,740264,Чернігівська область
28525,740265,518,5,283,228,55,740265,Чернігівська область
28526,740266,373,8,236,182,54,740266,Чернігівська область
28527,740267,464,5,284,227,57,740267,Чернігівська область
28528,740268,169,2,114,87,27,740268,Чернігівська область
28529,740269,50,0,40,19,21,740269,Чернігівська область
28530,740270,590,4,362,293,69,740270,Чернігівська область
28531,740271,145,2,98,62,36,740271,Чернігівська область
28532,740272,139,3,104,73,31,740272,Чернігівська область
28533,740273,130,1,98,66,32,740273,Чернігівська область
28534,740274,273,3,185,134,51,740274,Чернігівська область
28535,740275,60,1,48,40,8,740275,Чернігівська область
28536,740276,80,1,62,44,18,740276,Чернігівська область
28537,740277,147,3,110,82,28,740277,Чернігівська область
28538,740278,193,0,147,134,13,740278,Чернігівська область
28539,740279,460,6,299,228,71,740279,Чернігівська область
28540,740280,139,1,97,74,23,740280,Чернігівська область
28541,740281,217,3,160,116,44,740281,Чернігівська область
28542,740282,190,2,119,88,31,740282,Чернігівська область
28543,740283,181,0,104,90,14,740283,Чернігівська область
28544,740284,140,3,98,79,19,740284,Чернігівська область
28545,740285,169,1,101,87,14,740285,Чернігівська область
28546,740286,120,1,76,43,33,740286,Чернігівська область
28547,740287,479,4,263,194,69,740287,Чернігівська область
28548,740288,312,2,212,162,50,740288,Чернігівська область
28549,740289,459,9,222,179,43,740289,Чернігівська область
28550,740290,235,2,138,90,48,740290,Чернігівська область
28551,740291,99,1,78,49,29,740291,Чернігівська область
28552,740292,400,5,230,161,69,740292,Чернігівська область
28553,740293,266,3,160,109,51,740293,Чернігівська область
28554,740294,67,0,42,26,16,740294,Чернігівська область
28555,740295,395,4,234,187,47,740295,Чернігівська область
28556,740296,224,5,121,86,35,740296,Чернігівська область
28557,740297,490,6,304,224,80,740297,Чернігівська область
28558,740298,65,0,44,33,11,740298,Чернігівська область
28559,740299,678,6,451,335,116,740299,Чернігівська область
28560,740300,322,1,210,149,61,740300,Чернігівська область
28561,740301,441,3,314,246,68,740301,Чернігівська область
28562,740302,90,0,73,50,23,740302,Чернігівська область
28563,740303,298,2,197,145,52,740303,Чернігівська область
28564,740304,282,3,163,121,42,740304,Чернігівська область
28565,740305,53,0,32,26,6,740305,Чернігівська область
28566,740306,576,15,337,223,114,740306,Чернігівська область
28567,740307,81,1,60,39,21,740307,Чернігівська область
28568,740308,1153,18,660,467,193,740308,Чернігівська область
28569,740309,2085,34,1251,863,388,740309,Чернігівська область
28570,740310,892,16,741,567,174,740310,Чернігівська область
28571,740311,1831,25,1155,760,395,740311,Чернігівська область
28572,740312,405,8,351,285,66,740312,Чернігівська область
28573,740313,1478,19,861,601,260,740313,Чернігівська область
28574,740314,1329,11,799,576,223,740314,Чернігівська область
28575,740315,1806,33,1093,860,233,740315,Чернігівська область
28576,740316,817,6,482,358,124,740316,Чернігівська область
28577,740317,1597,24,987,767,220,740317,Чернігівська область
28578,740318,933,14,558,424,134,740318,Чернігівська область
28579,740319,1247,14,687,532,155,740319,Чернігівська область
28580,740320,1911,15,955,802,153,740320,Чернігівська область
28581,740321,1534,33,859,660,199,740321,Чернігівська область
28582,740322,345,0,182,144,38,740322,Чернігівська область
28583,740323,110,1,64,52,12,740323,Чернігівська область
28584,740324,15,0,7,7,0,740324,Чернігівська область
28585,740325,5,0,4,2,2,740325,Чернігівська область
28586,740581,692,10,430,299,131,740581,Чернігівська область
28587,740582,324,2,212,163,49,740582,Чернігівська область
28588,740583,480,4,272,214,58,740583,Чернігівська область
28589,740584,128,0,70,55,15,740584,Чернігівська область
28590,740585,308,3,210,174,36,740585,Чернігівська область
28591,740586,454,6,302,246,56,740586,Чернігівська область
28592,740587,47,0,29,19,10,740587,Чернігівська область
28593,740588,321,4,213,179,34,740588,Чернігівська область
28594,740589,347,6,213,171,42,740589,Чернігівська область
28595,740590,1741,23,1057,936,121,740590,Чернігівська область
28596,740591,591,8,343,273,70,740591,Чернігівська область
28597,740592,391,7,224,139,85,740592,Чернігівська область
28598,740593,903,11,616,484,132,740593,Чернігівська область
28599,740594,168,0,102,87,15,740594,Чернігівська область
28600,740595,763,5,516,429,87,740595,Чернігівська область
28601,740596,64,0,51,31,20,740596,Чернігівська область
28602,740597,122,4,87,71,16,740597,Чернігівська область
28603,740598,296,0,206,155,51,740598,Чернігівська область
28604,740599,804,8,519,456,63,740599,Чернігівська область
28605,740600,689,11,411,337,74,740600,Чернігівська область
28606,740601,365,3,193,142,51,740601,Чернігівська область
28607,740602,282,2,165,123,42,740602,Чернігівська область
28608,740603,204,3,117,90,27,740603,Чернігівська область
28609,740604,409,3,270,224,46,740604,Чернігівська область
28610,740605,114,2,89,72,17,740605,Чернігівська область
28611,740606,100,1,68,50,18,740606,Чернігівська область
28612,740607,1060,5,629,537,92,740607,Чернігівська область
28613,740608,1150,21,719,601,118,740608,Чернігівська область
28614,740609,1268,20,775,608,167,740609,Чернігівська область
28615,740610,1191,16,574,498,76,740610,Чернігівська область
28616,740611,469,4,300,255,45,740611,Чернігівська область
28617,740612,1017,13,616,525,91,740612,Чернігівська область
28618,740613,1009,7,611,542,69,740613,Чернігівська область
28619,740614,435,6,221,178,43,740614,Чернігівська область
28620,740615,191,1,134,98,36,740615,Чернігівська область
28621,740616,555,4,303,252,51,740616,Чернігівська область
28622,740617,1021,11,646,543,103,740617,Чернігівська область
28623,740618,532,6,360,280,80,740618,Чернігівська область
28624,740619,40,0,32,24,8,740619,Чернігівська область
28625,740620,169,1,90,75,15,740620,Чернігівська область
28626,740621,200,1,129,96,33,740621,Чернігівська область
28627,740622,394,4,233,186,47,740622,Чернігівська область
28628,740623,85,1,46,32,14,740623,Чернігівська область
28629,740624,464,13,357,288,69,740624,Чернігівська область
28630,740625,414,2,291,244,47,740625,Чернігівська область
28631,740626,218,1,134,105,29,740626,Чернігівська область
28632,740627,105,0,58,35,23,740627,Чернігівська область
28633,740628,347,5,211,160,51,740628,Чернігівська область
28634,740629,471,6,264,209,55,740629,Чернігівська область
28635,740630,419,7,226,166,60,740630,Чернігівська область
28636,740631,373,4,205,154,51,740631,Чернігівська область
28637,740632,93,1,58,45,13,740632,Чернігівська область
28638,740633,237,4,172,122,50,740633,Чернігівська область
28639,740634,64,0,35,21,14,740634,Чернігівська область
28640,740635,1333,14,835,677,158,740635,Чернігівська область
28641,740636,129,0,67,49,18,740636,Чернігівська область
28642,740637,558,9,309,227,82,740637,Чернігівська область
28643,740638,366,3,201,170,31,740638,Чернігівська область
28644,740639,159,0,91,71,20,740639,Чернігівська область
28645,740640,855,12,515,410,105,740640,Чернігівська область
28646,740949,1714,28,1052,863,189,740949,Чернігівська область
28647,740950,1686,29,1062,874,188,740950,Чернігівська область
28648,740951,1975,23,1234,1011,223,740951,Чернігівська область
28649,740952,1165,23,713,580,133,740952,Чернігівська область
28650,740953,1212,10,762,620,142,740953,Чернігівська область
28651,740954,1128,21,699,561,138,740954,Чернігівська область
28652,740955,1613,26,1032,809,223,740955,Чернігівська область
28653,740956,1129,13,742,609,133,740956,Чернігівська область
28654,740957,1355,25,848,692,156,740957,Чернігівська область
28655,740958,1299,17,774,588,186,740958,Чернігівська область
28656,740959,1591,29,967,795,172,740959,Чернігівська область
28657,740960,1923,27,1254,1008,246,740960,Чернігівська область
28658,740961,1836,28,1150,925,225,740961,Чернігівська область
28659,740962,1833,29,1145,906,239,740962,Чернігівська область
28660,740963,1210,14,721,583,138,740963,Чернігівська область
28661,740964,1527,12,932,795,137,740964,Чернігівська область
28662,740965,1788,25,1187,956,231,740965,Чернігівська область
28663,740966,1837,36,1185,946,239,740966,Чернігівська область
28664,740967,1386,26,914,786,128,740967,Чернігівська область
28665,740968,2005,36,1247,1001,246,740968,Чернігівська область
28666,740969,1262,25,782,643,139,740969,Чернігівська область
28667,740970,1518,20,962,807,155,740970,Чернігівська область
28668,740971,1828,30,1138,948,190,740971,Чернігівська область
28669,740972,1324,14,751,627,124,740972,Чернігівська область
28670,740973,1965,23,1204,1016,188,740973,Чернігівська область
28671,740974,1099,19,732,601,131,740974,Чернігівська область
28672,740975,1736,34,1087,902,185,740975,Чернігівська область
28673,740976,1907,35,1206,1014,192,740976,Чернігівська область
28674,740977,1774,18,1090,934,156,740977,Чернігівська область
28675,740978,704,10,476,406,70,740978,Чернігівська область
28676,740979,70,0,64,52,12,740979,Чернігівська область
28677,740981,67,0,48,43,5,740981,Чернігівська область
28678,740982,18,0,18,15,3,740982,Чернігівська область
28679,800001,2583,45,1735,994,741,800001,м.Київ
28680,800002,2134,40,1387,735,652,800002,м.Київ
28681,800003,1659,20,983,719,264,800003,м.Київ
28682,800004,1869,47,1103,714,389,800004,м.Київ
28683,800005,2524,49,1627,910,717,800005,м.Київ
28684,800006,1984,35,1259,847,412,800006,м.Київ
28685,800007,1691,20,1029,693,336,800007,м.Київ
28686,800008,1766,43,1133,718,415,800008,м.Київ
28687,800009,1744,29,1101,729,372,800009,м.Київ
28688,800010,1602,30,1073,711,362,800010,м.Київ
28689,800011,2200,38,1407,737,670,800011,м.Київ
28690,800012,1249,25,798,464,334,800012,м.Київ
28691,800013,2245,48,1465,902,563,800013,м.Київ
28692,800014,2098,32,1352,845,507,800014,м.Київ
28693,800015,1991,47,1193,759,434,800015,м.Київ
28694,800016,1157,32,775,404,371,800016,м.Київ
28695,800017,2170,59,1457,818,639,800017,м.Київ
28696,800018,2084,40,1167,824,343,800018,м.Київ
28697,800019,2423,40,1592,929,663,800019,м.Київ
28698,800020,1982,42,1112,778,334,800020,м.Київ
28699,800021,2305,44,1562,901,661,800021,м.Київ
28700,800022,1885,24,1106,744,362,800022,м.Київ
28701,800023,1995,34,1284,819,465,800023,м.Київ
28702,800024,2013,35,1273,817,456,800024,м.Київ
28703,800025,1041,12,605,396,209,800025,м.Київ
28704,800026,2092,35,1353,807,546,800026,м.Київ
28705,800027,2257,62,1478,830,648,800027,м.Київ
28706,800028,2273,59,1472,795,677,800028,м.Київ
28707,800029,2114,35,1474,916,558,800029,м.Київ
28708,800030,2192,44,1414,906,508,800030,м.Київ
28709,800031,2378,41,1602,894,708,800031,м.Київ
28710,800032,2061,46,1400,856,544,800032,м.Київ
28711,800033,2136,42,1416,908,508,800033,м.Київ
28712,800034,2200,39,1416,881,535,800034,м.Київ
28713,800035,2161,58,1428,871,557,800035,м.Київ
28714,800036,2264,54,1401,685,716,800036,м.Київ
28715,800037,2303,38,1486,738,748,800037,м.Київ
28716,800038,2051,56,1352,662,690,800038,м.Київ
28717,800039,1906,35,1280,683,597,800039,м.Київ
28718,800040,2626,53,1877,965,912,800040,м.Київ
28719,800041,2307,30,1624,899,725,800041,м.Київ
28720,800042,2687,36,1686,1193,493,800042,м.Київ
28721,800043,2601,46,1826,927,899,800043,м.Київ
28722,800044,2238,40,1443,896,547,800044,м.Київ
28723,800045,2399,41,1425,913,512,800045,м.Київ
28724,800046,2008,41,1325,833,492,800046,м.Київ
28725,800047,2082,57,1367,869,498,800047,м.Київ
28726,800048,2015,39,1313,844,469,800048,м.Київ
28727,800049,2143,43,1412,816,596,800049,м.Київ
28728,800050,2000,41,1275,806,469,800050,м.Київ
28729,800051,2030,38,1364,873,491,800051,м.Київ
28730,800052,1967,52,1256,721,535,800052,м.Київ
28731,800053,2119,57,1370,778,592,800053,м.Київ
28732,800054,2252,54,1462,840,622,800054,м.Київ
28733,800055,2585,49,1599,981,618,800055,м.Київ
28734,800056,1867,34,1201,768,433,800056,м.Київ
28735,800057,2341,47,1485,850,635,800057,м.Київ
28736,800058,2346,39,1197,752,445,800058,м.Київ
28737,800059,2265,51,1426,794,632,800059,м.Київ
28738,800060,2399,58,1807,967,840,800060,м.Київ
28739,800061,1884,36,1231,773,458,800061,м.Київ
28740,800062,2096,42,1321,768,553,800062,м.Київ
28741,800063,2507,60,1625,909,716,800063,м.Київ
28742,800064,2309,40,1296,795,501,800064,м.Київ
28743,800065,2558,55,1596,969,627,800065,м.Київ
28744,800066,2674,41,1620,1033,587,800066,м.Київ
28745,800067,2113,54,1475,845,630,800067,м.Київ
28746,800068,2162,45,1438,830,608,800068,м.Київ
28747,800069,2378,42,1530,873,657,800069,м.Київ
28748,800070,1651,32,1115,713,402,800070,м.Київ
28749,800071,2081,55,1357,804,553,800071,м.Київ
28750,800072,1885,55,1220,654,566,800072,м.Київ
28751,800073,2324,35,1403,755,648,800073,м.Київ
28752,800074,1882,43,1201,667,534,800074,м.Київ
28753,800075,1952,38,1207,677,530,800075,м.Київ
28754,800076,1967,46,1203,650,553,800076,м.Київ
28755,800077,2256,43,1424,834,590,800077,м.Київ
28756,800078,1999,49,1410,743,667,800078,м.Київ
28757,800079,2163,42,1374,775,599,800079,м.Київ
28758,800080,1924,35,1270,692,578,800080,м.Київ
28759,800081,2014,42,1316,743,573,800081,м.Київ
28760,800082,139,4,112,63,49,800082,м.Київ
28761,800083,92,0,71,47,24,800083,м.Київ
28762,800084,65,1,64,44,20,800084,м.Київ
28763,800085,40,1,38,29,9,800085,м.Київ
28764,801092,2378,43,1700,926,774,801092,м.Київ
28765,801096,1861,29,1222,607,615,801096,м.Київ
28766,801099,2296,41,1399,820,579,801099,м.Київ
28767,801101,2690,43,1904,974,930,801101,м.Київ
28768,800086,1948,35,1225,855,370,800086,м.Київ
28769,800087,1883,36,1280,760,520,800087,м.Київ
28770,800088,2336,35,1615,935,680,800088,м.Київ
28771,800089,2460,38,1768,1034,734,800089,м.Київ
28772,800090,2405,37,1648,999,649,800090,м.Київ
28773,800091,2192,27,1468,901,567,800091,м.Київ
28774,800092,2055,52,1393,776,617,800092,м.Київ
28775,800093,2264,41,1517,926,591,800093,м.Київ
28776,800094,2301,49,1563,1001,562,800094,м.Київ
28777,800095,2451,44,1673,949,724,800095,м.Київ
28778,800096,1978,31,1337,769,568,800096,м.Київ
28779,800097,2482,39,1692,953,739,800097,м.Київ
28780,800098,2524,53,1680,1005,675,800098,м.Київ
28781,800099,2182,52,1514,910,604,800099,м.Київ
28782,800100,1481,35,1033,589,444,800100,м.Київ
28783,800101,1964,36,1330,851,479,800101,м.Київ
28784,800102,2455,56,1677,1026,651,800102,м.Київ
28785,800103,2114,18,1281,845,436,800103,м.Київ
28786,800104,1444,14,979,541,438,800104,м.Київ
28787,800105,2328,54,1596,875,721,800105,м.Київ
28788,800106,2055,52,1375,766,609,800106,м.Київ
28789,800107,2256,36,1629,879,750,800107,м.Київ
28790,800108,1602,34,1131,621,510,800108,м.Київ
28791,800109,2337,42,1606,977,629,800109,м.Київ
28792,800110,2414,43,1613,952,661,800110,м.Київ
28793,800111,2332,45,1562,956,606,800111,м.Київ
28794,800112,2175,35,1426,933,493,800112,м.Київ
28795,800113,2049,42,1377,743,634,800113,м.Київ
28796,800114,2536,59,1685,944,741,800114,м.Київ
28797,800115,1839,40,1230,725,505,800115,м.Київ
28798,800116,2304,46,1515,932,583,800116,м.Київ
28799,800117,2208,37,1483,958,525,800117,м.Київ
28800,800118,2499,35,1745,1032,713,800118,м.Київ
28801,800119,2319,51,1517,859,658,800119,м.Київ
28802,800120,1452,37,994,606,388,800120,м.Київ
28803,800121,1523,30,1033,620,413,800121,м.Київ
28804,800122,2149,36,1411,879,532,800122,м.Київ
28805,800123,2247,47,1564,912,652,800123,м.Київ
28806,800124,2315,49,1494,892,602,800124,м.Київ
28807,800125,2281,43,1530,934,596,800125,м.Київ
28808,800126,1817,33,1214,678,536,800126,м.Київ
28809,800127,2172,41,1451,937,514,800127,м.Київ
28810,800128,1976,50,1300,721,579,800128,м.Київ
28811,800129,2380,53,1640,981,659,800129,м.Київ
28812,800130,2218,47,1544,929,615,800130,м.Київ
28813,800131,2267,38,1547,870,677,800131,м.Київ
28814,800132,2203,34,1513,986,527,800132,м.Київ
28815,800133,2402,49,1557,950,607,800133,м.Київ
28816,800134,1947,35,1271,811,460,800134,м.Київ
28817,800135,1563,27,1044,696,348,800135,м.Київ
28818,800136,2273,46,1522,1003,519,800136,м.Київ
28819,800137,2232,45,1506,1005,501,800137,м.Київ
28820,800138,2298,37,1566,1050,516,800138,м.Київ
28821,800139,2116,47,1366,858,508,800139,м.Київ
28822,800140,2401,51,1631,952,679,800140,м.Київ
28823,800141,2481,50,1713,1074,639,800141,м.Київ
28824,800142,2317,32,1507,982,525,800142,м.Київ
28825,800143,2169,43,1412,930,482,800143,м.Київ
28826,800144,2323,49,1538,1065,473,800144,м.Київ
28827,800145,2227,48,1466,941,525,800145,м.Київ
28828,800146,2047,43,1350,890,460,800146,м.Київ
28829,800147,1971,31,1350,876,474,800147,м.Київ
28830,800148,1853,38,1208,765,443,800148,м.Київ
28831,800149,2252,41,1503,931,572,800149,м.Київ
28832,800150,2192,48,1500,928,572,800150,м.Київ
28833,800151,2207,41,1391,902,489,800151,м.Київ
28834,800152,2265,53,1449,951,498,800152,м.Київ
28835,800153,2140,43,1404,945,459,800153,м.Київ
28836,800154,2247,41,1514,1008,506,800154,м.Київ
28837,800155,2221,37,1497,1007,490,800155,м.Київ
28838,800156,2226,55,1412,924,488,800156,м.Київ
28839,800205,2288,44,1383,923,460,800205,м.Київ
28840,800206,2301,35,1398,938,460,800206,м.Київ
28841,800207,2307,31,1437,971,466,800207,м.Київ
28842,800208,2347,43,1325,878,447,800208,м.Київ
28843,800209,2368,32,1498,1009,489,800209,м.Київ
28844,800210,2452,39,1549,1058,491,800210,м.Київ
28845,800211,2528,42,1373,956,417,800211,м.Київ
28846,800212,188,4,174,126,48,800212,м.Київ
28847,800213,22,0,22,16,6,800213,м.Київ
28848,800214,38,0,36,27,9,800214,м.Київ
28849,801073,1989,46,1385,806,579,801073,м.Київ
28850,801074,2318,38,1542,905,637,801074,м.Київ
28851,801076,2383,46,1687,956,731,801076,м.Київ
28852,801077,1954,38,1372,767,605,801077,м.Київ
28853,801078,2450,38,1736,846,890,801078,м.Київ
28854,801082,2302,52,1532,984,548,801082,м.Київ
28855,801097,1852,29,1291,720,571,801097,м.Київ
28856,801098,2699,40,1821,1102,719,801098,м.Київ
28857,801103,1536,20,1143,624,519,801103,м.Київ
28858,800215,2214,46,1469,915,554,800215,м.Київ
28859,800216,2213,44,1525,966,559,800216,м.Київ
28860,800217,2078,52,1357,842,515,800217,м.Київ
28861,800218,2079,48,1411,866,545,800218,м.Київ
28862,800219,2101,32,1424,900,524,800219,м.Київ
28863,800220,2241,39,1483,929,554,800220,м.Київ
28864,800221,2118,45,1358,862,496,800221,м.Київ
28865,800222,2184,44,1434,898,536,800222,м.Київ
28866,800223,2261,44,1483,980,503,800223,м.Київ
28867,800224,2309,56,1535,1005,530,800224,м.Київ
28868,800225,2159,36,1374,864,510,800225,м.Київ
28869,800226,2288,43,1424,969,455,800226,м.Київ
28870,800227,2198,48,1438,963,475,800227,м.Київ
28871,800236,2294,39,1473,944,529,800236,м.Київ
28872,800237,2330,50,1553,1026,527,800237,м.Київ
28873,800238,2235,39,1465,933,532,800238,м.Київ
28874,800239,2224,35,1551,1004,547,800239,м.Київ
28875,800240,2295,42,1488,1005,483,800240,м.Київ
28876,800241,2092,37,1313,810,503,800241,м.Київ
28877,800242,2269,44,1403,985,418,800242,м.Київ
28878,800243,1929,35,1231,791,440,800243,м.Київ
28879,800254,2128,35,1432,921,511,800254,м.Київ
28880,800255,2169,44,1484,986,498,800255,м.Київ
28881,800256,2070,43,1410,876,534,800256,м.Київ
28882,800257,1808,31,1218,738,480,800257,м.Київ
28883,800258,1444,33,955,620,335,800258,м.Київ
28884,800259,2238,26,1522,1020,502,800259,м.Київ
28885,800260,2355,40,1578,1027,551,800260,м.Київ
28886,800261,2210,31,1442,939,503,800261,м.Київ
28887,800262,1188,17,798,567,231,800262,м.Київ
28888,800263,1899,23,1218,845,373,800263,м.Київ
28889,800264,2278,43,1441,993,448,800264,м.Київ
28890,800265,2227,44,1470,1001,469,800265,м.Київ
28891,800266,2292,49,1434,980,454,800266,м.Київ
28892,800267,2317,44,1490,891,599,800267,м.Київ
28893,800268,2287,40,1462,990,472,800268,м.Київ
28894,800269,2389,50,1472,940,532,800269,м.Київ
28895,800270,2449,42,1620,1027,593,800270,м.Київ
28896,800273,2179,43,1427,941,486,800273,м.Київ
28897,800274,2307,33,1547,967,580,800274,м.Київ
28898,800275,2419,28,1348,958,390,800275,м.Київ
28899,800276,1895,27,1255,829,426,800276,м.Київ
28900,800277,1795,40,1179,788,391,800277,м.Київ
28901,800278,2188,30,1467,943,524,800278,м.Київ
28902,800279,1963,30,1335,849,486,800279,м.Київ
28903,800280,2401,42,1556,951,605,800280,м.Київ
28904,800281,2293,48,1489,955,534,800281,м.Київ
28905,800282,2443,24,1592,983,609,800282,м.Київ
28906,800283,1329,20,863,558,305,800283,м.Київ
28907,800284,2228,41,1498,941,557,800284,м.Київ
28908,800285,1717,21,1097,733,364,800285,м.Київ
28909,800286,2448,41,1600,963,637,800286,м.Київ
28910,800287,2213,23,1399,937,462,800287,м.Київ
28911,800288,2496,42,1612,1024,588,800288,м.Київ
28912,800289,1586,22,1047,681,366,800289,м.Київ
28913,800290,1351,29,878,528,350,800290,м.Київ
28914,800291,2293,25,1473,961,512,800291,м.Київ
28915,800292,2074,30,1380,884,496,800292,м.Київ
28916,800293,1977,42,1228,830,398,800293,м.Київ
28917,800294,1920,24,1244,831,413,800294,м.Київ
28918,800295,1913,29,1256,838,418,800295,м.Київ
28919,800296,2025,31,1337,878,459,800296,м.Київ
28920,800297,2252,47,1460,907,553,800297,м.Київ
28921,800298,2221,43,1425,932,493,800298,м.Київ
28922,800299,2153,30,1430,915,515,800299,м.Київ
28923,800300,2409,49,1597,1057,540,800300,м.Київ
28924,800301,2422,39,1677,1089,588,800301,м.Київ
28925,800302,2118,37,1405,940,465,800302,м.Київ
28926,800303,2237,36,1452,990,462,800303,м.Київ
28927,800304,2063,33,1327,884,443,800304,м.Київ
28928,801068,1751,20,1214,696,518,801068,м.Київ
28929,801069,2373,30,1570,995,575,801069,м.Київ
28930,801070,2236,49,1503,850,653,801070,м.Київ
28931,801071,1920,41,1201,853,348,801071,м.Київ
28932,801079,1810,31,1212,774,438,801079,м.Київ
28933,801080,1494,30,963,626,337,801080,м.Київ
28934,801088,1624,27,1091,704,387,801088,м.Київ
28935,801089,1386,27,890,631,259,801089,м.Київ
28936,801090,2087,31,1498,977,521,801090,м.Київ
28937,801104,1208,23,784,495,289,801104,м.Київ
28938,800350,2083,38,1308,817,491,800350,м.Київ
28939,800351,1354,15,817,542,275,800351,м.Київ
28940,800352,2345,41,1512,914,598,800352,м.Київ
28941,800353,1898,33,1234,779,455,800353,м.Київ
28942,800366,1837,47,1105,768,337,800366,м.Київ
28943,800369,1895,31,1136,761,375,800369,м.Київ
28944,800370,1765,30,1135,718,417,800370,м.Київ
28945,800371,1786,43,1078,700,378,800371,м.Київ
28946,800372,2080,32,1248,830,418,800372,м.Київ
28947,800373,1649,17,943,633,310,800373,м.Київ
28948,800374,2387,49,1468,911,557,800374,м.Київ
28949,800375,2506,33,1549,1019,530,800375,м.Київ
28950,800376,2591,42,1724,922,802,800376,м.Київ
28951,800377,2365,35,1547,945,602,800377,м.Київ
28952,800378,2112,49,1446,858,588,800378,м.Київ
28953,800379,2343,46,1604,921,683,800379,м.Київ
28954,800380,1751,29,1132,669,463,800380,м.Київ
28955,800381,2474,65,1648,922,726,800381,м.Київ
28956,800382,1849,49,1225,690,535,800382,м.Київ
28957,800383,2178,66,1463,858,605,800383,м.Київ
28958,800384,2300,36,1441,968,473,800384,м.Київ
28959,800385,2327,38,1406,929,477,800385,м.Київ
28960,800386,1504,29,986,634,352,800386,м.Київ
28961,800387,1192,31,774,468,306,800387,м.Київ
28962,800388,2171,35,1320,893,427,800388,м.Київ
28963,800389,1993,22,985,700,285,800389,м.Київ
28964,800390,2366,50,1573,959,614,800390,м.Київ
28965,800391,2325,58,1484,883,601,800391,м.Київ
28966,800392,2323,60,1459,900,559,800392,м.Київ
28967,800393,2329,54,1525,923,602,800393,м.Київ
28968,800394,2303,54,1412,876,536,800394,м.Київ
28969,800395,2327,46,1554,904,650,800395,м.Київ
28970,800396,2128,46,1378,805,573,800396,м.Київ
28971,800397,1718,41,1067,681,386,800397,м.Київ
28972,800398,2392,38,1523,973,550,800398,м.Київ
28973,800399,2257,47,1433,906,527,800399,м.Київ
28974,800400,1299,32,881,516,365,800400,м.Київ
28975,800401,2208,37,1376,826,550,800401,м.Київ
28976,800402,2316,54,1539,914,625,800402,м.Київ
28977,800403,2369,44,1592,971,621,800403,м.Київ
28978,800404,2477,37,1525,1006,519,800404,м.Київ
28979,800405,2532,42,1694,1077,617,800405,м.Київ
28980,800406,2328,29,1443,926,517,800406,м.Київ
28981,800407,2062,38,1226,814,412,800407,м.Київ
28982,800431,1604,25,996,663,333,800431,м.Київ
28983,800432,2031,39,1265,859,406,800432,м.Київ
28984,800433,2233,36,1387,941,446,800433,м.Київ
28985,800434,2289,42,1341,920,421,800434,м.Київ
28986,800438,2473,33,1694,827,867,800438,м.Київ
28987,800439,1189,12,913,439,474,800439,м.Київ
28988,800440,2130,44,1384,767,617,800440,м.Київ
28989,800441,2526,63,1705,982,723,800441,м.Київ
28990,800442,2274,43,1512,865,647,800442,м.Київ
28991,800443,2298,53,1471,890,581,800443,м.Київ
28992,800444,2082,65,1354,792,562,800444,м.Київ
28993,800445,1386,29,940,564,376,800445,м.Київ
28994,800446,2302,54,1547,908,639,800446,м.Київ
28995,800447,1499,42,994,580,414,800447,м.Київ
28996,800448,2060,40,1312,774,538,800448,м.Київ
28997,800449,2282,44,1519,907,612,800449,м.Київ
28998,800450,1971,39,1251,761,490,800450,м.Київ
28999,800451,2158,49,1381,817,564,800451,м.Київ
29000,800452,1679,34,1119,647,472,800452,м.Київ
29001,800453,2373,54,1479,910,569,800453,м.Київ
29002,800454,2149,43,1355,814,541,800454,м.Київ
29003,800455,2226,37,1443,889,554,800455,м.Київ
29004,800456,2263,45,1428,923,505,800456,м.Київ
29005,800457,2145,42,1335,881,454,800457,м.Київ
29006,800458,2130,43,1404,872,532,800458,м.Київ
29007,800459,2149,47,1387,898,489,800459,м.Київ
29008,800460,2388,50,1461,909,552,800460,м.Київ
29009,800461,1877,24,1194,763,431,800461,м.Київ
29010,800462,1996,31,1244,782,462,800462,м.Київ
29011,800463,1614,27,985,585,400,800463,м.Київ
29012,800464,2481,36,1631,998,633,800464,м.Київ
29013,800465,2287,39,1413,890,523,800465,м.Київ
29014,800466,1920,34,1245,748,497,800466,м.Київ
29015,800467,2184,55,1415,952,463,800467,м.Київ
29016,800468,2060,47,1286,835,451,800468,м.Київ
29017,800469,219,10,207,150,57,800469,м.Київ
29018,800470,61,0,61,46,15,800470,м.Київ
29019,800228,2159,43,1423,946,477,800228,м.Київ
29020,800229,2226,42,1414,951,463,800229,м.Київ
29021,800230,2016,40,1271,832,439,800230,м.Київ
29022,800231,1972,34,1259,775,484,800231,м.Київ
29023,800232,2164,42,1480,940,540,800232,м.Київ
29024,800233,2377,34,1402,953,449,800233,м.Київ
29025,800234,2354,31,1539,951,588,800234,м.Київ
29026,800235,2277,41,1399,986,413,800235,м.Київ
29027,800244,2264,51,1427,920,507,800244,м.Київ
29028,800245,2236,38,1414,946,468,800245,м.Київ
29029,800246,2166,52,1329,890,439,800246,м.Київ
29030,800247,2030,27,1337,876,461,800247,м.Київ
29031,800248,2207,41,1416,968,448,800248,м.Київ
29032,800249,2092,33,1404,913,491,800249,м.Київ
29033,800250,2109,41,1354,882,472,800250,м.Київ
29034,800251,2186,41,1336,850,486,800251,м.Київ
29035,800252,2117,35,1344,834,510,800252,м.Київ
29036,800253,2121,55,1323,940,383,800253,м.Київ
29037,800271,2391,46,1590,987,603,800271,м.Київ
29038,800272,2252,48,1513,997,516,800272,м.Київ
29039,800305,2178,40,1316,858,458,800305,м.Київ
29040,800306,2116,48,1239,820,419,800306,м.Київ
29041,800307,2055,39,1363,882,481,800307,м.Київ
29042,800308,2186,32,1403,868,535,800308,м.Київ
29043,800309,2153,45,1344,870,474,800309,м.Київ
29044,800310,2015,47,1324,822,502,800310,м.Київ
29045,800311,2177,47,1365,930,435,800311,м.Київ
29046,800312,2229,36,1334,1026,308,800312,м.Київ
29047,800313,1665,38,1004,663,341,800313,м.Київ
29048,800314,1623,35,1036,700,336,800314,м.Київ
29049,800315,1990,37,1297,835,462,800315,м.Київ
29050,800316,2039,53,1276,818,458,800316,м.Київ
29051,800317,2252,42,1345,878,467,800317,м.Київ
29052,800318,2270,50,1346,923,423,800318,м.Київ
29053,800319,1926,35,1186,771,415,800319,м.Київ
29054,800320,2129,50,1311,829,482,800320,м.Київ
29055,800321,2252,49,1421,943,478,800321,м.Київ
29056,800322,2341,46,1417,891,526,800322,м.Київ
29057,800323,2360,45,1507,978,529,800323,м.Київ
29058,800324,2231,45,1398,932,466,800324,м.Київ
29059,800325,2333,41,1425,941,484,800325,м.Київ
29060,800326,2189,45,1388,972,416,800326,м.Київ
29061,800327,229,9,185,147,38,800327,м.Київ
29062,800328,2215,37,1346,920,426,800328,м.Київ
29063,800329,2145,60,1292,872,420,800329,м.Київ
29064,800330,2246,52,1416,943,473,800330,м.Київ
29065,800331,2279,40,1502,1005,497,800331,м.Київ
29066,800332,1850,32,1190,755,435,800332,м.Київ
29067,800333,2100,59,1253,856,397,800333,м.Київ
29068,800334,1912,30,1192,857,335,800334,м.Київ
29069,800335,2198,39,1310,884,426,800335,м.Київ
29070,800336,2497,41,1631,1104,527,800336,м.Київ
29071,800337,1518,10,953,454,499,800337,м.Київ
29072,800338,230,10,160,111,49,800338,м.Київ
29073,800339,34,1,33,22,11,800339,м.Київ
29074,800340,83,2,81,59,22,800340,м.Київ
29075,800341,109,0,80,60,20,800341,м.Київ
29076,800342,2270,40,1466,960,506,800342,м.Київ
29077,800343,2300,40,1451,927,524,800343,м.Київ
29078,800344,2189,31,1383,859,524,800344,м.Київ
29079,800345,2140,39,1347,853,494,800345,м.Київ
29080,800346,2141,46,1397,905,492,800346,м.Київ
29081,800347,2201,41,1344,846,498,800347,м.Київ
29082,800348,2174,48,1360,851,509,800348,м.Київ
29083,800349,2135,39,1450,891,559,800349,м.Київ
29084,800354,2057,35,1196,828,368,800354,м.Київ
29085,800355,2086,35,1341,884,457,800355,м.Київ
29086,800356,2095,52,1322,869,453,800356,м.Київ
29087,800357,1802,38,1120,713,407,800357,м.Київ
29088,800358,2165,50,1364,885,479,800358,м.Київ
29089,800359,1473,27,960,674,286,800359,м.Київ
29090,800360,2150,43,1397,927,470,800360,м.Київ
29091,800361,1467,27,878,629,249,800361,м.Київ
29092,800362,2303,40,1383,899,484,800362,м.Київ
29093,800363,2246,28,1371,916,455,800363,м.Київ
29094,800364,1822,44,1091,730,361,800364,м.Київ
29095,800365,2348,39,1443,1009,434,800365,м.Київ
29096,800367,2024,44,1251,841,410,800367,м.Київ
29097,800368,2353,43,1497,922,575,800368,м.Київ
29098,801072,1224,19,755,517,238,801072,м.Київ
29099,801081,1433,16,903,725,178,801081,м.Київ
29100,1,95,1,85,65,20,1,м.Київ
29101,800157,2087,40,1342,904,438,800157,м.Київ
29102,800158,2374,50,1563,1027,536,800158,м.Київ
29103,800159,1309,12,919,633,286,800159,м.Київ
29104,800160,1940,41,1210,805,405,800160,м.Київ
29105,800161,2254,41,1401,957,444,800161,м.Київ
29106,800162,2211,36,1392,930,462,800162,м.Київ
29107,800163,2059,29,1276,881,395,800163,м.Київ
29108,800164,2213,29,1295,932,363,800164,м.Київ
29109,800165,2136,40,1400,911,489,800165,м.Київ
29110,800166,1739,45,1078,708,370,800166,м.Київ
29111,800167,2292,42,1518,1017,501,800167,м.Київ
29112,800168,2146,32,1406,936,470,800168,м.Київ
29113,800169,2083,28,1384,882,502,800169,м.Київ
29114,800170,2275,38,1508,960,548,800170,м.Київ
29115,800171,2221,47,1433,961,472,800171,м.Київ
29116,800172,2194,36,1463,934,529,800172,м.Київ
29117,800173,2486,61,1665,1033,632,800173,м.Київ
29118,800174,2340,38,1581,972,609,800174,м.Київ
29119,800175,1153,25,754,492,262,800175,м.Київ
29120,800176,2368,41,1523,966,557,800176,м.Київ
29121,800177,2332,49,1556,1028,528,800177,м.Київ
29122,800178,2240,39,1493,947,546,800178,м.Київ
29123,800179,2202,27,1375,951,424,800179,м.Київ
29124,800180,1913,34,1172,848,324,800180,м.Київ
29125,800181,1931,37,1183,841,342,800181,м.Київ
29126,800182,2168,31,1312,898,414,800182,м.Київ
29127,800183,2346,50,1428,977,451,800183,м.Київ
29128,800184,2235,41,1398,966,432,800184,м.Київ
29129,800185,1874,45,1113,786,327,800185,м.Київ
29130,800186,2071,39,1186,881,305,800186,м.Київ
29131,800187,2213,47,1412,956,456,800187,м.Київ
29132,800188,2078,40,1311,938,373,800188,м.Київ
29133,800189,2065,43,1293,869,424,800189,м.Київ
29134,800190,1979,42,1282,856,426,800190,м.Київ
29135,800191,2463,47,1557,1019,538,800191,м.Київ
29136,800192,2596,26,1286,995,291,800192,м.Київ
29137,800193,2120,27,1376,998,378,800193,м.Київ
29138,800194,2304,41,1384,990,394,800194,м.Київ
29139,800195,804,11,464,349,115,800195,м.Київ
29140,800196,2296,53,1526,994,532,800196,м.Київ
29141,800197,2043,39,1305,911,394,800197,м.Київ
29142,800198,2289,34,1415,1063,352,800198,м.Київ
29143,800199,2082,31,1284,916,368,800199,м.Київ
29144,800200,2232,44,1276,856,420,800200,м.Київ
29145,800201,1978,41,1248,854,394,800201,м.Київ
29146,800202,2210,46,1429,893,536,800202,м.Київ
29147,800203,1789,38,1191,775,416,800203,м.Київ
29148,800204,1625,36,1040,672,368,800204,м.Київ
29149,800408,2193,45,1320,871,449,800408,м.Київ
29150,800409,2382,44,1488,973,515,800409,м.Київ
29151,800410,2204,45,1296,828,468,800410,м.Київ
29152,800411,2250,38,1393,902,491,800411,м.Київ
29153,800412,2466,53,1601,994,607,800412,м.Київ
29154,800413,2340,49,1425,945,480,800413,м.Київ
29155,800414,2381,37,1467,1003,464,800414,м.Київ
29156,800415,2446,44,1467,1016,451,800415,м.Київ
29157,800416,2444,43,1421,931,490,800416,м.Київ
29158,800417,2451,46,1585,1045,540,800417,м.Київ
29159,800418,2359,35,1310,908,402,800418,м.Київ
29160,800419,1567,16,879,559,320,800419,м.Київ
29161,800420,2120,38,1368,900,468,800420,м.Київ
29162,800421,2057,31,1260,804,456,800421,м.Київ
29163,800422,1413,31,810,564,246,800422,м.Київ
29164,800423,1917,26,1143,769,374,800423,м.Київ
29165,800424,2277,39,1404,957,447,800424,м.Київ
29166,800425,1608,13,562,342,220,800425,м.Київ
29167,800426,2233,26,1394,965,429,800426,м.Київ
29168,800427,2365,22,1227,908,319,800427,м.Київ
29169,800428,2291,32,1406,915,491,800428,м.Київ
29170,800429,1669,20,1062,676,386,800429,м.Київ
29171,800430,2446,39,1469,973,496,800430,м.Київ
29172,800435,2308,39,1495,1013,482,800435,м.Київ
29173,800436,2346,52,1452,923,529,800436,м.Київ
29174,800437,1455,38,864,598,266,800437,м.Київ
29175,801075,1224,28,832,518,314,801075,м.Київ
29176,800471,2432,27,1340,869,471,800471,м.Київ
29177,800472,2116,42,1356,811,545,800472,м.Київ
29178,800473,2070,37,1266,795,471,800473,м.Київ
29179,800474,2173,53,1404,844,560,800474,м.Київ
29180,800475,2231,46,1443,877,566,800475,м.Київ
29181,800476,1993,45,1289,803,486,800476,м.Київ
29182,800477,2199,49,1456,884,572,800477,м.Київ
29183,800478,2151,47,1456,843,613,800478,м.Київ
29184,800479,2142,46,1439,790,649,800479,м.Київ
29185,800480,2148,33,1398,836,562,800480,м.Київ
29186,800481,2010,44,1282,819,463,800481,м.Київ
29187,800482,2199,48,1429,902,527,800482,м.Київ
29188,800483,2018,26,1257,836,421,800483,м.Київ
29189,800484,2240,35,1524,940,584,800484,м.Київ
29190,800485,2061,32,1340,866,474,800485,м.Київ
29191,800486,2183,44,1398,835,563,800486,м.Київ
29192,800487,2133,46,1397,838,559,800487,м.Київ
29193,800488,2470,39,1674,907,767,800488,м.Київ
29194,800489,2500,41,1735,987,748,800489,м.Київ
29195,800490,1910,41,1289,789,500,800490,м.Київ
29196,800491,2218,45,1522,871,651,800491,м.Київ
29197,800492,2154,53,1526,923,603,800492,м.Київ
29198,800493,2205,44,1555,939,616,800493,м.Київ
29199,800494,2234,39,1494,879,615,800494,м.Київ
29200,800495,1888,41,1225,727,498,800495,м.Київ
29201,800496,1835,47,1218,744,474,800496,м.Київ
29202,800497,1849,45,1204,719,485,800497,м.Київ
29203,800498,1720,38,1152,720,432,800498,м.Київ
29204,800499,2102,34,1355,826,529,800499,м.Київ
29205,800500,2199,47,1442,867,575,800500,м.Київ
29206,800501,1867,57,1222,726,496,800501,м.Київ
29207,800502,2119,45,1433,861,572,800502,м.Київ
29208,800503,1666,35,1097,701,396,800503,м.Київ
29209,800504,2148,57,1494,892,602,800504,м.Київ
29210,800505,2032,36,1324,797,527,800505,м.Київ
29211,800506,1984,40,1324,812,512,800506,м.Київ
29212,800507,2234,45,1491,894,597,800507,м.Київ
29213,800508,2276,53,1534,904,630,800508,м.Київ
29214,800509,2203,45,1499,890,609,800509,м.Київ
29215,800510,2314,58,1558,932,626,800510,м.Київ
29216,800511,2228,48,1444,895,549,800511,м.Київ
29217,800512,2076,53,1388,813,575,800512,м.Київ
29218,800513,2145,49,1394,827,567,800513,м.Київ
29219,800514,2145,39,1371,863,508,800514,м.Київ
29220,800515,1831,27,1169,755,414,800515,м.Київ
29221,800516,2328,29,1540,1012,528,800516,м.Київ
29222,800517,2210,44,1436,897,539,800517,м.Київ
29223,800518,2304,39,1497,934,563,800518,м.Київ
29224,800519,2194,49,1395,862,533,800519,м.Київ
29225,800520,2119,39,1470,858,612,800520,м.Київ
29226,800521,2141,50,1451,820,631,800521,м.Київ
29227,800522,2106,49,1369,803,566,800522,м.Київ
29228,800523,2331,38,1547,918,629,800523,м.Київ
29229,800524,2033,38,1298,784,514,800524,м.Київ
29230,800525,2216,28,1312,822,490,800525,м.Київ
29231,800526,2157,46,1441,881,560,800526,м.Київ
29232,800527,2265,54,1443,910,533,800527,м.Київ
29233,800528,2173,54,1359,866,493,800528,м.Київ
29234,800529,1986,39,1310,808,502,800529,м.Київ
29235,800530,2069,45,1322,844,478,800530,м.Київ
29236,800531,1815,26,892,645,247,800531,м.Київ
29237,800532,1962,34,1202,712,490,800532,м.Київ
29238,800533,2240,58,1421,877,544,800533,м.Київ
29239,800534,2127,45,1388,853,535,800534,м.Київ
29240,800535,2213,49,1532,858,674,800535,м.Київ
29241,800536,2249,53,1441,894,547,800536,м.Київ
29242,800537,2123,49,1400,899,501,800537,м.Київ
29243,800538,2361,41,1559,909,650,800538,м.Київ
29244,800539,1997,38,1364,864,500,800539,м.Київ
29245,800540,2176,45,1350,826,524,800540,м.Київ
29246,800541,2060,45,1264,801,463,800541,м.Київ
29247,800542,2059,41,1408,841,567,800542,м.Київ
29248,800543,1817,26,1242,754,488,800543,м.Київ
29249,800544,2467,51,1648,989,659,800544,м.Київ
29250,800545,2054,37,1326,799,527,800545,м.Київ
29251,800546,2183,48,1333,855,478,800546,м.Київ
29252,800547,2033,55,1366,872,494,800547,м.Київ
29253,800577,35,1,34,19,15,800577,м.Київ
29254,800578,18,2,16,10,6,800578,м.Київ
29255,800548,1924,29,1303,797,506,800548,м.Київ
29256,800549,2209,30,1453,955,498,800549,м.Київ
29257,800550,2155,52,1375,829,546,800550,м.Київ
29258,800551,2160,39,1457,919,538,800551,м.Київ
29259,800552,2141,35,1342,795,547,800552,м.Київ
29260,800553,2322,29,1491,981,510,800553,м.Київ
29261,800554,2172,31,1443,982,461,800554,м.Київ
29262,800555,2214,41,1348,839,509,800555,м.Київ
29263,800556,2433,41,1529,1012,517,800556,м.Київ
29264,800557,2304,43,1475,894,581,800557,м.Київ
29265,800558,2264,48,1472,867,605,800558,м.Київ
29266,800559,2187,56,1438,891,547,800559,м.Київ
29267,800560,2114,26,1297,816,481,800560,м.Київ
29268,800561,2189,35,1395,936,459,800561,м.Київ
29269,800562,2110,37,1335,875,460,800562,м.Київ
29270,800563,1971,33,1315,881,434,800563,м.Київ
29271,800564,2071,49,1368,878,490,800564,м.Київ
29272,800565,2057,53,1398,897,501,800565,м.Київ
29273,800566,2306,48,1528,956,572,800566,м.Київ
29274,800567,2406,56,1693,1022,671,800567,м.Київ
29275,800568,2258,30,1394,929,465,800568,м.Київ
29276,800569,2072,36,1244,827,417,800569,м.Київ
29277,800570,2203,26,1340,871,469,800570,м.Київ
29278,800571,2101,42,1331,896,435,800571,м.Київ
29279,800572,2329,33,1591,983,608,800572,м.Київ
29280,800573,2410,39,1591,1009,582,800573,м.Київ
29281,800574,1281,30,823,529,294,800574,м.Київ
29282,800575,1024,12,699,468,231,800575,м.Київ
29283,800576,1488,28,938,642,296,800576,м.Київ
29284,800579,5,1,4,4,0,800579,м.Київ
29285,800580,146,10,130,104,26,800580,м.Київ
29286,800581,59,3,53,40,13,800581,м.Київ
29287,800582,269,4,218,157,61,800582,м.Київ
29288,800781,2164,41,1425,796,629,800781,м.Київ
29289,800782,2378,48,1536,1015,521,800782,м.Київ
29290,800783,2265,61,1447,910,537,800783,м.Київ
29291,800784,1947,30,1214,652,562,800784,м.Київ
29292,800785,2000,26,1240,769,471,800785,м.Київ
29293,800786,2163,48,1373,806,567,800786,м.Київ
29294,800787,1800,21,1155,724,431,800787,м.Київ
29295,800788,2474,30,1642,1008,634,800788,м.Київ
29296,800789,2392,36,1670,982,688,800789,м.Київ
29297,800790,2176,46,1414,840,574,800790,м.Київ
29298,800791,2125,39,1399,861,538,800791,м.Київ
29299,800792,2301,49,1527,911,616,800792,м.Київ
29300,800793,2249,32,1487,893,594,800793,м.Київ
29301,800794,2155,39,1376,801,575,800794,м.Київ
29302,800795,2260,37,1496,922,574,800795,м.Київ
29303,800796,1569,13,1076,650,426,800796,м.Київ
29304,800797,2023,52,1296,758,538,800797,м.Київ
29305,800798,2003,28,1305,819,486,800798,м.Київ
29306,800799,2187,32,1440,899,541,800799,м.Київ
29307,800800,2131,47,1369,866,503,800800,м.Київ
29308,800801,2560,59,1701,965,736,800801,м.Київ
29309,800802,2250,44,1424,857,567,800802,м.Київ
29310,800803,2141,46,1480,814,666,800803,м.Київ
29311,800804,2320,45,1549,871,678,800804,м.Київ
29312,800805,2268,61,1435,740,695,800805,м.Київ
29313,800806,2113,60,1452,821,631,800806,м.Київ
29314,800807,2264,37,1424,936,488,800807,м.Київ
29315,800808,2233,50,1493,877,616,800808,м.Київ
29316,800809,2063,41,1390,731,659,800809,м.Київ
29317,800810,2238,45,1416,777,639,800810,м.Київ
29318,800811,2396,49,1619,910,709,800811,м.Київ
29319,800812,2340,50,1512,881,631,800812,м.Київ
29320,800813,2216,45,1465,847,618,800813,м.Київ
29321,800814,2250,39,1376,791,585,800814,м.Київ
29322,800815,1199,23,720,457,263,800815,м.Київ
29323,800816,2293,59,1430,872,558,800816,м.Київ
29324,800817,1891,30,1049,702,347,800817,м.Київ
29325,800818,1743,34,1059,647,412,800818,м.Київ
29326,800819,2041,48,1212,806,406,800819,м.Київ
29327,800820,1375,21,863,555,308,800820,м.Київ
29328,800821,52,7,38,23,15,800821,м.Київ
29329,800822,171,9,150,102,48,800822,м.Київ
29330,801091,2122,54,1443,822,621,801091,м.Київ
29331,801100,1405,40,913,553,360,801100,м.Київ
29332,800702,2445,44,1525,930,595,800702,м.Київ
29333,800703,2374,42,1620,971,649,800703,м.Київ
29334,800704,2326,56,1696,937,759,800704,м.Київ
29335,800705,2265,27,1418,889,529,800705,м.Київ
29336,800706,2346,29,1555,965,590,800706,м.Київ
29337,800707,2427,57,1572,971,601,800707,м.Київ
29338,800708,2337,28,1477,912,565,800708,м.Київ
29339,800709,2123,28,1315,839,476,800709,м.Київ
29340,800710,1602,30,1095,696,399,800710,м.Київ
29341,800711,2269,30,1546,957,589,800711,м.Київ
29342,800712,2035,36,1307,805,502,800712,м.Київ
29343,800713,2251,30,1491,919,572,800713,м.Київ
29344,800714,2210,35,1378,883,495,800714,м.Київ
29345,800715,1714,26,1123,732,391,800715,м.Київ
29346,800716,1469,24,968,612,356,800716,м.Київ
29347,800717,1763,26,1082,672,410,800717,м.Київ
29348,800718,2157,35,1393,872,521,800718,м.Київ
29349,800719,1853,38,1185,733,452,800719,м.Київ
29350,800720,1830,36,1058,711,347,800720,м.Київ
29351,800721,1978,32,1232,840,392,800721,м.Київ
29352,800722,1938,38,1221,808,413,800722,м.Київ
29353,800723,2046,32,1337,872,465,800723,м.Київ
29354,800724,2027,35,1311,837,474,800724,м.Київ
29355,800725,2162,45,1304,890,414,800725,м.Київ
29356,800726,1902,41,1199,788,411,800726,м.Київ
29357,800727,1500,33,984,616,368,800727,м.Київ
29358,800728,1836,29,1172,745,427,800728,м.Київ
29359,800729,2037,35,1355,865,490,800729,м.Київ
29360,800730,2064,38,1292,847,445,800730,м.Київ
29361,800731,2092,38,1263,854,409,800731,м.Київ
29362,800732,2035,27,1282,841,441,800732,м.Київ
29363,800733,1925,29,1260,820,440,800733,м.Київ
29364,800734,2267,48,1467,931,536,800734,м.Київ
29365,800735,2227,42,1608,985,623,800735,м.Київ
29366,800736,1890,38,1245,774,471,800736,м.Київ
29367,800737,2391,37,1459,895,564,800737,м.Київ
29368,800738,1734,23,1030,695,335,800738,м.Київ
29369,800739,2024,45,1268,791,477,800739,м.Київ
29370,800740,1459,28,975,597,378,800740,м.Київ
29371,800741,1346,28,956,567,389,800741,м.Київ
29372,800742,2206,38,1397,883,514,800742,м.Київ
29373,800743,2205,36,1439,935,504,800743,м.Київ
29374,800744,2186,49,1461,908,553,800744,м.Київ
29375,800745,2340,41,1611,912,699,800745,м.Київ
29376,800746,2214,46,1337,803,534,800746,м.Київ
29377,800747,1898,38,1209,774,435,800747,м.Київ
29378,800748,1692,30,1052,706,346,800748,м.Київ
29379,800749,1823,36,1156,736,420,800749,м.Київ
29380,800750,1687,40,1093,730,363,800750,м.Київ
29381,800751,1970,27,1259,786,473,800751,м.Київ
29382,800752,1717,45,1084,719,365,800752,м.Київ
29383,800753,2177,50,1390,879,511,800753,м.Київ
29384,800754,2250,34,1395,932,463,800754,м.Київ
29385,800755,2268,38,1449,910,539,800755,м.Київ
29386,800756,2087,55,1379,905,474,800756,м.Київ
29387,800757,1899,29,1227,818,409,800757,м.Київ
29388,800758,2038,32,1321,829,492,800758,м.Київ
29389,800759,1856,41,1113,748,365,800759,м.Київ
29390,800760,1765,24,1133,735,398,800760,м.Київ
29391,800761,1878,44,1176,742,434,800761,м.Київ
29392,800762,2108,48,1335,889,446,800762,м.Київ
29393,800763,1913,20,1151,750,401,800763,м.Київ
29394,800764,2235,32,1403,910,493,800764,м.Київ
29395,800765,2180,43,1433,796,637,800765,м.Київ
29396,800766,2187,47,1466,848,618,800766,м.Київ
29397,800767,2335,38,1538,964,574,800767,м.Київ
29398,800768,2368,52,1637,857,780,800768,м.Київ
29399,800769,2378,37,1572,913,659,800769,м.Київ
29400,800770,2361,51,1574,995,579,800770,м.Київ
29401,800771,2250,44,1521,942,579,800771,м.Київ
29402,800772,2283,45,1441,835,606,800772,м.Київ
29403,800773,2477,54,1690,975,715,800773,м.Київ
29404,800774,2241,43,1345,862,483,800774,м.Київ
29405,800775,2156,40,1457,825,632,800775,м.Київ
29406,800776,1998,41,1187,784,403,800776,м.Київ
29407,800777,1879,35,1183,678,505,800777,м.Київ
29408,800778,1937,26,1260,751,509,800778,м.Київ
29409,800779,2132,38,1315,821,494,800779,м.Київ
29410,800780,997,21,644,390,254,800780,м.Київ
29411,800823,143,12,112,75,37,800823,м.Київ
29412,800824,24,0,19,17,2,800824,м.Київ
29413,800825,103,5,86,64,22,800825,м.Київ
29414,800826,91,2,82,59,23,800826,м.Київ
29415,800827,94,1,78,50,28,800827,м.Київ
29416,801106,549,9,378,212,166,801106,м.Київ
29417,800633,2510,46,1484,824,660,800633,м.Київ
29418,800634,2468,58,1639,825,814,800634,м.Київ
29419,800635,2720,54,1869,1000,869,800635,м.Київ
29420,800636,2528,47,1645,926,719,800636,м.Київ
29421,800637,2075,45,1309,736,573,800637,м.Київ
29422,800638,2209,40,1399,759,640,800638,м.Київ
29423,800639,2097,33,1220,755,465,800639,м.Київ
29424,800640,2398,30,1590,1016,574,800640,м.Київ
29425,800641,2233,21,1383,632,751,800641,м.Київ
29426,800642,1569,18,893,570,323,800642,м.Київ
29427,800643,2130,41,1363,851,512,800643,м.Київ
29428,800644,2322,29,1311,785,526,800644,м.Київ
29429,800645,2232,48,1429,845,584,800645,м.Київ
29430,800646,2310,47,1429,836,593,800646,м.Київ
29431,800647,2398,44,1519,918,601,800647,м.Київ
29432,800648,1414,27,827,553,274,800648,м.Київ
29433,800649,2396,45,1433,958,475,800649,м.Київ
29434,800650,2485,44,1599,920,679,800650,м.Київ
29435,800651,2415,39,1506,1032,474,800651,м.Київ
29436,800652,2268,48,1563,923,640,800652,м.Київ
29437,800653,2005,40,1235,820,415,800653,м.Київ
29438,800654,1967,46,1194,733,461,800654,м.Київ
29439,800655,1928,37,1193,762,431,800655,м.Київ
29440,800656,1964,30,1239,761,478,800656,м.Київ
29441,800657,2341,41,1463,927,536,800657,м.Київ
29442,800658,2181,38,1419,918,501,800658,м.Київ
29443,800659,2306,44,1525,952,573,800659,м.Київ
29444,800660,2027,34,1355,906,449,800660,м.Київ
29445,800661,1998,34,1307,805,502,800661,м.Київ
29446,800662,2248,33,1478,896,582,800662,м.Київ
29447,800663,1953,21,1263,765,498,800663,м.Київ
29448,800664,2115,55,1414,867,547,800664,м.Київ
29449,800665,2489,40,1647,969,678,800665,м.Київ
29450,800666,2068,32,1334,859,475,800666,м.Київ
29451,800667,2203,38,1455,910,545,800667,м.Київ
29452,800668,2291,49,1481,961,520,800668,м.Київ
29453,800669,2226,38,1392,872,520,800669,м.Київ
29454,800670,2326,36,1186,751,435,800670,м.Київ
29455,800671,2419,45,1478,953,525,800671,м.Київ
29456,800672,2304,44,1433,948,485,800672,м.Київ
29457,800673,2157,49,1440,819,621,800673,м.Київ
29458,800674,2387,58,1635,941,694,800674,м.Київ
29459,800675,2301,38,1540,910,630,800675,м.Київ
29460,800676,2182,41,1445,828,617,800676,м.Київ
29461,800677,2300,54,1540,898,642,800677,м.Київ
29462,800678,2050,39,1307,834,473,800678,м.Київ
29463,800679,2253,46,1499,931,568,800679,м.Київ
29464,800680,2351,52,1470,932,538,800680,м.Київ
29465,800681,2245,35,1501,1017,484,800681,м.Київ
29466,800682,2088,49,1392,927,465,800682,м.Київ
29467,800683,1368,26,866,602,264,800683,м.Київ
29468,800684,2215,25,1212,850,362,800684,м.Київ
29469,800685,2039,35,1220,833,387,800685,м.Київ
29470,800686,2093,47,1255,860,395,800686,м.Київ
29471,800687,2142,33,1264,856,408,800687,м.Київ
29472,800688,2232,44,1398,919,479,800688,м.Київ
29473,800689,2228,44,1371,925,446,800689,м.Київ
29474,800690,2213,34,1357,924,433,800690,м.Київ
29475,800691,2176,36,1331,897,434,800691,м.Київ
29476,800692,2078,33,1433,912,521,800692,м.Київ
29477,800693,2037,48,1364,811,553,800693,м.Київ
29478,800694,2115,28,1387,914,473,800694,м.Київ
29479,800695,1696,30,1123,705,418,800695,м.Київ
29480,800696,2228,39,1360,865,495,800696,м.Київ
29481,800697,26,0,26,18,8,800697,м.Київ
29482,800698,222,17,194,138,56,800698,м.Київ
29483,800699,35,1,31,23,8,800699,м.Київ
29484,800700,87,2,74,63,11,800700,м.Київ
29485,800701,46,1,43,27,16,800701,м.Київ
29486,801083,45,3,37,29,8,801083,м.Київ
29487,801084,24,1,22,15,7,801084,м.Київ
29488,801085,33,1,29,21,8,801085,м.Київ
29489,801087,2466,32,1389,811,578,801087,м.Київ
29490,801093,1547,18,905,471,434,801093,м.Київ
29491,801094,2888,26,2004,1119,885,801094,м.Київ
29492,801095,1453,18,685,418,267,801095,м.Київ
29493,1,13,0,13,9,4,1,м.Київ
29494,800583,1984,46,1225,682,543,800583,м.Київ
29495,800584,2090,42,1286,708,578,800584,м.Київ
29496,800585,2453,45,1573,931,642,800585,м.Київ
29497,800586,2001,39,1163,574,589,800586,м.Київ
29498,800587,1277,34,812,433,379,800587,м.Київ
29499,800588,2097,50,1392,756,636,800588,м.Київ
29500,800589,1918,51,1210,680,530,800589,м.Київ
29501,800590,2212,45,1485,782,703,800590,м.Київ
29502,800591,1997,50,1264,685,579,800591,м.Київ
29503,800592,2198,57,1390,873,517,800592,м.Київ
29504,800593,2175,34,1329,803,526,800593,м.Київ
29505,800594,2380,50,1529,838,691,800594,м.Київ
29506,800595,2553,37,1477,867,610,800595,м.Київ
29507,800596,2466,52,1528,901,627,800596,м.Київ
29508,800597,2251,48,1452,762,690,800597,м.Київ
29509,800598,2454,39,1576,888,688,800598,м.Київ
29510,800599,1153,18,744,448,296,800599,м.Київ
29511,800600,2404,35,1315,910,405,800600,м.Київ
29512,800601,2333,45,1489,765,724,800601,м.Київ
29513,800602,2371,51,1336,807,529,800602,м.Київ
29514,800603,2511,47,1544,908,636,800603,м.Київ
29515,800604,2391,65,1462,852,610,800604,м.Київ
29516,800605,2270,34,1266,825,441,800605,м.Київ
29517,800606,2290,41,1387,865,522,800606,м.Київ
29518,800607,2158,69,1087,716,371,800607,м.Київ
29519,800608,2292,42,1252,917,335,800608,м.Київ
29520,800609,2351,47,1550,929,621,800609,м.Київ
29521,800610,2286,55,1441,807,634,800610,м.Київ
29522,800611,2495,44,1532,808,724,800611,м.Київ
29523,800612,2410,56,1601,923,678,800612,м.Київ
29524,800613,2324,45,1491,914,577,800613,м.Київ
29525,800614,2618,33,1498,999,499,800614,м.Київ
29526,800615,2511,30,1644,884,760,800615,м.Київ
29527,800616,2448,66,1574,877,697,800616,м.Київ
29528,800617,2421,56,1431,793,638,800617,м.Київ
29529,800618,2044,51,1224,643,581,800618,м.Київ
29530,800619,1962,43,1284,652,632,800619,м.Київ
29531,800620,2298,34,1427,818,609,800620,м.Київ
29532,800621,2313,48,1420,827,593,800621,м.Київ
29533,800622,2003,30,1289,713,576,800622,м.Київ
29534,800623,2531,50,1546,916,630,800623,м.Київ
29535,800624,60,2,54,34,20,800624,м.Київ
29536,800625,135,3,125,85,40,800625,м.Київ
29537,800627,53,0,53,41,12,800627,м.Київ
29538,800628,117,4,107,76,31,800628,м.Київ
29539,800629,31,0,31,24,7,800629,м.Київ
29540,800630,323,8,298,210,88,800630,м.Київ
29541,800631,50,0,46,31,15,800631,м.Київ
29542,800632,105,1,102,75,27,800632,м.Київ
29543,800828,1918,58,1307,715,592,800828,м.Київ
29544,800829,1694,29,1101,663,438,800829,м.Київ
29545,800830,1218,31,705,456,249,800830,м.Київ
29546,800831,2275,36,1358,928,430,800831,м.Київ
29547,800832,2459,27,1518,878,640,800832,м.Київ
29548,800833,2215,59,1385,828,557,800833,м.Київ
29549,800834,1991,37,1239,730,509,800834,м.Київ
29550,800835,1744,41,1144,690,454,800835,м.Київ
29551,800836,2042,40,1290,757,533,800836,м.Київ
29552,800837,1934,38,1211,741,470,800837,м.Київ
29553,800838,2560,53,1694,973,721,800838,м.Київ
29554,800839,2183,33,1257,928,329,800839,м.Київ
29555,800840,2150,37,1357,798,559,800840,м.Київ
29556,800841,1589,35,1040,610,430,800841,м.Київ
29557,800842,2268,47,1508,906,602,800842,м.Київ
29558,800843,2354,45,1538,882,656,800843,м.Київ
29559,800850,2478,33,1565,1101,464,800850,м.Київ
29560,800851,2214,50,1464,854,610,800851,м.Київ
29561,800865,2094,31,1505,1073,432,800865,м.Київ
29562,800869,1992,39,1360,807,553,800869,м.Київ
29563,800870,2073,41,1421,900,521,800870,м.Київ
29564,800871,2093,50,1419,904,515,800871,м.Київ
29565,800873,2322,51,1505,854,651,800873,м.Київ
29566,800877,1235,20,763,479,284,800877,м.Київ
29567,800878,1302,17,767,477,290,800878,м.Київ
29568,800879,2057,51,1282,718,564,800879,м.Київ
29569,800880,2025,37,1311,732,579,800880,м.Київ
29570,800881,1393,33,926,575,351,800881,м.Київ
29571,800882,1710,27,1119,669,450,800882,м.Київ
29572,800883,2023,32,1246,727,519,800883,м.Київ
29573,800884,2365,54,1599,986,613,800884,м.Київ
29574,800885,1754,21,1078,649,429,800885,м.Київ
29575,800887,2154,25,1307,604,703,800887,м.Київ
29576,800888,2158,16,1285,590,695,800888,м.Київ
29577,800889,1867,35,1219,690,529,800889,м.Київ
29578,800890,1391,23,886,518,368,800890,м.Київ
29579,800891,2220,34,1301,792,509,800891,м.Київ
29580,800950,148,4,112,90,22,800950,м.Київ
29581,800951,102,3,77,61,16,800951,м.Київ
29582,800952,55,1,42,33,9,800952,м.Київ
29583,800953,220,8,199,146,53,800953,м.Київ
29584,800954,86,1,73,53,20,800954,м.Київ
29585,800955,76,3,71,53,18,800955,м.Київ
29586,800956,76,2,71,55,16,800956,м.Київ
29587,800958,34,0,28,20,8,800958,м.Київ
29588,800961,1784,38,1076,547,529,800961,м.Київ
29589,800962,1694,37,1022,547,475,800962,м.Київ
29590,800963,2119,34,1296,646,650,800963,м.Київ
29591,800964,984,25,585,294,291,800964,м.Київ
29592,800966,847,21,531,267,264,800966,м.Київ
29593,800967,1257,30,755,372,383,800967,м.Київ
29594,800975,1928,43,1217,639,578,800975,м.Київ
29595,801086,28,0,22,14,8,801086,м.Київ
29596,801105,2103,23,1155,813,342,801105,м.Київ
29597,800844,1926,41,1245,757,488,800844,м.Київ
29598,800845,2026,25,1291,848,443,800845,м.Київ
29599,800846,2004,39,1307,797,510,800846,м.Київ
29600,800847,2097,53,1302,764,538,800847,м.Київ
29601,800848,2558,24,1250,948,302,800848,м.Київ
29602,800849,2175,36,1336,793,543,800849,м.Київ
29603,800852,2131,41,1350,852,498,800852,м.Київ
29604,800853,1549,23,898,566,332,800853,м.Київ
29605,800854,2428,39,1551,963,588,800854,м.Київ
29606,800855,1889,31,1200,752,448,800855,м.Київ
29607,800856,1667,27,1070,700,370,800856,м.Київ
29608,800857,2122,41,1411,921,490,800857,м.Київ
29609,800858,1738,28,1140,696,444,800858,м.Київ
29610,800859,1760,28,1148,645,503,800859,м.Київ
29611,800860,1928,37,1163,646,517,800860,м.Київ
29612,800861,2005,58,1281,769,512,800861,м.Київ
29613,800862,2309,43,1426,860,566,800862,м.Київ
29614,800863,1677,36,1103,665,438,800863,м.Київ
29615,800864,2271,32,1392,822,570,800864,м.Київ
29616,800866,2252,39,1529,890,639,800866,м.Київ
29617,800867,1754,30,1053,736,317,800867,м.Київ
29618,800868,1824,19,1085,717,368,800868,м.Київ
29619,800872,2461,44,1627,816,811,800872,м.Київ
29620,800874,1631,35,1080,629,451,800874,м.Київ
29621,800875,1648,12,1002,670,332,800875,м.Київ
29622,800876,1671,33,1110,641,469,800876,м.Київ
29623,800886,2109,53,1368,788,580,800886,м.Київ
29624,800892,1816,40,1060,800,260,800892,м.Київ
29625,800893,1611,33,1032,695,337,800893,м.Київ
29626,800894,2482,60,1606,921,685,800894,м.Київ
29627,800895,1960,49,1270,860,410,800895,м.Київ
29628,800896,1746,41,1074,753,321,800896,м.Київ
29629,800897,1750,44,1164,797,367,800897,м.Київ
29630,800898,1687,40,1092,640,452,800898,м.Київ
29631,800899,2292,50,1484,816,668,800899,м.Київ
29632,800900,2135,56,1417,845,572,800900,м.Київ
29633,800901,1888,42,1086,741,345,800901,м.Київ
29634,800902,2318,58,1493,862,631,800902,м.Київ
29635,800903,2297,29,1466,853,613,800903,м.Київ
29636,800904,2309,40,1419,848,571,800904,м.Київ
29637,800905,1919,32,1214,709,505,800905,м.Київ
29638,800906,2015,25,1296,933,363,800906,м.Київ
29639,800907,2041,19,1147,769,378,800907,м.Київ
29640,800908,2282,56,1411,857,554,800908,м.Київ
29641,800909,2482,49,1700,1001,699,800909,м.Київ
29642,800910,1965,30,1230,726,504,800910,м.Київ
29643,800911,1971,22,1267,789,478,800911,м.Київ
29644,800912,2207,40,1345,810,535,800912,м.Київ
29645,800913,2279,48,1437,935,502,800913,м.Київ
29646,800914,1759,37,1063,678,385,800914,м.Київ
29647,800915,1185,13,699,435,264,800915,м.Київ
29648,800916,2199,38,1382,864,518,800916,м.Київ
29649,800917,1628,48,980,567,413,800917,м.Київ
29650,800918,2090,34,1257,782,475,800918,м.Київ
29651,800919,2028,24,1288,752,536,800919,м.Київ
29652,800920,1627,30,1048,678,370,800920,м.Київ
29653,800921,2005,33,1140,827,313,800921,м.Київ
29654,800922,1839,36,1111,719,392,800922,м.Київ
29655,800923,1655,29,1049,667,382,800923,м.Київ
29656,800924,2053,36,1273,859,414,800924,м.Київ
29657,800925,1383,23,867,558,309,800925,м.Київ
29658,800926,2147,29,1351,894,457,800926,м.Київ
29659,800927,2103,41,1289,856,433,800927,м.Київ
29660,800928,2177,49,1357,860,497,800928,м.Київ
29661,800929,2370,38,1507,948,559,800929,м.Київ
29662,800930,1318,28,859,505,354,800930,м.Київ
29663,800931,1817,36,1125,711,414,800931,м.Київ
29664,800932,1460,32,936,558,378,800932,м.Київ
29665,800933,1724,33,1072,681,391,800933,м.Київ
29666,800934,1323,18,809,514,295,800934,м.Київ
29667,800935,2098,47,1222,808,414,800935,м.Київ
29668,800936,1963,26,1224,814,410,800936,м.Київ
29669,800937,2282,21,982,622,360,800937,м.Київ
29670,800938,2008,43,1324,826,498,800938,м.Київ
29671,800939,1520,25,831,601,230,800939,м.Київ
29672,800940,1522,17,765,618,147,800940,м.Київ
29673,800941,2125,20,1289,820,469,800941,м.Київ
29674,800942,2502,44,1577,939,638,800942,м.Київ
29675,800943,2002,33,1302,759,543,800943,м.Київ
29676,800944,1316,22,738,524,214,800944,м.Київ
29677,800945,1948,39,1412,833,579,800945,м.Київ
29678,800946,2314,40,1542,921,621,800946,м.Київ
29679,800947,2221,45,1310,771,539,800947,м.Київ
29680,800948,2507,43,1629,1001,628,800948,м.Київ
29681,800949,124,4,120,76,44,800949,м.Київ
29682,800957,317,7,133,105,28,800957,м.Київ
29683,801102,1578,23,973,578,395,801102,м.Київ
29684,1,2530,155,2049,1925,124,1,м.Київ
29685,2,74,0,49,40,9,2,м.Київ
29686,800965,1346,40,814,415,399,800965,м.Київ
29687,800968,1094,27,718,397,321,800968,м.Київ
29688,800969,1480,32,852,447,405,800969,м.Київ
29689,800970,1576,35,1058,567,491,800970,м.Київ
29690,800971,781,20,503,267,236,800971,м.Київ
29691,800972,1087,25,669,343,326,800972,м.Київ
29692,800973,1071,35,718,365,353,800973,м.Київ
29693,800974,812,13,497,265,232,800974,м.Київ
29694,800976,1220,21,795,402,393,800976,м.Київ
29695,800977,1618,50,992,508,484,800977,м.Київ
29696,800978,2094,48,1240,629,611,800978,м.Київ
29697,800979,1535,37,890,475,415,800979,м.Київ
29698,800980,1715,45,1162,626,536,800980,м.Київ
29699,800981,1428,26,896,471,425,800981,м.Київ
29700,800982,2007,34,1255,708,547,800982,м.Київ
29701,800983,2495,53,1614,881,733,800983,м.Київ
29702,800984,1136,23,683,416,267,800984,м.Київ
29703,800985,1329,29,814,427,387,800985,м.Київ
29704,800986,1368,22,827,446,381,800986,м.Київ
29705,800987,2471,44,1555,904,651,800987,м.Київ
29706,800988,2432,44,1577,881,696,800988,м.Київ
29707,800989,2384,46,1478,869,609,800989,м.Київ
29708,800990,2246,48,1438,788,650,800990,м.Київ
29709,800991,2286,41,1503,833,670,800991,м.Київ
29710,800992,2317,45,1565,846,719,800992,м.Київ
29711,800993,2350,50,1528,846,682,800993,м.Київ
29712,800994,2414,40,1523,859,664,800994,м.Київ
29713,800995,2259,31,1375,811,564,800995,м.Київ
29714,800996,2494,66,1549,854,695,800996,м.Київ
29715,800997,2091,36,1294,718,576,800997,м.Київ
29716,800998,2352,38,1464,881,583,800998,м.Київ
29717,800999,2219,61,1463,830,633,800999,м.Київ
29718,801000,2428,46,1544,850,694,801000,м.Київ
29719,801001,2202,53,1411,764,647,801001,м.Київ
29720,801002,2120,65,1391,821,570,801002,м.Київ
29721,801003,2198,58,1414,833,581,801003,м.Київ
29722,801004,2086,31,1260,710,550,801004,м.Київ
29723,801005,1943,32,1256,810,446,801005,м.Київ
29724,801006,2120,29,1201,752,449,801006,м.Київ
29725,801007,2209,32,1397,709,688,801007,м.Київ
29726,801008,2488,71,1572,930,642,801008,м.Київ
29727,801009,2319,45,1484,832,652,801009,м.Київ
29728,801010,2416,42,1513,916,597,801010,м.Київ
29729,801011,2279,40,1377,824,553,801011,м.Київ
29730,801012,2326,42,1394,833,561,801012,м.Київ
29731,801013,2200,39,1366,809,557,801013,м.Київ
29732,801014,1533,31,920,582,338,801014,м.Київ
29733,801015,2001,38,1126,674,452,801015,м.Київ
29734,801016,1717,36,1069,657,412,801016,м.Київ
29735,801017,1610,27,987,585,402,801017,м.Київ
29736,801018,1697,35,1044,623,421,801018,м.Київ
29737,801019,2024,36,1306,742,564,801019,м.Київ
29738,801020,1835,30,1095,633,462,801020,м.Київ
29739,801021,1555,26,955,561,394,801021,м.Київ
29740,801022,1438,18,920,527,393,801022,м.Київ
29741,801023,2054,14,1272,764,508,801023,м.Київ
29742,801024,2389,41,1428,897,531,801024,м.Київ
29743,801025,2460,45,1593,838,755,801025,м.Київ
29744,801026,2379,62,1372,803,569,801026,м.Київ
29745,801027,1781,27,956,566,390,801027,м.Київ
29746,801028,2402,30,1363,767,596,801028,м.Київ
29747,801029,2381,35,1404,817,587,801029,м.Київ
29748,801030,2106,37,1336,709,627,801030,м.Київ
29749,801031,2354,53,1511,818,693,801031,м.Київ
29750,801032,2228,38,1406,886,520,801032,м.Київ
29751,801033,2360,44,1510,948,562,801033,м.Київ
29752,801034,2155,33,1326,819,507,801034,м.Київ
29753,801035,1790,36,1131,669,462,801035,м.Київ
29754,801036,2291,58,1395,812,583,801036,м.Київ
29755,801037,2248,28,1377,860,517,801037,м.Київ
29756,801038,1697,28,1071,698,373,801038,м.Київ
29757,801039,1256,23,734,441,293,801039,м.Київ
29758,801040,1902,33,1187,695,492,801040,м.Київ
29759,801041,2235,34,1366,844,522,801041,м.Київ
29760,801042,2098,39,1281,821,460,801042,м.Київ
29761,801043,1900,34,1172,761,411,801043,м.Київ
29762,801044,2189,37,1318,807,511,801044,м.Київ
29763,801045,2339,41,1548,956,592,801045,м.Київ
29764,801046,2402,41,1443,924,519,801046,м.Київ
29765,801047,2528,31,1461,994,467,801047,м.Київ
29766,801048,1841,34,1022,672,350,801048,м.Київ
29767,801049,2515,55,1643,974,669,801049,м.Київ
29768,801050,41,2,39,21,18,801050,м.Київ
29769,801051,168,7,159,109,50,801051,м.Київ
29770,801052,12,0,12,4,8,801052,м.Київ
29771,801053,61,4,57,42,15,801053,м.Київ
29772,801054,57,0,53,40,13,801054,м.Київ
29773,801055,141,7,133,78,55,801055,м.Київ
29774,801056,98,5,90,64,26,801056,м.Київ
29775,801057,61,0,57,42,15,801057,м.Київ
29776,801058,120,5,91,65,26,801058,м.Київ
29777,801059,118,3,93,82,11,801059,м.Київ
29778,801060,177,0,97,77,20,801060,м.Київ
29779,801061,40,1,38,28,10,801061,м.Київ
29780,801062,103,3,95,76,19,801062,м.Київ
29781,801063,254,5,147,107,40,801063,м.Київ
29782,801064,32,0,31,23,8,801064,м.Київ
29783,801065,192,10,172,132,40,801065,м.Київ
29784,801066,236,3,222,161,61,801066,м.Київ
29785,900001,1744,1,98,26,72,900001,Закордонний виборчий окург
29786,900002,2761,21,1079,349,730,900002,Закордонний виборчий окург
29787,900003,363,0,233,120,113,900003,Закордонний виборчий окург
29788,900004,291,1,62,31,31,900004,Закордонний виборчий окург
29789,900005,1065,1,195,113,82,900005,Закордонний виборчий окург
29790,900006,2356,11,679,242,437,900006,Закордонний виборчий окург
29791,900007,7315,11,811,529,282,900007,Закордонний виборчий окург
29792,900008,4970,1,297,238,59,900008,Закордонний виборчий окург
29793,900009,2920,4,221,91,130,900009,Закордонний виборчий окург
29794,900011,126,0,24,18,6,900011,Закордонний виборчий окург
29795,900012,204,0,73,15,58,900012,Закордонний виборчий окург
29796,900013,2847,23,1317,373,944,900013,Закордонний виборчий окург
29797,900014,168,2,70,28,42,900014,Закордонний виборчий окург
29798,900015,412,4,132,92,40,900015,Закордонний виборчий окург
29799,900016,2780,29,1083,415,668,900016,Закордонний виборчий окург
29800,900017,957,4,141,72,69,900017,Закордонний виборчий окург
29801,900018,8593,7,382,196,186,900018,Закордонний виборчий окург
29802,900020,2900,5,466,165,301,900020,Закордонний виборчий окург
29803,900021,4574,17,1120,822,298,900021,Закордонний виборчий окург
29804,900022,181,2,84,33,51,900022,Закордонний виборчий окург
29805,900023,14340,5,641,315,326,900023,Закордонний виборчий окург
29806,900025,168,0,69,27,42,900025,Закордонний виборчий окург
29807,900026,228,1,63,31,32,900026,Закордонний виборчий окург
29808,900027,766,5,356,100,256,900027,Закордонний виборчий окург
29809,900028,5043,53,2156,930,1226,900028,Закордонний виборчий окург
29810,900029,5813,22,1486,580,906,900029,Закордонний виборчий окург
29811,900030,2907,23,1073,509,564,900030,Закордонний виборчий окург
29812,900031,8129,27,2156,550,1606,900031,Закордонний виборчий окург
29813,900032,5887,40,1647,756,891,900032,Закордонний виборчий окург
29814,900033,5683,34,1417,643,774,900033,Закордонний виборчий окург
29815,900034,688,2,199,126,73,900034,Закордонний виборчий окург
29816,900035,4109,2,173,87,86,900035,Закордонний виборчий окург
29817,900037,1335,2,364,93,271,900037,Закордонний виборчий окург
29818,900038,5326,20,1112,310,802,900038,Закордонний виборчий окург
29819,900040,140,0,52,37,15,900040,Закордонний виборчий окург
29820,900041,418,2,274,142,132,900041,Закордонний виборчий окург
29821,900042,504,4,289,124,165,900042,Закордонний виборчий окург
29822,900043,681,7,384,139,245,900043,Закордонний виборчий окург
29823,900044,231,1,109,47,62,900044,Закордонний виборчий окург
29824,900045,368,0,86,73,13,900045,Закордонний виборчий окург
29825,900046,211,0,92,46,46,900046,Закордонний виборчий окург
29826,900047,2387,10,713,445,268,900047,Закордонний виборчий окург
29827,900048,3104,10,467,252,215,900048,Закордонний виборчий окург
29828,900049,1435,4,263,127,136,900049,Закордонний виборчий окург
29829,900051,71,0,46,22,24,900051,Закордонний виборчий окург
29830,900052,125,0,111,32,79,900052,Закордонний виборчий окург
29831,900053,586,0,150,92,58,900053,Закордонний виборчий окург
29832,900054,240,1,79,29,50,900054,Закордонний виборчий окург
29833,900055,52035,10,419,291,128,900055,Закордонний виборчий окург
29834,900056,13536,4,177,144,33,900056,Закордонний виборчий окург
29835,900058,1943,8,898,222,676,900058,Закордонний виборчий окург
29836,900059,17030,19,1650,696,954,900059,Закордонний виборчий окург
29837,900061,14279,16,902,396,506,900061,Закордонний виборчий окург
29838,900062,26191,26,1799,701,1098,900062,Закордонний виборчий окург
29839,900063,13413,13,1010,434,576,900063,Закордонний виборчий окург
29840,900064,544,0,203,62,141,900064,Закордонний виборчий окург
29841,900065,351,3,178,72,106,900065,Закордонний виборчий окург
29842,900067,212,0,43,26,17,900067,Закордонний виборчий окург
29843,900068,351,0,71,29,42,900068,Закордонний виборчий окург
29844,900069,18057,55,4162,2141,2021,900069,Закордонний виборчий окург
29845,900070,4781,15,1238,781,457,900070,Закордонний виборчий окург
29846,900071,10977,22,1915,840,1075,900071,Закордонний виборчий окург
29847,900072,3830,6,467,230,237,900072,Закордонний виборчий окург
29848,900073,2805,14,1187,486,701,900073,Закордонний виборчий окург
29849,900074,844,4,275,118,157,900074,Закордонний виборчий окург
29850,900080,314,1,122,58,64,900080,Закордонний виборчий окург
29851,900082,101,1,47,18,29,900082,Закордонний виборчий окург
29852,900083,349,1,100,40,60,900083,Закордонний виборчий окург
29853,900085,278,2,166,72,94,900085,Закордонний виборчий окург
29854,900086,3788,2,449,234,215,900086,Закордонний виборчий окург
29855,900088,688,2,250,106,144,900088,Закордонний виборчий окург
29856,900089,7299,8,456,120,336,900089,Закордонний виборчий окург
29857,900090,11993,17,1336,306,1030,900090,Закордонний виборчий окург
29858,900091,23893,2,578,85,493,900091,Закордонний виборчий окург
29859,900092,5927,32,1093,354,739,900092,Закордонний виборчий окург
29860,900093,209,0,102,38,64,900093,Закордонний виборчий окург
29861,900094,351,0,99,57,42,900094,Закордонний виборчий окург
29862,900095,237,2,165,68,97,900095,Закордонний виборчий окург
29863,900096,600,4,414,174,240,900096,Закордонний виборчий окург
29864,900097,210,0,71,50,21,900097,Закордонний виборчий окург
29865,900098,2500,7,335,152,183,900098,Закордонний виборчий окург
29866,900099,4068,2,95,70,25,900099,Закордонний виборчий окург
29867,900100,1211,1,112,48,64,900100,Закордонний виборчий окург
29868,900101,20806,6,508,235,273,900101,Закордонний виборчий окург
29869,900102,3738,24,1170,375,795,900102,Закордонний виборчий окург
29870,900104,263,3,84,37,47,900104,Закордонний виборчий окург
29871,900105,23383,56,4125,2425,1700,900105,Закордонний виборчий окург
29872,900106,5321,12,974,625,349,900106,Закордонний виборчий окург
29873,900107,214,2,129,33,96,900107,Закордонний виборчий окург
29874,900108,1380,6,396,99,297,900108,Закордонний виборчий окург
29875,900109,904,2,385,127,258,900109,Закордонний виборчий окург
29876,900110,483,1,164,68,96,900110,Закордонний виборчий окург
29877,900111,268,2,250,147,103,900111,Закордонний виборчий окург
29878,900114,42,1,40,25,15,900114,Закордонний виборчий окург
29879,900116,1298,10,673,336,337,900116,Закордонний виборчий окург
29880,900120,185,0,110,67,43,900120,Закордонний виборчий окург
29881,900121,4314,6,574,178,396,900121,Закордонний виборчий окург
29882,900122,21386,26,1501,795,706,900122,Закордонний виборчий окург
29883,900123,101,2,66,33,33,900123,Закордонний виборчий окург
29884,900124,408,4,321,151,170,900124,Закордонний виборчий окург
29885,900125,1035,4,297,89,208,900125,Закордонний виборчий окург
